Ha, Ha, Ha, Ms, Ha, Ha, Ha, Ms, Ms, Ms, Ms, Ms, Ms^Xm, Ms^Xm, Ms^Xm, Ms^Xm, Ms, Ms, Ms, Ms, Ms, Ms, Ms, Ms, Ms, Ms, Ms, Aa, Ms, Ai, Ai, Ai, Ai, Ai
Ha, Ha, Ha, Ms, Ai, Ai, Ha, Ms, Ms, Ms, Ms, Ms^Xm, Ms^Xm, Ms^Xm, Ms, Ms, Ms, Ms, Ms, Ms, Ms, Ms, Ms, Ms, Ms, Ms, Ms, Aa^Vha, Ms, Ai, Ai, Ai, Ai, Ai
Aa, Aa, Aa, Ha, Ai, Ai, Ai, Ha, Ha, Ha, Ha, Ms, Ms, Ms, Ms, Ms, Ms, Ms, Ms, Ms, Ms, Ms, Ha, Ms, Ms, Ms, Ha, Ms, Cud, Ms, Ms, Ai, Ai, Ai
Ha, Ha, Aa, Aa, Aa, Ai, Aa, Aa, Aa, Aa, Aa, Ha, Ha^Vhha, Ms, Ms, Ms, Ms, Ms, Ms, Ms, Ha, Ha^Vhha, Aa, Ha, Ha, Ms, Ha, Cud, 1 Kud, Cud, Ms, Ai, Ai, Ai
Ha, Rb^Vhha, Rb^Fda, Aa^Fpa, Rd, Rd, Rd, Rd, Rd, Rd, Rd, Ha, Aa, Ha, Ha, Ms, Ms, Ms, Ms, Ha, Ha, Rd, Rd, Aa, Ha^Fpa, Ha^Vhha, Rr, Cud, Cud, Cud, Aa^Vha, Ai, Ai, Ai
Gd, Gd, Aa^Fpa, Rd^Fda, Aa^Fpa, Ha, Ha, Ha, Ms, Ha, Aa, Rd, Rb, Aa, Aa, Ha, Ms, Ha^Vhha, Ms, Ha, Rd, Rd, Aa^Fpa, Rd^Fpa, Rd^Fpa, Rr, Aa, Aa, Aa, Aa, Ai, Ai, Ms, Ms
Aa^Fpa, Aa^Fpa, Gd, Rd^Fpa, Aa^Fpa, Aa, Ha, Ms, Ms, Ha, Gd, Aa, Aa^Fpa, Rb^Vea, Ha, Ha, Ha, Ms, Ms, Ha, Aa, Aa^Fpa, Aa^Fpa, Aa^Fpa, Aa, Rr, Ai, Ai, Ww, Wwrg^Es, Ms, Ms, Ms, Ms
Aa^Fpa, Aa^Fpa, Aa^Fpa, Rd^Fpa, Aa^Fpa, Aa, Aa, Ms, Ms, Ms, Ha, Gd, Ha^Fpa, Rb, Ha, Ms, Ms, Ms, Ms, Ha, Ha, Ha^Fpa, Aa^Fpa, Aa, Ww^Es, Rr, Ww^Es, Wwrg, Ha^Vhha, Ha, Mm, Ms, Ms, Ms
Aa^Fpa, Aa^Fpa, Aa^Fpa, Rb^Vea, Aa, Aa, Ha, Ha, Ms, Ms, Ha, Ha^Fpa, Ha^Fpa, Aa, Ha, Ms, Ms, Ha, Ha, Ms, Gd, Gd, Ww, Ww, Rd^Ebn, Ww^Bw|, Ai, Ai, Ai, Ha, Mm, Ms, Ms, Ms
Aa^Fpa, Aa^Fpa, Aa, Gd^Fda, Gd, Aa, Aa, Aa, Ha, Ha, Aa, Aa, Aa^Fpa, Aa, Ha, Ms, Ms, Ha, Gd, Gd, Ww, Ww, Ai^Vhha, Ai, Aa, Rr, Rr, Ai, Ha, Ha, Mm, Mm, Ms, Ms
Aa, Aa, Aa^Fda, Gd^Fda, Aa, Gd, Aa, Ha, Aa, Ha, Aa, Aa, Aa, Aa, Aa, Ha, Ha, Ha, Ww, Ww, Ha, Ha, Mm, Ha, Ha, Aa, Aa, Aa, Ha, Ha, Ha, Mm, Ms, Ms
Aa^Fpa, Aa^Fpa, Aa^Fpa, Aa, Aa^Fpa, Aa^Fpa, Aa^Fpa, Aa, Ha^Fpa, Aa, Ms, Ha, Gd, Aa, Ai, Ai, Ww, Ww, Gd, Gd, Ha^Fpa, Ha, Mm, Mm, Mm, Ha, Rr, Aa, Aa^Fpa, Aa, Ha, Ms, Ms, Ms
Aa^Fpa, Aa^Fpa, Aa^Fma, Aa, Aa^Fma, Aa, Aa, Aa, Aa, Ha, Ms, Ms, Ha, Aa, Ai, Ww, Ww, Gd, Aa^Fpa, Aa^Fpa, Aa^Fpa, Ha, Ha, Mm, Ha, Ha, Rr, Aa, Aa^Fpa, Aa, Ha^Fpa, Mm, Ms, Ms
Aa, Aa, Gd^Fda, Gd^Fda, Gd^Fda, Aa, Aa, Aa, Aa, Aa, Ha, Ha, Ai, Ai, Ww, Ww, Gd, Gd, Ha, Aa^Fpa, Rr, Ha, Rr, Ha, Rr, Rr, Aa, Aa^Fpa, Aa^Fpa, Ha^Fpa, Ha^Fpa, Ha^Fpa, Ms, Ms
Aa, Aa, Aa, Gd, Ai, Aa, Ai, Aa, Gd, Aa, Gd, Gd, Ww, Ww, Ww, Ww, Gd, Mm, Ha, Rr, Aa, Rr, Ha, Rr, Ha^Vhha, Aa, Aa, Aa^Fpa, Aa^Fpa, Aa, Ha, Mm, Ms, Ms
Ai, Ai, Ww, Ww, Ww, Ai, Ww, Ai, Ww, Ww, Ww, Ww, Ww, Ww, Aa, Aa, Aa, Gd, Rr, Rr, Ha, Ha, Ha, Mm, Ha, Ha, Ha, Ha, Ha, Aa, Ha, Mm, Ms, Ms
Ww, Ww, Ww, Gd^Es, Gd, Ww, Gd, Ww, Ww, Ww, Ww, Ww, Ai, Ai, Aa, Aa, Aa, Rr, Rr, Gd, Ha, Ha, Ha, Ha, Mm, Mm, Mm, Ha, Mm, Ha, Mm, Mm, Ms, Ms
Ww, Ww, Ai, Ai, Gd, Aa, Aa, Gd, Gd, Ai, Ai, Ai, Ha, Gd, Gd, Aa, Aa, Aa, Rr, Aa, Ha, Mm, Mm, Mm, Ha, Mm, Ha, Ha, Mm, Mm, Mm, Mm, Ms, Ms
Aa, Ai, Aa, Ai, Aa^Vh, Gd, Gd, Gd, Aa, Gd, Ai, Ai, Gd, Mm, Ha, Aa, Gd^Vh, Rr, Gd, Aa, Ha, Ha, Ha, Ha, Mm^Fma, Ha, Mm, Mm, Ha, Mm, Mm, Mm, Mm, Ms
Aa, Aa, Aa, Gd, Rd, Rd, Aa, Gd, Aa, Aa, Aa, Gd, Gd, Ha, Aa, Aa, Rr, Rr, Gd, Aa, Ha, Ha, Aa, Ha^Fpa, Ha^Fma, Mm^Fma, Ha, Mm, Mm, Mm, Mm, Mm, Mm^Fma, Ms
Aa, Aa, Aa, Gd, Aa, Rd, Rd, Aa, Aa, Aa, Aa, Aa, Aa, Aa, Gd, Gd, Rr, Gd, Aa, Aa, Ms, Ha, Aa, Aa, Aa, Ha^Fpa, Ha, Ha, Ha, Ha, Ha^Fpa, Mm^Fma, Mm^Fma, Mm
Aa, Aa, Aa, Aa, Aa, Aa, Aa, Re, Re^Vh, Gd, Aa, Aa, Aa, Aa, Gd, Gd, Rr, Gd, Aa, Ha, Ha, Aa, Aa, Aa, Aa, Aa, Aa, Ha, Aa, Ha, Ha, Ha^Fpa, Mm, Ms
Aa, Gd, Aa, Aa, Aa, Aa, Aa, Aa, Re, Aa, Aa, Aa, Gd, Gd, Rr, Rr, Gd, Gd, Gd, Aa, Aa, Aa, Gd, Gd, Gd, Aa^Fpa, Aa^Fpa, Aa, Gd^Fetd, Ha, Ha, Mm, Mm, Ms
Aa, Gd, Gd, Gd, Gd, Aa, Aa, Aa, Rd, Aa, Gd, Gd, Gd, Gd, Rr, Gd, Gd, Gd, Gd, Gd, Gd, Gd, Aa, Gd, Aa, Aa^Fpa, Gd^Fp, Gd^Fp, Gd, Hhd, Hhd, Mm, Mm, Mm
Aa, Gd, Aa, Gd^Vh, Aa, Aa, Aa, Aa, Rd, Aa, Gd, Gd, Rr, Rr, Gd, Gd, Gd, Gd, Gd, Gd^Fp, Gd^Fp, Gd^Ve, Hh, Ms, Hh, Gd, Gs^Fp, Gd, Hh, Hhd, Mm, Ha, Ha^Fpa, Aa^Fpa
Aa, Gd, Gd, Gd, Aa, Aa, Re, Re, Aa, Aa, Rr, Rr, Gd^Vh, Gd, Gd, Gd, Gd^Fp, Gd, Gd, Gd^Fp, Gd, Gd, Gd, Mm, Gd, Gd, Gs^Fp, Gd^Ve, Hh^Fp, Hh^Fp, Mm, Hhd, Ha^Fpa, Ha^Fpa
Gd, Aa, Aa, Aa, Ce, Ce^Edt, Ce, Aa, Rr, Rr, Aa, Gd, Gd, Gd, Gd, Gd^Fp, Gs^Fp, Gd^Fp, Gd^Fp, Gd, Gs^Fp, Gd, Gd^Ve, Gd, Gs^Fp, Gs^Fp, Gs^Fp, Gs^Fp, Hh, Mm, Hh, Hh^Fp, Hh, Hh
Gd, Gd, Aa, Aa, Ce^Edt, 2 Ke, Ce, Rr, Aa, Aa, Ha, Aa, Aa, Gd, Gd, Gd, Gd, Gd, Gd^Fp, Gs^Fp, Gs^Efm, Gs^Fp, Gs^Fp, Gs^Fp, Cv, Cv, Cv, Gs^Fp, Hh, Hh, Mm, Mm, Hh^Fp, Hh^Fp
Gd, Gd, Gd, Aa, Rr, Ce, Rr, Rr, Gd, Aa, Ha, Ha, Gd, Gd, Gd^Fp, Gd, Gd, Gd^Fp, Gd^Fp, Gs^Fp, Gs^Fp, Gs^Fp, Gs^Efm, Gs^Efm, Cv, 3 Kv, Cv, Gs^Fp, Hh^Fp, Hh, Hh, Hh, Hh^Fp, Hh^Fp
Gd, Gd, Gd, Rr, Aa^Vh, Rr, Gd, Gd, Gd, Aa, Aa, Aa, Gd, Gd^Fp, Gd^Fp, Gd, Gd^Fp, Gs^Fp, Gs^Fp, Gs^Fp, Gs^Fp, Gs^Fp, Hh, Gs^Efm, Gs^Fp, Cv, Gs^Fp, Gs^Fp, Hh, Hh^Fp, Gs, Hh^Fp, Hh^Fp, Hh^Fp
Gd, Gd, Rr, Rr, Gd, Aa, Gd, Gd, Gd, Gd, Gd, Gd, Gd, Gd^Fp, Gs, Gd^Fp, Gs^Fp, Gs^Fp, Gs^Efm, Gs^Fp, Gs^Fp, Gs^Ve, Hh^Fp, Hh^Fp, Gs^Fp, Gs^Fp, Gs^Fp, Gs^Ve, Gs^Fp, Gs^Fp, Gs^Fp, Gs, Hh^Fp, Hh^Fp
Rr, Rr, Gd, Gd, Gd, Gd, Gll^Fp, Gll^Fp, Gd, Gd, Gd, Gd^Fp, Gd^Fp, Gs^Fp, Gs, Gs^Fp, Gs^Efm, Gs^Fp, Gs^Fp, Gs^Fp, Gs^Efm, Gs^Fp, Hh, Hh, Gs^Efm, Gs^Fp, Gs^Efm, Gs^Fp, Gs^Fp, Gs^Fp, Gs^Efm, Gs^Ve, Hh, Hh
Rr, Rr, Gd, Gd, Gd, Gd, Gd, Gll^Fp, Gd, Gd, Gd^Fp, Gs^Fp, Gd^Fp, Gs^Fp, Gs, Gs^Fp, Gs^Fp, Gs^Fp, Gs^Fp, Gs^Fp, Gs^Fp, Gs^Fp, Gs^Fp, Gs^Fp, Gs, Gs^Fp, Gs, Gs^Fp, Gs^Fp, Gs^Fp, Gs^Efm, Gs^Efm, Hh, Hh
