Aa, Aa, Aa^Fpa, Aa^Fpa, Aa, Aa^Fpa, Aa^Fpa, Aa, Aa^Fpa, Ai, Ai, Rd, Gd, Aa, Aa^Fpa, Ha, Ha, Aa^Fpa, Aa, Aa, Aa, Gd, Aa^Fpa, Aa^Fpa, Aa^Fpa, Aa^Fpa, Aa^Fpa, Ha, Aa^Fpa, Aa^Fpa, Aa^Fpa, Aa^Fpa, Aa, Aa
Aa, Aa^Es, Aa^Fpa, Aa^Fpa, Aa^Es, Aa^Fpa, Aa^Fpa, Aa^Em, Aa^Fpa, Ai, Ai, Rd, Re, Aa, Aa^Fpa, Ha, Ha, Aa^Fpa, Aa, Aa, Aa, Gd, Aa^Fpa, Aa^Fpa, Aa^Fpa, Aa^Fpa, Ha^Em, Ha^Fpa, Ha^Em, Aa^Fpa, Aa^Fpa, Aa^Fpa, Aa, Aa
Aa, Aa, Aa^Es, Aa^Fpa, Aa, Aa, Aa, Aa, Aa, Aa^Es, Ai, Ai, Rd, Aa, Aa, Aa^Fpa, Aa^Fpa, Aa^Fpa, Aa^Fpa, Aa^Fpa, Aa^Fpa, Aa^Fpa, Aa^Fpa, Aa^Fpa, Aa, Ha^Fpa, Aa^Fpa, Ha, Ha^Fpa, Ha^Fpa, Aa^Fpa, Aa, Ai, Ai
Aa^Fpa, Aa^Fpa, Aa^Fpa, Aa^Fpa, Aa^Fpa, Aa^Fpa, Aa^Fpa, Aa^Fpa, Aa^Fpa, Aa^Fpa, Aa^Fpa, Aa, Aa, Rd, Aa, Aa^Fpa, Aa^Fpa, Ai, Ai, Aa^Fpa, Aa, Aa^Fpa, Ha, Ha, Aa, Aa, Ha, Aa, Aa, Aa^Fpa, Aa^Fpa, Ai, Aa^Fpa, Aa^Fpa
Aa^Fpa, Aa^Fpa, Ha^Em, Ha^Em, Ha, Aa^Fpa, Ha, Aa, Aa^Fpa, Ha, Ha^Fpa, Ha, Aa, Re, Aa, Aa^Fpa, Aa^Fpa, Ai, Aa^Fpa, Aa^Fpa, Gd, Aa, Ha^Em, Ha^Em, Aa^Fpa, Aa, Ww, Ha, Ai, Ha^Em, Ww, Ai, Aa^Fpa, Aa^Fpa
Aa^Fpa, Aa^Fpa, Aa, Ms, Ai, Ha, Ha, Ha^Es, Ha, Aa^Fpa, Ha, Ha^Fpa, Aa, Rd, Aa, Aa, Aa^Fpa, Aa^Fpa, Aa, Aa^Fpa, Aa^Fpa, Aa, Aa^Fpa, Aa^Fpa, Ww, Ww, Aa, Ai, Ww, Ww, Aa^Fpa, Aa^Fpa, Aa, Aa
Aa^Fpa, Aa^Fpa, Ha^Fpa, Ha, Ai, Ai, Ha, Ha^Fpa, Ha, Aa^Fpa, Ha^Em, Aa^Fpa, Aa, Rd, Aa, Aa, Aa^Fpa, Aa^Fpa, Aa, Aa, Aa^Fpa, Aa^Fpa, Ai, Aa^Fpa, Ww, Aa, Aa^Fpa, Aa^Fpa, Ha, Ai, Aa^Em, Aa, Aa, Aa
Aa^Fpa, Aa^Fpa, Aa, Ha, Ha, Ha, Aa^Fpa, Gd, Ha, Aa^Fpa, Aa^Fpa, Aa^Fpa, Aa, Rd, Re, Aa, Aa^Fpa, Aa^Fpa, Aa, Gd, Aa^Fpa, Ai, Ww, Ww, Ha, Aa, Ha^Es, Aa^Fpa, Aa^Fpa, Aa^Fpa, Aa^Fpa, Aa^Em, Aa^Fpa, Aa^Fpa
Aa^Fpa, Aa^Fpa, Aa^Fpa, Aa^Fpa, Ha, Ha, Aa, Aa, Ms, Aa^Fpa, Aa^Fpa, Aa^Fpa, Aa^Fpa, Re, Rd, Aa, Aa^Fpa, Aa^Fpa, Aa^Fpa, Aa^Fpa, Aa, Ai, Ww, Ai, Aa^Fpa, Ha, Ha^Fpa, Ha^Es, Aa^Fpa, Aa^Fpa, Aa^Em, Aa^Fpa, Aa, Aa
Aa, Aa, Ha^Em, Ha, Ha^Em, Aa^Fpa, Ha, Aa, Aa^Fpa, Ha^Em, Aa^Fpa, Aa, Aa^Fpa, Aa, Rd, Aa, Ai, Ai, Ww, Ww, Ww, Ww, Ai, Ai, Ha, Ha, Ha, Ha^Em, Aa, Aa^Em, Aa, Aa^Fpa, Aa, Aa
Aa, Aa, Aa^Fpa, Aa^Fpa, Aa^Fpa, Aa^Fpa, Ha, Ha^Fpa, Aa^Es, Aa^Fpa, Aa^Fpa, Aa^Fpa, Aa, Aa, Ww^Bw|, Ww, Ww, Ww, Ai, Aa^Fpa, Aa^Fpa, Aa, Aa^Fpa, Aa^Fpa, Ha^Em, Ms, Ha, Aa^Fpa, Aa^Fpa, Ha^Fpa, Aa^Fpa, Gd, Aa^Fpa, Aa^Fpa
Aa, Aa, Aa^Fpa, Gd^Em, Aa^Fpa, Ha^Es, Ha^Es, Ha, Aa, Aa^Em, Aa^Fpa, Aa, Ww, Ww, Rd, Gd, Aa, Ai, Aa^Fpa, Aa^Fpa, Aa^Es, Aa^Fpa, Aa^Fpa, Aa^Fpa, Aa^Fpa, Ha^Es, Aa^Fpa, Aa^Fpa, Ha^Em, Ha^Em, Ha, Aa^Fpa, Aa^Fpa, Aa^Fpa
Aa^Es, Aa, Aa, Aa^Fpa, Aa^Fpa, Aa^Fpa, Ha^Fpa, Ha^Fpa, Aa^Fpa, Aa^Fpa, Ai, Ww, Aa^Fpa, Aa, Aa, Rd, Gd, Aa, Aa^Fpa, Aa^Fpa, Ai, Ai^Es, Aa^Fpa, Aa^Fpa, Ha^Es, Aa^Fpa, Aa^Fpa, Aa^Fpa, Ha, Ms, Ha, Aa^Fpa, Aa^Fpa, Aa^Fpa
Aa, Aa^Es, Aa^Fpa, Aa, Aa^Fpa, Aa^Fpa, Aa^Fpa, Ha, Ai, Ha, Ww, Aa, Aa, Aa, Aa, Rd, Gd, Aa, Aa^Fpa, Gd, Ai, Ai, Aa^Fpa, Ha, Ms, Ha, Aa^Fpa, Aa^Fpa, Aa^Fpa, Ha, Aa^Fpa, Aa^Fpa, Aa^Fpa, Aa^Fpa
Re, Re, Rd, Aa, Aa, Aa^Fpa, Ai, Aa^Fpa, Ww, Ww, Ai, Aa^Fpa, Aa^Fpa, Aa^Fpa, Rd, Re, Aa, Aa, Aa^Fpa, Aa^Fpa, Aa^Fpa, Aa^Fpa, Aa^Fpa, Ha, Ha, Ha^Em, Aa^Fpa, Aa^Fpa, Aa^Fpa, Aa^Fpa, Ai, Aa^Fpa, Aa^Fpa, Aa^Fpa
Aa, Aa, Aa, Rd, Ai^Bw\, Ai, Ai, Ww, Aa^Fpa, Ai, Aa^Fpa, Aa^Fpa, Aa^Fpa, Aa, Rd, Gd, Aa, Aa, Aa^Fpa, Aa^Fpa, Aa, Aa, Aa^Fpa, Aa^Fpa, Ha, Ha^Fpa, Ha, Ha^Em, Aa^Fpa, Ai, Ai, Aa^Fpa, Aa^Fpa, Aa^Fpa
Aa, Aa, Ww, Ww, Gd, Rd, Re, Aa^Fpa, Aa^Fpa, Aa^Fpa, Aa, Aa^Fpa, Aa^Em, Aa^Fpa, Aa, Rd, Re, Aa, Aa, Aa^Fpa, Aa^Fpa, Aa, Ha, Aa^Fpa, Ha, Ha, Ha, Ha^Em, Aa^Fpa, Aa^Em, Aa, Aa^Fpa, Aa^Fpa, Aa^Fpa
Ai, Ai, Aa, Aa^Fpa, Aa, Aa, Gd, Rd, Aa, Aa^Fpa, Aa, Aa, Aa^Fpa, Aa^Fpa, Aa, Aa, Rd, Gd, Aa, Aa^Fpa, Aa^Fpa, Aa^Fpa, Ha, Ha, Aa, Ha^Fpa, Aa, Ha, Ha, Aa^Fpa, Ha^Em, Ha^Fpa, Aa^Fpa, Aa^Fpa
Ww, Ww, Aa, Aa, Aa^Fpa, Aa^Em, Gd, Rd, Rd, Aa, Aa, Ha^Fpa, Ha, Aa, Ha, Aa, Rd, Aa, Aa, Aa^Fpa, Ha, Aa^Fpa, Aa, Aa^Fpa, Aa^Es, Aa^Es, Aa^Fpa, Ha, Aa^Fpa, Aa^Fpa, Aa^Fpa, Aa^Fpa, Aa, Aa
Aa^Fpa, Aa^Fpa, Aa^Fpa, Aa^Em, Aa^Fpa, Aa^Fpa, Aa, Gd, Rd, Gd, Ha, Ha, Ms, Ms, Cud, Ha, Rd, Gd, Aa, Aa^Fpa, Ha, Ha, Aa, Aa, Aa^Fpa, Aa^Fpa, Aa^Fpa, Aa^Fpa, Aa, Aa, Aa, Aa, Rd, Rd
Gd, Gd^Es, Gd^Es, Gd^Es, Ha^Fpa, Aa, Ha, Ha, Ha, Rd, Rr, Cud, Ha, Ha, Ha, Rr, Cud, Ha, Aa, Aa^Fpa, Aa^Fpa, Aa^Fpa, Aa^Fpa, Aa^Fpa, Aa, Aa, Rd, Aa, Rd, Re, Re, Rd, Gd, Gd
Gd, Gd, Ha, Ha, Ha, Ha, Ha^Es, Ha^Es, Ms, Cud, Aa, Aa^Vha, Aa, Gs, Rr, Aa^Vha, Ms, Ha, Ha, Aa^Fpa, Aa^Fpa, Aa^Fpa, Aa, Aa, Re, Rd, Gd, Rd, Aa, Re, Aa, Aa, Aa, Aa
Gd, Gd, Ha, Ms, Ha, Ms, Ms, Ms, Ha, Ha, Gs, Rr, Rr, Rr, Gs, Ha, Ms, Ms, Ha, Aa, Aa, Aa, Gd, Aa, Rd, Gd, Aa^Fpa, Aa, Aa^Fpa, Aa, Aa^Fpa, Aa^Fpa, Aa^Fpa, Aa^Fpa
Ha, Ha, Ha, Ms, Ms, Ms, Ha, Ms, Ha, Aa, Gs, Gs, Rr, Rr, Rr, Ha, Ha, Ms, Ha, Aa, Aa, Gd, Re, Rd, Aa, Aa^Fpa, Aa^Em, Aa^Fpa, Ha^Em, Aa^Fpa, Ha, Ha, Ha, Ha
Ms, Ms, Ai, Ms, Ha^Es, Ms, Ha, Ha, Aa, Aa^Vha, Rr, Rr, Aa, Gs, Ha, Rr, Rr, Cud, Rd, Rd, Rd, Rd, Aa, Aa, Aa^Fpa, Aa^Fpa, Aa^Fpa, Aa^Fpa, Ha, Ha^Em, Ha, Ms, Ha, Ha
Ha, Ha, Ai, Ha^Es, Ha^Es, Ha, Ha^Vhha, Aa, Gs, Rr, Gs, Gs, Aa, Aa, Ha, Ha, Aa^Vha, Rr, Ha, Aa, Gd, Aa^Fpa, Aa^Fpa, Aa, Aa^Fpa, Aa^Fpa, Ai, Aa^Fpa, Aa^Em, Aa^Fpa, Aa^Em, Ha, Aa^Fpa, Aa^Fpa
Ms, Ms, Ms, Ms, Ha, Ha, Cud, Gs, Rr, Rr, Gs, Gs, Aa^Vha, Ha, Ha, Ms, Ms, Cud, Ha, Gd, Gd, Aa^Fpa, Aa^Em, Aa, Aa^Em, Aa^Fpa, Ai, Ai, Ai, Aa, Ai, Ai, Ai, Ai
Mm^Xm, Ha, Mm^Xm, Ha, Ha, Cud, 1 Kud, Cud, Gs, Gs, Ai, Ai, Ai^Es, Ha, Ha, Ms, Ha, Ms, Ha, Aa, Aa, Aa^Fpa, Aa^Fpa, Aa^Fpa, Aa^Fpa, Aa^Fpa, Ha^Fpa, Ha^Fpa, Ha^Fpa, Ai, Ha, Aa^Fpa, Ai, Ai
Mm^Xm, Mm^Xm, Mm^Xm, Xu, Ur, Cud, Cud, Cud, Ha, Ha^Vhha, Ha^Es, Ai, Aa^Es, Aa, Ha, Ha, Ms, Ms, Ha, Ha, Aa, Aa^Es, Gd^Es, Aa^Fpa, Aa^Fpa, Aa^Em, Ha^Fpa, Ha, Ms, Ha, Aa^Fpa, Ai, Aa^Fpa, Aa^Fpa
Mm^Xm, Mm^Xm, Mm^Xm, Xu, Xu, Ha, Ha, Ha, Ha, Ms, Ha, Ms, Ms, Ms, Ha, Ms, Ha, Ha, Ms, Ha, Ha, Gd, Gd^Es, Aa^Es, Aa, Aa, Aa^Fpa, Ha, Ha^Es, Ha, Ha^Es, Ai, Ai, Ai
Mm^Xm, Mm^Xm, Mm^Xm, Mm^Xm, Mm^Xm, Ms, Ms, Ms, Ms, Ms, Ms, Ms, Ms, Ms, Ms, Ms, Ms, Ha, Ha, Ms, Ha^Es, Aa, Aa^Es, Aa, Aa^Fpa, Aa, Aa^Fpa, Aa^Fpa, Ha^Fpa, Aa^Fpa, Ha^Fpa, Aa^Fpa, Aa^Fpa, Aa^Fpa
Mm^Xm, Mm^Xm, Mm^Xm, Mm^Xm, Mm^Xm, Ms, Ms, Ms, Ms, Ms, Ms, Ms, Ms, Ms, Ms, Ms, Ms, Ha, Ha, Ms, Ha, Aa^Es, Aa, Aa, Aa^Fpa, Aa^Em, Aa^Fpa, Aa^Fpa, Ha^Fpa, Ha^Fpa, Ha^Fpa, Aa^Fpa, Aa^Fpa, Aa^Fpa
