Xu, Xu, Xu, Xu, Xu, Xu, Uu, Uu, Uu, Uu, Uu, Uu, Uu, Xu, Xu, Xu, Mm, Ha, Ha^Fpa, Aa, Aa, Aa, Ha, Ha, Mm, Mm, Mm, Ha, Ha, Gs, Aa^Fpa, Aa^Fpa, Ha, Ha^Fpa, Mm, Mm, Mm, Ha, Ha, Aa, Aa, Aa
Xu, Xu, Xu, Xu, Xu, Xu, Uu, Uu, Uu, Uu, Uu^Vud, Uu, Uu, Xu, Xu, Xu, Mm, Ha, Ha^Fpa, Aa, Aa, Aa, Ha, Ha^Vhha, Mm, Mm, Mm, Ha, Ha, Gs, Aa^Fpa, Aa^Fpa, Ha^Fpa, Ha^Fpa, Mm, Mm, Mm, Ha, Ha, Aa, Aa, Aa
Xu, Xu, Cud, Cud, Cud, Uu^Vud, Xu, Xu, Xu, Xu, Xu, Re, Mm, Xu, Mm, Mm, Aa, Gs, Gs, Gs, Ha, Ha, Mm, Mm, Mm, Mm, Mm, Mm, Mm, Ha, Ha, Ha, Mm, Ha, Mm, Mm, Xu, Mm, Mm, Ha, Ha, Ha
Mm, Mm, Cud, 1 Kud, Cud, Uu, Xu, Mm, Mm, Mm, Mm, Re, Mm, Mm, Ha, Ha, Ha, Ha, Ha, Ha, Ha, Mm, Ha, Mm, Mm, Mm, Ha, Mm, Ha, Ha, Aa, Ha, Ha, Mm, Mm, Xu, Uu, Xu, Mm, Mm, Mm, Mm
Mm, Mm, Mm, Cud, Re, Xu, Mm, Mm, Ha, Ha, Re, Re, Mm, Ha, Ha, Mm, Mm, Mm, Mm, Mm, Ha, Ha, Aa, Ha, Ha, Mm, Ha, Ha, Gs, Gs, Aa, Aa, Ha, Mm, Mm, Mm, Xu, Xu, Mm, Mm, Ha, Ha
Mm, Mm, Mm, Mm, Re, Mm, Mm, Mm, Ha, Gs, Re, Ha, Ha, Mm, Mm, Mm, Mm, Ha, Ha, Ha, Aa, Gs, Gs, Aa, Ha, Mm, Ha, Aa, Aa^Fpa, Aa^Fpa, Ha, Ha, Mm, Mm, Mm, Mm, Mm, Mm, Ha, Ha, Aa, Aa
Mm, Mm, Mm, Mm, Mm, Re, Re, Mm, Mm, Mm, Ha, Re, Gs, Ha, Ha^Vhha, Mm, Mm, Ha, Gs, Gs, Aa, Aa, Aa^Fpa, Aa, Gs, Ha, Gs, Aa, Aa^Fpa, Aa^Fpa, Ha, Mm, Mm, Mm, Ha, Ha, Mm, Ha, Ha, Aa^Vha, Aa, Aa
Mm, Mm, Ha, Mm, Ha^Fpa, Ha, Re, Ha, Mm, Ha, Ha, Re, Aa, Gs, Gs, Ha, Mm, Ha, Ha, Aa, Aa, Gs, Aa^Fpa, Aa^Fpa, Aa^Fpa, Gs, Aa^Fpa, Aa^Fpa, Aa^Fpa, Aa^Fpa, Aa^Fpa, Ha, Ha, Ha, Gs, Ha, Ha, Mm, Ha^Fpa, Aa, Aa, Aa
Ha, Ha, Ha, Ha^Fpa, Gs, Aa^Fpa, Re, Aa^Vha, Ha, Mm, Ha, Re, Aa^Fpa, Aa^Fpa, Aa^Fpa, Ha, Ha, Ha, Mm, Ha, Ha, Gs, Gs, Aa^Fpa, Aa^Fpa, Aa^Fpa, Aa^Fpa, Aa^Fpa, Aa^Fpa, Aa^Fpa, Aa^Fpa, Aa^Vha, Ha, Aa, Aa, Aa, Aa, Ha, Aa, Aa^Fpa, Aa^Fpa, Aa^Fpa
Ha, Ha, Mm, Ha, Aa, Aa^Fpa, Aa^Fpa, Re, Re, Ha, Re, Re, Aa^Fpa, Ha^Fpa, Aa^Fpa, Aa, Ha, Ha, Mm, Mm, Mm, Ha, Gs, Gs, Gs, Gs, Aa^Fpa, Aa^Fpa, Aa^Fpa, Gs, Gs, Ha, Mm, Ha, Gs, Ha^Fpa, Aa, Gs, Aa^Fpa, Aa^Fpa, Aa^Fpa, Aa^Fpa
Ha, Ha, Mm, Ha, Ha, Aa, Gs, Gs, Ha, Re, Re, Ha, Gs, Aa^Fpa, Gs, Ha, Ha, Mm, Mm, Mm, Mm, Ha, Ha, Gs, Ha, Gs, Gs, Aa^Fpa, Gs, Aa^Fpa, Ha, Mm, Mm, Ha, Aa, Aa, Aa^Fpa, Aa^Fpa, Aa^Fpa, Aa^Fpa, Aa^Fpa, Aa^Fpa
Ha, Ha, Mm, Mm, Mm, Ha, Aa^Fpa, Gs, Ha, Mm, Mm, Re, Re, Aa, Ha, Ha, Mm, Mm, Xu, Xu, Xu, Mm, Mm, Ha, Mm, Ha, Ha, Gs, Ha, Gs, Ha, Mm, Mm, Ha, Aa, Aa, Aa, Aa^Fpa, Aa^Fpa, Aa^Fpa, Aa^Fpa, Aa^Fpa
Mm, Mm, Mm, Mm, Mm, Ha, Aa^Fpa, Aa^Vha, Gs, Ha, Mm, Mm, Mm, Re, Re, Mm, Uu, Xu, Uu, Uu^Vud, Uu, Xu, Uu, Mm, Mm, Mm, Mm, Ha, Mm, Ha, Ha, Ha, Ha, Ha, Ha, Aa^Vha, Gs, Gs, Aa^Fpa, Aa^Fpa, Aa^Fpa, Aa^Fpa
Mm, Mm, Mm, Mm, Ha, Ha, Gs, Aa^Fpa, Aa, Ha, Ha, Mm, Mm, Mm, Xu, Re, Re, Uu, Uu, Uu, Uu, Uu, Uu, Uu, Xu, Mm, Mm, Mm, Mm, Mm, Ha, Ha, Gs, Ha, Mm, Ha, Ha, Gs, Gs, Gs, Aa, Aa
Mm, Mm, Mm, Mm, Mm, Ha, Gs, Aa^Fpa, Aa, Aa, Ha, Mm, Mm, Xu, Uu^Vud, Uu, Uu, Re, Re, Uu^Vud, Uu, Uu, Uu, Uu, Uu^Vud, Xu, Mm, Mm, Mm, Ha^Vhha, Ha, Gs, Gs, Ha, Mm, Mm, Ha, Gs, Gs, Aa, Aa, Aa
Mm, Mm, Ha, Mm, Mm, Ha, Gs, Ha, Ha, Aa, Gs, Ha, Mm, Xu, Uu, Uu, Uu^Vud, Uu, Re, Re, Re, Uu, Uu^Vud, Uu, Uu, Xu, Mm, Mm, Ha, Ha, Gs, Gs, Aa, Ha, Ha, Mm, Mm, Ha, Ha, Ha, Ha, Ha
Ha, Ha, Aa, Ha, Ha, Ha, Gs, Ha, Gs, Aa, Aa^Fpa, Ha, Ha, Uu, Uu, Uu, Uu, Re, Cud, Cud, Cud, Re, Re, Uu, Re, Re, Re, Ha, Gs, Gs, Aa^Fpa, Aa^Fpa, Aa^Fpa, Aa, Ha, Mm, Mm, Mm, Mm, Mm, Mm, Mm
Aa, Aa, Aa, Gs, Aa, Aa, Aa, Gs, Aa^Vha, Aa^Fpa, Aa^Fpa, Aa^Fpa, Mm, Uu, Uu, Uu, Uu, Re, Cud, 2 Kud, Cud, Re, Uu, Re, Uu, Uu, Mm, Re, Re, Gs, Aa^Fpa, Aa^Fpa, Aa^Fpa, Aa, Ha, Mm, Mm, Mm, Mm, Mm, Ha, Ha
Aa, Aa, Aa^Fpa, Aa^Fpa, Aa^Fpa, Aa, Ha, Ha, Aa, Aa, Ha, Mm, Mm, Xu, Uu, Uu, Uu^Vud, Re, Re, Cud, Re, Re, Uu^Vud, Uu, Uu, Xu, Mm, Aa^Fpa, Gs, Re, Re, Aa^Fpa, Aa, Ha, Mm, Mm, Mm, Mm, Mm, Mm, Aa^Vha, Aa
Gs, Gs, Aa^Fpa, Aa^Fpa, Aa^Fpa, Aa, Ha, Ha, Gs, Aa, Ha, Mm, Mm, Xu, Uu^Vud, Uu, Re, Re, Ai, Re, Ai, Ai, Ai, Ai, Uu^Vud, Xu, Mm, Ha, Ha, Gs, Re, Aa^Fpa, Gs, Ha, Mm, Mm, Mm, Mm, Ha, Ha, Gs, Gs
Gs, Gs, Gs, Aa^Fpa, Aa^Fpa, Aa^Fpa, Gs, Gs, Ha, Ha, Mm, Mm, Mm, Xu, Xu, Uu, Re, Uu, Ai, Ai, Ai, Ai, Ai, Ai, Xu, Xu, Mm, Mm, Mm, Ha, Re, Gs, Gs, Ha, Ha, Ha, Mm, Mm, Ha, Ha, Gs, Gs
Ha, Ha, Ha, Gs, Aa^Fpa, Aa^Fpa, Aa^Fpa, Gs, Ha, Ha, Mm, Mm, Mm, Mm, Mm, Xu, Re, Uu, Uu, Ai, Ai, Ai, Ai, Xu, Mm, Mm, Mm, Mm, Mm, Ha, Ha, Re, Gs, Gs, Aa, Ha, Aa^Fpa, Mm, Aa^Fpa, Aa^Fpa, Aa^Fpa, Aa^Fpa
Mm, Mm, Ha, Gs, Gs, Aa^Fpa, Gs, Aa^Fpa, Ha, Mm, Mm, Mm, Ha, Mm, Ha, Mm, Re, Uu, Xu, Uu^Vud, Xu, Ai, Ai, Mm, Mm, Mm, Mm, Mm, Mm, Mm, Ha, Re, Gs, Aa, Aa, Aa^Fpa, Aa^Fpa, Ha, Aa^Fpa, Aa^Fpa, Aa^Fpa, Aa^Fpa
Mm, Mm, Mm, Ha, Aa^Fpa, Gs, Ha, Gs, Ha, Ha, Ha, Ha, Ha, Ha, Ha, Re, Ha, Mm, Mm, Xu, Mm, Mm, Ww, Ww, Ha, Ha, Ha, Ha, Ha, Mm, Re, Re, Ha, Aa, Ha, Aa^Fpa, Ha, Ha, Ha^Vhha, Aa^Fpa, Aa^Fpa, Aa^Fpa
Mm, Mm, Mm, Mm, Ha, Ha, Ha, Aa^Vha, Re, Re, Re, Re, Re, Re, Re, Re, Gs, Ha, Mm, Mm, Mm, Mm, Ww, Ww, Gs, Gs, Gs, Gs, Gs, Re, Gs, Gs, Ha, Ha, Mm, Ha, Mm, Mm, Ha, Aa^Fpa, Ha, Ha
Mm, Mm, Mm, Mm, Ha, Gs, Ha, Re, Ha, Mm, Mm, Ha, Gs, Ha, Ha, Gs, Gs, Ha, Mm, Mm, Ha, Ha, Ww, Ww, Gs, Gs, Ha, Gs, Re, Re, Gs, Gs, Gs, Ha, Mm, Mm, Mm, Mm, Ha, Ha, Mm, Mm
Mm, Mm, Mm, Mm, Ha, Gs, Gs, Re, Ha, Mm, Mm, Ha, Ha, Ha, Mm, Ha, Gs, Ha, Ha, Mm, Ha, Ha, Ww, Ww, Gs, Ha, Ha, Re, Aa^Fpa, Aa^Fpa, Aa^Fpa, Gs, Ha, Ha, Ha, Mm, Mm, Mm, Mm, Mm, Ha, Ha
Ha, Ha, Ha, Ha, Ha, Gs, Re, Re, Ha, Ha, Mm, Mm, Mm, Mm, Mm, Ha, Gs, Gs, Ha, Ha, Ww, Ww, Ww, Aa^Fpa, Gs, Ha, Gs, Re, Aa^Fpa, Aa^Fpa, Aa^Fpa, Gs, Ha, Ha, Mm, Mm, Mm, Mm, Mm, Mm, Ha, Ha
Aa, Aa, Aa, Aa, Aa, Gs, Re, Gs, Ha, Mm, Mm, Mm, Mm, Mm, Ha, Ha, Gs, Gs, Gs, Gs, Ww, Ww, Aa^Fpa, Aa^Fpa, Aa^Fpa, Gs, Gs, Re, Gs, Aa^Fpa, Aa^Fpa, Aa^Fpa, Ha, Mm, Mm, Mm, Mm, Mm, Mm, Mm, Ha, Ha^Fpa
Aa, Aa, Aa^Fpa, Gs, Re, Re, Ha, Gs, Ha, Mm, Mm, Mm, Mm, Mm, Ha, Ha, Gs, Gs, Gs, Gs, Ww, Ww, Ww, Aa^Fpa, Aa^Fpa, Aa^Fpa, Gs, Re, Re, Gs, Gs, Gs, Ha, Mm, Ha, Mm, Mm, Mm, Mm, Ha, Ha^Fpa, Ha^Fpa
Aa^Fpa, Aa^Fpa, Aa^Fpa, Re, Ha, Ha, Mm, Ha, Ha^Vhha, Ha, Ha, Ha, Ha, Mm, Ha, Ha, Ha, Ha, Gs, Gs, Aa^Fpa, Ww, Ww, Aa^Fpa, Aa, Aa, Aa, Gs, Gs, Re, Gs, Gs, Aa^Fpa, Ha^Vhha, Gs, Ha, Ha, Mm, Mm, Mm, Ha, Ha^Fpa
Aa^Fpa, Aa^Fpa, Aa^Fpa, Re, Ha, Ha, Mm, Mm, Mm, Ha, Mm, Mm, Ha, Ha, Mm, Ha^Vhha, Mm, Ha, Gs, Gs, Ai, Ai, Ww, Ai, Ai, Aa, Gs, Aa, Gs, Re, Gs, Gs, Aa^Fpa, Aa^Fpa, Gs, Gs, Ha, Mm, Ha, Ha, Aa^Vha, Aa
Aa^Fpa, Aa^Fpa, Re, Re, Gs, Ha, Mm, Mm, Mm, Ha, Ha, Ha, Mm, Ha, Mm, Mm, Ha, Ha, Aa, Gs, Ai, Ai, Ai, Ww, Ai, Aa, Aa, Aa, Gs, Re, Re, Gs, Gs, Gs, Aa, Gs, Gs, Ha, Gs, Gs, Aa^Fpa, Aa^Fpa
Re, Re, Gs, 3 Gs, Aa, Ha^Vhha, Ha, Mm, Mm, Mm, Mm, Mm, Mm, Mm, Mm, Ha, Aa, Aa, Aa^Fpa, Gs, Gs, Ai, Ai, Ww, Ha, Ha, Mm, Aa, Gs, Gs, Re, Gs, Aa, Aa, Aa, Aa, Gs, Gs, Aa^Fpa, Aa^Fpa, Aa^Fpa, Aa^Fpa
Gs, Gs, Gs, Aa, Ha, Ha, Ha, Ha, Mm, Mm, Mm, Mm, Mm, Mm, Mm, Ha, Ha^Fpa, Aa, Aa^Fpa, Aa^Fpa, Gs, Aa, Aa, Ww, Ww, Mm, Mm, Ha, Gs^Vh, Gs, Re, Gs, Gs, Aa^Vha, Aa, Aa, Aa, Gs, Gs, Aa^Fpa, Aa^Fpa, Aa^Fpa
Gs, Gs, Gs, Ha, Ha, Ha, Mm, Mm, Mm, Mm, Mm, Mm, Mm, Mm, Ha, Ha, Ha^Fpa, Ha, Ha, Aa^Fpa, Gs, Aa, Ww, Ww, Ww, Mm, Mm, Ha, Gs, Gs, Gs, Re, Gs, Gs, Gs, Aa, Aa, Aa, Aa^Fpa, Gs, Gs, Gs
Aa^Fpa, Aa^Fpa, Gs, Ha, Ha, Mm, Mm, Mm, Mm, Mm, Ha, Mm, Mm, Mm, Mm, Ha, Ha, Ha, Aa^Fpa, Ha^Fpa, Gs, Ww, Ww, Ww, Ha, Mm, Ha, Gs, Aa^Fpa, Aa^Fpa, Gs, Re, Gs, Gs, Gs, Gs, Gs, Gs, Aa^Fpa, Gs, Gs^Vh, Gs
Aa^Fpa, Aa^Fpa, Gs, Gs, Ha, Mm, Mm, Mm, Ha, Mm, Ha, Ha, Ha, Mm, Mm, Mm, Ha, Aa, Aa^Fpa, Ha, Gs, Ww, Ai, Gs, Gs, Ha, Gs, Gs, Gs, Aa^Fpa, Re, Re, Gs, Gs, Gs, Gs, Aa^Fpa, Gs, Aa, Aa, Gs, Gs
Aa^Fpa, Aa^Fpa, Aa^Fpa, Ha^Fpa, Mm, Mm, Mm, Ha, Ha^Vhha, Ha, Ha, Ha, Ha, Mm, Mm, Mm, Mm, Ha, Gs, Gs, Ww, Ww, Ai, Ai, Gs, Gs, Aa, Aa, Aa, Gs, Re, Gs, Gs, Gs, Gs, Gs, Aa^Fpa, Aa^Fpa, Aa, Aa, Aa, Aa
Aa^Fpa, Aa^Fpa, Ha^Fpa, Ha^Fpa, Mm, Mm, Mm, Ha, Ha, Ha, Ha, Ha, Ha, Mm, Mm, Mm, Mm, Ha, Gs, Gs, Ww, Ww, Ai, Ai, Gs, Gs, Aa, Aa, Aa, Gs, Re, Gs, Gs, Gs, Gs, Gs, Aa^Fpa, Aa^Fpa, Aa, Aa, Aa, Aa
