Gd, Aa, Aa^Fda, Aa^Fda, Aa, Aa, Aa, Ha, Ms, Ms, Ms, Ms, Xu, Xu, Xu, Xu, Xu, Xu, Xu, Ms, Ha, Ha, Ha, Ha, Ha, Aa, Ha, Ha, Ms, Ha, Ha, Aa, Aa, Aa
Aa, Aa^Fpa, Aa^Fpa, Ha, Aa, Aa, Ha, Ha, Ms, Ms, Ms, Xu, Xu, Xu, Xu, Xu, Xu, Xu, Xu, Xu, Xu, Xu, Xu, Ms, Xu, Ms, Ms, Ms, Ms, Ms, Ha, Ha, Ha, Aa
Aa, Aa^Fma, Aa^Fma, Ha, Ha, Ha, Ha, Ha, Ms, Ms, Xu, Xu, Xu, Xu, Xu, Xu, Xu, Xu, Xu, Xu, Xu, Xu, Xu, Xu, Xu, Xu, Xu, Xu, Ms, Ms, Ms, Ha, Ha, Aa
Aa, Aa^Fda, Aa^Fda, Aa^Fda, Ha, Ha, Ms, Ms, Ms, Xu, Xu, Xu, Uh, Xu, Xu, Xu, Xu, Xu, Uh, Xu, Xu, Xu, Xu, Xu, Xu, Xu, Xu, Xu, Xu, Ms, Ha, Ha, Ms, Ha
Aa^Fpa, Aa, Gd, Aa, Ha, Ha, Xu, Ms, Xu, Xu, Xu, Uh, Uh, Uh, Uu^Uf, Xu, Uu, Uu, Xu, Uh, Uu, Xu, Xu, Xu, Xu, Xu, Xu, Xu, Xu, Ms, Ha, Ha, Ms, Ms
Aa^Fda, Aa^Fda, Gd, Aa, Gd, Xu, Xu, Xu, Xu, Xu, Cud, Cud, Rd, Uu^Uf, Uu, Uu^Em, Rd, Uu, Rd, Xu, Uu, Uu^Vu, Xu, Xu, Xu, Xu, Xu, Xu, Xu, Xu, Xu, Xu, Xu, Ha
Ha, Gd, Aa^Fpa, Gd, Xu, Xu, Xu, Xu, Uu, Cud, Cud, Rd, Cud, Cud, Uu, Rd, Uu, Rd, Xu, Rd, Uu^Uf, Uu, Uu, Uh, Uh, Xu, Xu, Xu, Xu, Xu, Xu, Xu, Xu, Ha
Ha, Ha, Ha, Aa^Fpa, Xu, Xu, Uh, Uh, Rd, Rd, Uu, Cud, Kud, Cud, Uu, Uu, Uu, Xu, Xu, Xu, Uu^Uf, Uu, Uu, Uh, Uh, Xu, Xu, Xu, Xu, Xu, Xu, Xu, Xu, Ha
Ha, Ms, Ha, Ms, Xu, Xu, Uh, Uu, 1 Rd, Uu, Uu, Uu, Cud, Cud, Uu, Uu, Uu, Uu, Uu, Xu, Uu^Vu, Uu, Rd, Uu^Uf, Uh, Xu, Xu, Xu, Xu, Xu, Xu, Xu, Xu, Xu
Aa, Aa, Cea, Ms, Xu, Xu, Uu, Uu, Uu, Uu, Uu, Cud, Cud, Uh, Uh, Uh, Xu, Uu, Uh, Uu, Uu, Xu, Rd, Uu^Uf, Uu^Uf, Uu^Uf, Uh, Xu, Xu, Xu, Xu, Xu, Xu, Xu
Aa, Cea, 2 Kea, Cea, Xu, Xu, Uu, Uu, Uh, Xu, Xu, Cud, Xu, Cud, Xu, Xu, Xu, Xu, Xu, Uh, Uu, Rd, Uu, Uu, Xu, Uu, Uh, Xu, Xu, Xu, Xu, Xu, Xu, Xu
Gd, Cea, Cea, Xu, Uu^Vud, Uu, Rd, Uu, Uh, Xu, Xu, Xu, Xu, Xu, Xu, Xu, Xu, Xu, Xu, Uu^Em, Uu, Rd, Uu^Uf, Uu, Uu, Xu, Uu, Xu, Xu, Xu, Xu, Xu, Xu, Xu
Aa, Cea, Cea, Xu, Uu, Uu, Rd, Uu, Xu, Xu, Xu, Xu, Xu, Xu, Xu, Xu, Uh, Xu, Uu, Uu, Uh, Uh, Xu, Xu, Xu, Uu, Xu, Ql, Ql, Xu, Xu, Xu, Xu, Xu
Gd, Aa, Cea, Uu, Rd, Rd, Uh, Xu, Xu, Xu, Xu, Xu, Xu, Xu, Uh, Uh, Rd, Uu, Uu^Uf, Uu^Uf, Uu^Uf, Uh, Xu, Xu, Xu, Xu, Uh, Uu^Uf, Uu^Uf, Uu^Uf, Uh, Xu, Xu, Xu
Gd, Cea, Cea, Rd, Uu^Vud, Uu, Xu, Xu, Xu, Xu, Ql, Ql, Ql, Ql, Uu, Rd, Uu, Uu, Uu, Uu^Vu, Xu, Xu, Xu, Xu, Uu, Uh, Uu, Uu, Uu, Uu, Uu, Uh, Xu, Xu
Aa, Aa, Ha, Ha, Xu, Xu, Xu, Xu, Cud, Xu, Ql, Xu, Ql, Ql, Uu, Rd, Uh, Uh, Xu, Xu, Xu, Xu, Uh, Uh, Rd, Rd, Uu, Rd, Rd, Xu, Uu, Uu^Em, Xu, Xu
Aa^Fpa, Aa^Fpa, Xu, Xu, Xu, Xu, Cud, Cud, Ql, Ql, Ql, Ql, Ql, Uu, Uu, Uu, Uh, Xu, Xu, Xu, Xu, Xu, Uh, Uh, Uu, Uh, Xu, Xu, Rd, Uu, Uh, Uh, Xu, Xu
Ha, Ha^Fma, Xu, Xu, 3 Kud, Cud, Uu^Vu, Ql, Ql, Ql, Xu, Xu, Xu, Xu, Uh, Uu, Uu, Uu^Vu, Xu, Xu, Xu, Uu^Uf, Uu^Uf, Uu, Ql, Xu, Xu, Ql, Uu^Vu, Uu, Uh, Uh, Xu, Xu
Ha, Ha^Fma, Xu, Xu, Cud, Cud, Ql, Ql, Ql, Ql, Uu^Vu, Xu, Xu, Xu, Uh, Uu, Uu, Rd, Rd, Rd, Rd, Uu^Uf, Uu, Uu, Xu, Xu, Ql, Ql, Uu, Uu, Uh, Xu, Xu, Xu
Ha, Ha, Xu, Xu, Cud, Ql, Ql, Ql, Ql, Ql, Xu, Xu, Xu, Xu, Xu, Uu^Vu, Uu, Uu, Uh, Uu, Uu^Uf, Uu, Uu^Vu, Ql, Xu, Xu, Uh, Uh, Uu, Uu, Ql, Ql, Xu, Xu
Ha, Ms, Xu, Xu, Cud, Uu^Vu, Ql, Ql, Ql, Ql, Ql, Xu, Xu, Xu, Ql, Ql, Ql, Uu, Uh, Uu^Uf, Uh, Uu^Uf, Xu, Xu, Ql, Ql, Rd, Uu^Uf, Uh, Xu, Xu, Xu, Xu, Xu
Ms, Ms, Xu, Xu, Xu, Cud, Ql, Ql, Ql, Ql, Ql, Uu^Vu, Xu, Xu, Ql, Xu, Xu, Xu, Xu, Xu, Xu, Xu, Xu, Xu, Ql, Xu, Rd, Uh, Ql, Xu, Xu, Xu, Xu, Xu
Ha, Xu, Xu, Xu, Uu^Vu, Cud, Cud, Uu^Vu, Xu, Ql, Ql, Ql, Xu, Xu, Ql, Xu, Xu, Xu, Xu, Xu, Xu, Xu, Xu, Xu, Uu, Rd, Uh, Uh, Xu, Xu, Xu, Xu, Ha^Fma, Xu
Aa, Xu, Xu, Xu, Xu, Xu, Xu, Xu, Xu, Xu, Ql, Ql, Uu^Uf, Uu^Uf, Uu, Uu, Uu, Uh, Uh, Xu, Uu^Uf, Uu^Uf, Uu, Uu^Em, Uu^Uf, Uu, Uu^Uf, Xu, Xu, Xu, Xu, Ha^Fda, Ha^Fda, Ha
Aa, Ha^Fpa, Ha^Fpa, Xu, Xu, Xu, Xu, Xu, Xu, Xu, Xu, Ql, Ql, Uu^Vu, Uu, Uu, Cud, Uh, Uu, Xu, Cud, Uu, Uu, Uh, Uh, Uu^Uf, Xu, Xu, Xu, Xu, Ha, Ha^Fda, Ha, Ha
Ha, Ha, Ha, Xu, Xu, Xu, Xu, Xu, Xu, Xu, Xu, Xu, Ql, Uu, Uu, Ql, Uu^Vu, Ql, Uu, Uu^Vu, Cud, Uu, Uh, Uh, Ql, Ql, Xu, Xu, Xu, Xu, Aa^Fda, Aa, Aa^Fma, Aa^Fpa
Aa, Aa, Aa^Fpa, Ha^Fpa, Ha, Ha, Ha, Xu, Xu, Xu, Xu, Xu, Xu, Ql, Uu, Cud, Ql, Cud, Uu^Uf, Uu^Uf, Xu, Uu, Xu, Xu, Xu, Xu, Xu, Xu, Ha, Aa, Aa^Fda, Aa, Aa, Aa^Fpa
Aa, Aa^Fpa, Aa^Fpa, Ha, Ms, Ms, Ms, Ha, Xu, Xu, Xu, Xu, Xu, Ql, Uh, Uu, Uu^Vu, Uu, Uh, Ql, Xu, Xu, Xu, Xu, Xu, Xu, Ha^Fma, Ha^Fma, Aa^Fda, Aa, Ha^Fpa, Ha^Fda, Aa^Fda, Ha
Ha^Fpa, Ha, Ms, Ha^Fda, Ha, Ha^Fpa, Ms, Ha, Xu, Xu, Xu, Xu, Ql, Uh, Uh, Uu, Ql, Ql, Ql, Ql, Xu, Xu, Xu, Xu, Xu, Ha, Aa^Fma, Aa^Fma, Aa^Fda, Aa^Fpa, Ms, Ms, Ha, Ms
Aa, Ha, Ha, Ms, Ha^Fpa, Ms, Ms, Ms, Xu, Xu, Xu, Xu, Ql, Uh, Uu, Ql, Xu, Xu, Xu, Xu, Xu, Xu, Xu, Xu, Xu, Ms, Ms, Ms, Aa^Fda, Ms, Ms, Ms, Ha, Ms
Aa, Aa^Fda, Aa^Fda, Ha^Fda, Ms, Ms, Ms, Ms, Xu, Xu, Xu, Xu, Xu, Uu, Uu, Xu, Xu, Xu, Xu, Xu, Xu, Xu, Xu, Xu, Ha, Ms, Ha^Fpa, Aa^Fda, Ms, Ms, Ms, Ms, Ms, Ha
Ha, Aa^Fda, Ha, Ms, Ms, Ms, Ms, Ms, Xu, Xu, Xu, Xu, Xu, Uu, Uu, Xu, Xu, Xu, Xu, Xu, Xu, Xu, Xu, Xu, Ha, Ha, Ms, Ms, Aa^Fpa, Ms, Aa^Fpa, Ha^Fpa, Aa^Fpa, Ms
