Xu, Xu, Xu, Xu, Xu, Xu, Xu, Xu, Xu, Xu, Xu, Xu, Xu, Xu, Uu^Uf, Rr, Uu^Uf, Xu, Xu, Xu, Xu, Xu, Xu, Xu, Xu, Xu, Xu, Xu, Xu, Xu, Xu, Xu, Xu, Xu
Xu, Xu, Xu, Xu, Xu, Xu, Xu, Xu, Xu, Xu, Xu, Xu, Uu^Uf, Uu^Uf, Uu, Rr, Uu, Uu^Uf, Uu^Uf, Xu, Xu, Xu, Xu, Xu, Xu, Xu, Xu, Xu, Xu, Xu, Xu, Xu, Xu, Xu
Xu, Xu, Xu, Xu, Xu, Xu, Xu, Xu, Xu, Xu, Xu, Xu, Uu, Uu, Uu, Rr, Uu, Uu, Uu, Xu, Xu, Xu, Xu, Xu, Xu, Xu, Xu, Xu, Uu^Vu, Xu, Xu, Xu, Xu, Xu
Xu, Xu, Xu, Xu, Xu, Xu, Xu, Xu, Uu^Vu, Xu, Xu, Uu, Uu, Uh, Uu^Uf, Uu, Uu, Uu, Uu, Uu^Em, Xu, Xu, Uu^Uf, Xu, Uu, Uu^Vu, Cud, Uu^Uf, Cud, Uu^Uf, Xu, Xu, Xu, Xu
Xu, Xu, Xu, Xu, Uu^Uf, Xu, Uu^Vu, Uu^Em, Uu, Uu^Uf, Uu, Xu, Uu, Uh, Uu, 1 Uu, Uu, Uh, Uh, Uu, Xu, Uu^Uf, Rr, Uu, Rr, Uu, Cud, 3 Kud, Cud, Uu^Vu, Xu, Xu, Xu, Xu
Xu, Xu, Xu, Uu, Uu^Vu, Cud, 4 Kud, Cud, Rr, Rr, Uu^Vu, Xu, Uh, Rr, Uu, Uu, Uu, Uu, Rr, Uu^Uf, Xu, Uu^Vu, Uu, Rr, Uu, Uu, Uu, Cud, Uu, Uu, Uu, Xu, Xu, Xu
Xu, Xu, Xu, Xu, Uu, Cud, Cud, Cud, Uu^Vu, Uu, Ql, Xu, Xu, Uu, Uu, Uu, Uu, Uu, Xu, Xu, Xu, Xu, Ql, Xu, Ql, Uu, Uu^Vu, Uu, Uu^Vu, Uu, Uu^Vu, Xu, Xu, Xu
Xu, Xu, Xu, Xu, Uu^Vu, Uu, Uu^Vu, Uu, Ql, Xu, Ql, Xu, Uu, Ql, Xu, Rr, Uu, Ql, Xu, Xu, Ql, Ql, Ql, Ql, Xu, Xu, Xu, Xu, Xu, Xu, Xu, Xu, Xu, Xu
Xu, Xu, Xu, Xu, Uu, Uu, Xu, Ql, Ql, Xu, Xu, Ql, Uu, Ql, Xu, Rr, Uu, Ql, Xu, Xu, Ql, Xu, Xu, Uu, Xu, Xu, Xu, Xu, Xu, Xu, Xu, Xu, Xu, Xu
Xu, Xu, Xu, Xu, Xu, Xu, Xu, Xu, Xu, Uu, Xu, Xu, Ql, Xu, Xu, Uu, Rr, Uu, Ql, Ql, Ql, Xu, Ql, Uu, Ql, Xu, Xu, Xu, Xu, Xu, Xu, Xu, Xu, Xu
Xu, Xu, Xu, Xu, Xu, Xu, Uh, Xu, Xu, Uu, Xu, Xu, Xu, Xu, Uh, Uu, Rr, Uu, Uu, Xu, Xu, Ql, Xu, Uu, Uu, Uu, Uu, Uu, Uu, Xu, Xu, Xu, Xu, Xu
Xu, Xu, Xu, Xu, Uu, Uh, Xu, Xu, Xu, Uu, Xu, Xu, Uu, Uh, Rr, Uu, Uu, Uu, Uu, Xu, Xu, Ql, Xu, Xu, Uu, Xu, Xu, Uu, Uu, Uu, Ql, Xu, Xu, Xu
Xu, Xu, Xu, Xu, Xu, Uu, Xu, Xu, Ql, Ql, Uu, Uu, Uu, Rr, Uu, Rr, Uu, Uu, Uu, Uh, Uh, Xu, Uu, Xu, Uu, Uu, Xu, Xu, Uu, Uu, Ql, Ql, Xu, Xu
Xu, Xu, Xu, Xu, Xu, Ql, Uu, Xu, Uu, Uu, Rr, Rr, Xu, Uu, Uu, Rr, Uu, Uu, Xu, Uu, Uu, Uu, Rr, Uu, Uu, Xu, Xu, Xu, Uu, Uu, Uu, Xu, Xu, Xu
Xu, Xu, Xu, Xu, Xu, Uu, Uu, Uu, Rr, Uu, Uh, Xu, Xu, Xu, Xu, Uu, Rr, Ql, Ql, Xu, Ql, Uu, Xu, Rr, Uu, Uu^Vu, Xu, Uu, Uu, Uu^Vu, Xu, Xu, Xu, Xu
Xu, Xu, Xu, Xu, Uu, Uu^Vu, Uu, Uu, Uu, Uh, Xu, Xu, Xu, Xu, Ql, Uu, Rr, Ql, Xu, Ql, Xu, Xu, Xu, Uh, Rr, Uu, Uu, Uu, Cud, Xu, Xu, Xu, Xu, Xu
Xu, Xu, Xu, Xu, Uu, Cud, 5 Kud, Cud, Uu, Uu, Uu, Xu, Xu, Ql, Ql, Uu, Uu, Xu, Xu, Ql, Xu, Xu, Xu, Uh, Uh, Rr, Uu, Cud, 6 Kud, Xu, Xu, Xu, Xu, Xu
Xu, Xu, Ql, Ql, Uu^Vu, Cud, Cud, Cud, Uu, Uu^Vu, Xu, Xu, Xu, Ql, Ql, Uu, Uu, Uu, Xu, Ql, Ql, Xu, Uu, Uu, Uu^Vu, Uu, Uu, Cud, Cud, Xu, Xu, Xu, Xu, Xu
Xu, Uh, Uh, Ql, Uu, Uu, Uu, Uu, Uu, Ql, Xu, Xu, Xu, Xu, Xu, Xu, Uh, Rr, Uu, Xu, Uu, Uu, Xu, Xu, Xu, Ql, Ql, Rr, Rr, Uu, Uh, Xu, Xu, Xu
Ql, Uh, Uu, Uu, Uu, Uu, Uu, Uu^Vu, Xu, Uu, Uu, Xu, Xu, Xu, Ql, Xu, Uh, Rr, Uu, Uu, Ql, Xu, Xu, Xu, Ql, Xu, Xu, Ql, Uu^Vu, Uu, Uh, Uu^Vu, Xu, Xu
Ql, Uh, Rr, Rr, Uh, Uu^Vu, Xu, Xu, Ql, Xu, Uh, Xu, Ql, Ql, Ql, Xu, Uu, Uu, Rr, Uu, Ql, Xu, Xu, Ql, Ql, Xu, Xu, Xu, Uu, Uu, Rr, Uu, Xu, Xu
Ql, Uh, Rr, Uu, Uh, Xu, Xu, Ql, Ql, Xu, Uh, Uu, Uu, Uu, Uu, Xu, Uu^Ii, Cud, Rr, Cud, Uu^Ii, Xu, Xu, Ql, Ql, Xu, Ql, Ql, Ql, Uu, Rr, Uu, Uu, Xu
Xu, Uu, Rr, Uh, Xu, Xu, Xu, Ql, Xu, Xu, Uh, Xu, Xu, Xu, Uu, Uu^Ii, Ql, Ql, Rr, Ql, Ql, Uu^Ii, Uu, Xu, Xu, Xu, Ql, Xu, Xu, Xu, Uh, Uu, Uu, Ql
Xu, Uu, Rr, Uu, Uu, Xu, Xu, Xu, Ql, Uu, Xu, Xu, Ql, Uu, Uu, Uu^Ii, Ql, Xu, Uu^Ii, Xu, Ql, Uu^Ii, Uu, Xu, Xu, Xu, Ql, Ql, Xu, Xu, Xu, Uh, Uh, Ql
Xu, Uu, Uu, Rr, Uu, Xu, Xu, Ql, Ql, Xu, Xu, Ql, Uh, Uu, Uu, Cud, Rr, Rr, Xu, Rr, Rr, Cud, Uu, Xu, Ql, Xu, Ql, Xu, Ql, Xu, Ql, Xu, Uh, Xu
Xu, Xu, Xu, Uu, Rr, Uu, Uu, Ql, Uu, Xu, Xu, Xu, Uh, Uh, Uu, Rr, Cud, Ql, Ql, Ql, Cud, Rr, Uu, Ql, Ql, Ql, Xu, Xu, Ql, Ql, Ql, Xu, Uu, Xu
Xu, Xu, Xu, Uu, Uu, Rr, Rr, Uu, Rr, Uu, Uu, Xu, Rr, Rr, Uu, Uu, Uu, Uu^Ii, Uu^Ii, Uu^Ii, Uu, Uu, Rr, Uu, Uu, Xu, Xu, Xu, Xu, Ql, Ql, Ql, Uu, Xu
Xu, Xu, Xu, Xu, Xu, Uu, Uu, Uu, Uu, Rr, Uu, Uu, Rr, Uu, Ql, Xu, Xu, Uh, Uh, Uh, Xu, Xu, Xu, Rr, Uh, Ql, Xu, Xu, Xu, Xu, Xu, Ql, Ql, Ql
Xu, Xu, Xu, Xu, Xu, Xu, Ql, Uu, Xu, Uu, Uu, Rr, Xu, Xu, Ql, Ql, Uu, Uu, Uu, Xu, Xu, Xu, Xu, Uu, Uh, Uu, Rr, Uu, Uu^Em, Xu, Xu, Uu, Uu, Ql
Xu, Xu, Xu, Xu, Uu, Ql, Xu, Ql, Xu, Xu, Xu, Xu, Ql, Ql, Ql, Xu, Uu, Uu, Uu, Xu, Xu, Ql, Ql, Ql, Uh, Uh, Uh, Rr, Uu, Uu, Uu, Uu, Uu, Ql
Xu, Xu, Xu, Uu, Uu, Uu, Uu, Xu, Ql, Xu, Ql, Ql, Xu, Ql, Xu, Uu, Uu, Uu, Xu, Xu, Xu, Xu, Xu, Ql, Ql, Uu, Xu, Uu, Uu, Uu, Uu, Uu, Uu, Ql
Xu, Xu, Uu, Uu, Uu, Uu, Uu, Uu, Xu, Ql, Xu, Xu, Xu, Xu, Uu, Uu, Uu, Uu, Xu, Xu, Xu, Xu, Xu, Xu, Xu, Xu, Xu, Xu, Xu, Xu, Xu, Ql, Ql, Ql
Xu, Xu, Xu, Uu, Xu, Xu, Xu, Xu, Xu, Xu, Xu, Xu, Xu, Xu, Uu, Uu, Xu, Xu, Xu, Xu, Xu, Xu, Xu, Xu, Xu, Xu, Xu, Xu, Xu, Xu, Xu, Ql, Ql, Ql
Xu, Xu, Xu, Xu, Xu, Xu, Xu, Xu, Xu, Xu, Xu, Xu, Xu, Xu, Xu, Xu, Xu, Xu, Xu, Xu, Xu, Xu, Xu, Xu, Xu, Xu, Xu, Xu, Xu, Xu, Xu, Ql, Ql, Ql
