Gg, Gg, Gg, Gg, Gg, Gg, Gs^Fds, Gg, Hh, Gs^Fds, Gs^Fds, Gs^Fds, Gs^Fds, Gs^Fds, Hh, Hh, Gg, Gg, Rr, Gg, Gg, Gg, Gg, Gs^Fds, Gg, Gg, Gg, Gg, Gg, Hh, Gg, Gs^Fds, Gg, Gg
Gg, Gg, Gg, Gg, Gs^Fds, Gs^Fds, Gg, Hh, Gs^Fds, Gs^Fds, Gg, Gg, Gg, Gs^Fds, Gg, Gg, Gg, Gg, 1 Rr, Gg, Gg, Gg, Gg, Gg, Gg, Gg, Gg, Gs^Fds, Gg, Hh, Hh, Gg, Gg, Gg
Gg, Gg, Gg, Gs^Fds, Gg, Gg, Gg, Gg, Gg, Gs^Fds, Gs^Fds, Gg, Gg, Gs^Fds, Gg, Gg, Gg, Gg, Rr, Gg, Gg, Gg, Gg, Gs^Fds, Gg, Gg, Gg, Gg, Gg, Hh, Gg, Gg, Gg, Gg
Gg, Gg, Gs^Fds, Gs^Fds, Gg, Gg, Gs^Fds, Gs^Fds, Gg, Gg, Gg, Gs^Fds, Gg, Gs^Fds, Gg, Gg, Gg, Gg, Rr, Gg, Gg, Gg, Gg, Gg, Gg, Gg, Gs^Fds, Gs^Fds, Gs^Fds, Gs^Fds, Gs^Fds, Gg, Gg, Gg
Gg, Gg, Gs^Fds, Gs^Fds, Hh, Gg, Hh, Hh, Hh, Gg, Gg, Gg, Gg, Gg, Gg, Gg, Gg, Rr, Gg, Gg, Gg, Gg, Gg, Gg, Gs^Fds, Gs^Fds, Gg, Gs^Fds, Gs^Fds, Gs^Fds, Gs^Fds, Hh, Gg, Gg
Gg, Gg, Gg, Gg, Gg, Gg, Hh, Hh, Gg, Gg, Gg, Gg, Gg, Gg, Ce, Gg, Gg, Rr, Gg, Gg, Gg, Gg, Gg, Gs^Fds, Gs^Fds, Gg, Gs^Fds, Gs^Fds, Gs^Fds, Gg, Gs^Fds, Hh, Gg, Gg
Gg, Gg, Gg, Gs^Fds, Gg, Gg, Gg, Gg, Gg, Gg, Gg, Gg, Ce, Ce, Gg, Ce, Ce, Rr, Gg, Gg, Gg, Gg, Gs^Fds, Gg, Gg, Gs^Fds, Gg, Gs^Fds, Gg, Gs^Fds, Gs^Fds, Gs^Fds, Gs^Fds, Gs^Fds
Hh, Hh, Hh, Gg, Gg, Gg, Gg, Gg, Gg, Gg, Ce, Ce, Gg, Gg^Vh, Gg, Gg^Vh, Rr, Rr, Ce, Gg, Gg, Gg, Gg, Gg, Gg, Gg, Gs^Fds, Gg, Gg, Gs^Fds, Gs^Fds, Gg, Gs^Fds, Gs^Fds
Hh, Hh, Hh, Gg, Gg, Gg, Gg, Gg, Ce, Ce, Gg, Gg^Vh, Rr, Rr, Rr, Rr, Gg, Rr, Gg, Ce, Ce, Gg, Gg, Gg, Gg, Gs^Fds, Gg, Gg, Gg, Gs^Fds, Gg, Gs^Fds, Gg, Gg
Hh, Hh, Gg, Gg, Gg, Gg, Ce, Ce, Rr, Gg^Vh, Rr, Rr, Gg, Gg^Vh, Rr, Gg^Vh, Gg, Rr, Rr, Gg^Vh, Gg, Ce, Ce, Gg, Gg, Gg, Gg, Gg, Gg, Gg, Gs^Fds, Gg, Gg, Gg
Gg, Gg, Gg, Gg, Ce, Ce, Rr, Rr, Gs^Fds, Rr, Rr, Gg^Vh, Gg, Gg, Rr, Gg, Gg^Vh, Rr, Gg^Vh, Rr, Rr, Gg^Vh, Rr, Ce, Ce, Gg, Gg, Gg, Gg, Gg, Gg, Gg, Gg, Gg
Gg, Gg, Gg, Ce, Rr, Rr, Gg^Vh, Gs^Fds, Gs^Fds, Rr, Gg^Vh, Rr, Gg^Vh, Gs^Fds, Gs^Fds, Rr, Rr, Rr, Gg, Gg, Gg^Vh, Rr, Gg^Vh, Rr, Rr, Ce, Ce, Gg, Gg, Gg, Gg, Gg, Gg, Gg
Gg, Gg, Ce, Ce, Rr, Gg, Gg, Gg, Rr, Rr, Gg, Rr, Rr, Gs^Fds, Gg^Vh, Gg, Gg^Vh, Rr, Gg^Vh, Gs^Fds, Gs^Fds, Gg, Gg, Gg, Rr, Rr, Rr, Ce, Ce, Gg, Gg, Gg, Gg, Gg
Gg, Gg, Rr, Rr, Gg, Gg^Vh, Gg, Gg^Vh, Rr, Gg^Vh, Gg, Gg^Vh, Gg, Rr, Rr, Gg, Rr, Rr, Gg, Gs^Fds, Gg, Gg^Vh, Rr, Rr, Gg, Gg^Vh, Gg, Rr, Rr, Ce, Ce, Gg, Gg, Gg
Rr, Rr, Rr, Gg^Vh, Gg, Gg, Gg, Rr, Gg^Vh, Gg, Gg^Vh, Gg, Rr, Rr, Gg, Rr, Ds, Rr, Ds, Gg^Vh, Rr, Rr, Gs^Fds, Rr, Rr, Gg, Gg, Hh, Gs^Fds, Rr, Ce, Gg, Rr, Rr
Gg, Gg, Ce, Rr, Rr, Gg^Vh, Rr, Rr, Gg, Gg, Rr, Rr, Gg, Gg, Ds, Ds, Ww, Rr, Ww, Ds, Ds, Gg^Vh, Gg, Gg, Rr, Gg^Vh, Gg, Gs^Fds, Gg, Rr, Rr, Rr, Gg, Gg
Gg, Gg, Ce, Rr, Gg, Rr, Rr, Gg^Vh, Rr, Rr, Gg, Gg, Ds, Ds, Ww, Ww, Wo, Ww^Bw|, Wo, Ww, Ww, Ds, Ds, Gg^Vh, Gs^Fds, Rr, Rr, Gg^Vh, Rr, Rr, Ce, Gg, Gg, Gg
Gg, Gg, Ce, Rr, Gg, Gg^Vh, Gg, Rr, Rr, Gg, Ds, Ds, Ww, Ww, Wo, Wo, Ch, Rr, Ch, Wo, Wo, Ww, Ww, Ds, Ds, Gg^Vh, Rr, Rr, Gg, Rr, Ce, Gg, Gg, Gg
Gg, Gg, Ce, Rr, Gg^Vh, Ww, Gg^Vh, Gg, Rr, Rr, Rr, Ww, Wo, Wo, Ch, Ch, Rr, Rr, Rr, Ch, Ch, Wo, Wo, Ww, Rr, Rr, Gg^Vh, Gs^Fds, Gg, Rr, Ce, Gg, Gg, Gg
Gg, Gg, Ce, Rr, Gg, Gg, Rr, Rr, Gg, Ds, Ww, Ww^Bw\, Rr, Ch, Rr, Rr, Gs^Vh, Rr, Gs^Vh, Rr, Rr, Ch, Rr, Ww^Bw/, Ww, Ds, Gg, Gg, Rr, Rr, Rr, Ce, Gg, Gg
Gg, Gg, Ce, Rr, Gg^Vh, Rr, Gg, Gg^Vh, Gg, Ds, Ww, Wo, Ch, Rr, Rr, Gs^Vh, Gs, Rr, Gs, Gs^Vh, Rr, Rr, Ch, Wo, Ww, Ds, Rr, Rr, Gg^Vh, Gg, Rr, Ce, Gg, Gg
Gg, Gg, Ce, Rr, Rr, Rr, Gg^Vh, Gg, Gg, Ds, Ww, Wo, Ch, Rr, Gs^Vh, Rr, Ch, Ch, Ch, Rr, Gs^Vh, Rr, Ch, Wo, Ww, Ds, Rr, Gg, Gg, Gs^Fds, Rr, Ce, Gg, Gg
Gg, Gg, Ce, Gg^Vh, Rr, Gs^Fds, Gs^Fds, Gg, Gg, Ds, Ww, Wo, Ch, Rr, Gs^Vh, Gs, Ch, 2 Kh, Ch, Gs, Gs^Vh, Rr, Ch, Wo, Ww, Ds, Rr, Gg^Vh, Gg, Gs^Fds, Rr, Ce, Gg, Gg
Gg, Gg, Ce, Gg, Rr, Gs^Fds, Gs^Fds, Gg, Gg, Ds, Ww, Wo, Ch, Rr, Rr, Rr, Gs, Ch, Gs, Rr, Rr, Rr, Ch, Wo, Ww, Ds, Gs^Fds, Rr, Rr, Gg^Vh, Rr, Ce, Gg, Gg
Gg, Gg, Ce, Gg^Vh, Rr, Rr, Rr, Gg^Vh, Gg, Ds, Ww, Wo, Rr, Rr, Rr, Gs^Vh, Gs^Vh, Rr, Gs^Vh, Gs^Vh, Rr, Rr, Rr, Wo, Ww, Ds, Gg^Vh, Gg, Gg^Vh, Rr, Ce, Ce, Gg, Gg
Gg, Gg, Ce, Rr, Gg^Vh, Gg, Rr, Gg, Gg^Vh, Ds, Rr, Ww^Bw/, Wo, Ch, Ch, Rr, Rr, Rr, Rr, Rr, Ch, Ch, Wo, Ww^Bw\, Rr, Ds, Gg, Gg, Gg, Rr, Ce, Gg, Gg, Gg
Gg, Gg, Ce, Rr, Gg, Ww, Gg^Vh, Rr, Rr, Rr, Ds, Ww, Ww, Wo, Wo, Ch, Ch, Rr, Ch, Ch, Wo, Wo, Ww, Ww, Ds, Rr, Rr, Gg^Vh, Rr, Rr, Ce, Gg, Gg, Gg
Gg, Gg, Ce, Rr, Gg^Vh, Gg, Rr, Rr, Gs^Fds, Rr, Gg, Ds, Ds, Ww, Ww, Wo, Wo, Rr, Wo, Wo, Ww, Ww, Ds, Ds, Gg^Vh, Rr, Gg^Vh, Rr, Rr, Ce, Gg, Gg, Gg, Gg
Gg, Gg, Ce, Rr, Rr, Rr, Gg, Gg^Vh, Gg, Rr, Rr, Gg, Gg^Vh, Ds, Ds, Ww, Ww, Ww^Bw|, Ww, Ww, Ds, Ds, Gs^Fds, Gs^Fds, Gg, Rr, Gg, Gg, Rr, Rr, Rr, Gg, Gg, Gg
Gg, Gg, Rr, Rr, Rr, Gg, Gg^Vh, Gg, Gs^Fds, Gg^Vh, Gg, Rr, Rr, Gg, Gs^Fds, Ds, Ds, Rr, Ds, Ds, Gg, Gg, Gg^Vh, Gg, Rr, Rr, Gg, Gg^Vh, Rr, Ce, Rr, Gg, Gg, Gg
Rr, Rr, Gg, Ce, Ce, Rr, Rr, Gg, Gg^Vh, Gs^Fds, Gg, Gg, Rr, Gg, Gg, Gs^Fds, Gg^Vh, Rr, Gg, Gg, Gg^Vh, Gg, Rr, Rr, Gg, Rr, Rr, Gg, Rr, Ce, Gg, Rr, Rr, Rr
Gg, Gg, Gg, Gg, Gg, Ce, Ce, Rr, Rr, Rr, Rr, Gg^Vh, Rr, Gg, Gg^Vh, Gg, Gg, Rr, Gg^Vh, Gg, Gg, Rr, Gg^Vh, Gg, Gg, Gg^Vh, Gg, Rr, Rr, Ce, Gg, Gg, Gg, Gg
Gg, Gg, Gg, Gg, Gg, Gg, Gg, Ce, Ce, Ce, Ce, Rr, Ce, Rr, Rr, Gg, Gg, Rr, Gg, Gg, Gg^Vh, Rr, Gg, Gs^Fds, Gg^Vh, Gg, Rr, Rr, Ce, Ce, Gg, Gg, Hh, Hh
Hh, Hh, Hh, Gg, Gg, Gg, Gg, Gg, Gg, Gg, Gg, Ce, Gg, Ce, Ce, Rr, Rr, Rr, Rr, Rr, Rr, Rr, Rr, Rr, Rr, Rr, Ce, Ce, Gg, Gg, Gg, Gg, Gg, Gg
Hh, Hh, Hh, Gs^Fds, Gg, Gg, Gs^Fds, Gg, Gg, Gg, Gg, Gg, Gg, Gg, Gg, Ce, Ce, Ce, Rr, Ce, Ce, Ce, Ce, Ce, Ce, Ce, Gg, Gg, Gg, Gg, Gg, Gg, Gg, Gg
Gs^Fds, Gs^Fds, Gg, Gg, Gs^Fds, Gg, Gg, Gg, Hh, Hh, Hh, Gg, Gg, Gg, Gg, Gg, Gg, Gg, Rr, Gg, Gg, Gg, Gg, Gg, Gg, Gg, Gs^Fds, Gg, Gg, Hh, Hh, Hh, Hh, Hh
Gg, Gg, Gg, Gg, Gg, Gs^Fds, Gg, Gg, Gs^Fds, Hh, Gg, Gg, Gg, Gg, Gg, Gg, Gg, Gg, Gg, Gg, Gg, Gg, Gs^Fds, Gg, Gs^Fds, Gg, Gg, Gg, Gg, Hh, Hh, Hh, Gg, Gg
Gg, Gg, Gg, Gg, Gg, Gs^Fds, Gg, Gg, Gs^Fds, Hh, Gg, Gg, Gg, Gg, Gg, Gg, Gg, Gg, Gg, Gg, Gs^Fds, Gs^Fds, Gs^Fds, Gs^Fds, Gs^Fds, Gs^Fds, Gs^Fds, Gg, Gg, Hh, Hh, Hh, Gg, Gg
