Gs^Fds, Gs^Fds, Gs^Fds, Gs^Fds, Re^Gvs, Gs^Fds, Gs^Fds, Ce, Gg, Rr, Gg, Ce, Gs^Fds, Gs^Fds, Gs^Fds, Gs^Fds, Gs^Fds, Gs^Fds, Gs^Fds, Gs^Fds, Gs^Fds, Gs^Fds
Gs^Fds, Gs^Fds, Gs^Fds, Gs^Fds, Re^Gvs, Gs^Fds, Gs^Fds, Ce, Gg^Vh, Rr, Gg^Vh, Ce, Gs^Fds, Gs^Fds, Gs^Fds, Gs^Fds, Gs^Fds, Gs^Fds, Gs^Fds, Gs^Fds, Gs^Fds, Gs^Fds
Gs^Fds, Gs^Fds, Re^Gvs, Re^Gvs, Re^Gvs, Gs, Re^Gvs, Ce, Ce, Rr, Ce, Ce, Gs^Fds, Gs^Fds, Gs^Fds, Gs^Fds, Gs^Fds, Gs^Fds, Gs^Fds, Gs^Fds, Gg, Gg
Gg, Gs, Re^Gvs, Gs^Fds, Re^Gvs, Gs^Fds, Re^Gvs, Gs^Fds, Gs, Rr, Gs, Gs, Gs, Gs^Fds, Gg, Gs^Fds, Gs^Fds, Gs^Fds, Gs^Fds, Gg, Gs^Fds, Gs^Fds
Gg, Gs, Re^Gvs, Re^Gvs, Re^Gvs, Re^Gvs, Gs^Fds, Gs^Fds, Re, Re, Gg, Gg, Gg, Gg, Gg, Gg, Gs^Fds, Gs^Fds, Gg, Gs^Fds, Gs^Fms, Gs^Fds
Gg, Gs, Gs^Fds, Gs^Fds, Re^Gvs, Gs^Fds, Gs, Gs, Re, Gg, Gs^Fds, Gs^Fds, Gg, Gs^Fds, Gs^Fds, Gs^Fds, Gs^Fms, Gs^Fds, Gs^Fms, Gs^Fds, Gs^Fms, Gs^Fms
Gs^Fds, Gs^Fds, Re^Gvs, Re^Gvs, Gs^Fds, Gs^Fds, Re, Re, Gg, Gg, Gg, Gs^Fds, Gs^Fds, Gs^Fds, Gs^Fds, Gs^Fds, Gs^Fms, Gs^Fms, Gs^Fds, Gs^Fms, Gs^Fms, Gs^Fms
Gs^Fms, Gs^Fms, Gs^Fms, Gs^Fms, Gs^Fms, Re, Gs^Fms, Gs^Fms, Gg, Gg, Gs^Fds, Gs^Fds, Gs^Fds, Gs^Fds, Gs^Fds, Rb^Vh, Gg, Gs^Fms, Gs^Fms, Gs^Fms, Gs^Fms, Gs^Fms
Gg, Gg, Gs^Fds, Gs^Fds, Gs^Fds, Gs, Gs, Gs^Fms, Gg, Gs^Fds, Gs^Fds, Gs^Fds, Gs^Fds, Gs^Fds, Gg, Gs^Fds, Gg, Gg, Gs^Fms, Gs^Fms, Gs^Fms, Gs^Fms
Gg, Gg, Gg, Gs^Fms, Gs^Fds, Gs^Fms, Gs^Fms, Gs, Re, Gs^Fds, Gs^Fds, Gs^Fds, Gs^Fds, Gg, Gg, Gg, Gs^Fms, Gg, Gg, Gs^Fds, Gg, Gg
Gg, Gg, Gg, Gg, Gg, Gg, Gs^Fms, Gs^Fds, Gs^Fds, Re, Gg, Gs^Fds, Rb^Vh, Gs^Fds, Gg, Gs^Fds, Gs^Fms, Gll^Fp, Gs^Fms, Gs^Fds, Gs^Fds, Gs^Fds
Gg, Gg, Gg, Gg, Gg, Gg, Gs^Fds, Gs^Fds, Gs^Fds, Re, Gg, Gs^Fds, Gs^Fds, Gs^Fds, Gg, Gs^Fms, Gs^Fms, Gll^Fp, Gll^Fp, Gll^Vh, Gs^Fms, Gs^Fms
Gg, Gg, Gs^Fms, Gg, Gs^Fds, Gg, Gg, Gs^Fds, Re, Re, Gg, Gg, Gg, Gg, Gg, Gg, Gll^Fp, Gll^Fp, Gll^Fp, Gs^Fms, Gg, Gg
Gs^Fp, Gs^Fms, Gs^Fp, Gs^Fms, Gs^Fms, Gs^Fms, Gg, Gs, Gs^Fds, Gs^Fds, Gs^Fms, Gg, Gg, Gg, Gg, Gg, Gg, Gll^Fp, Gll^Fp, Gll^Fp, Gll^Fp, Gg
Gs^Fp, Gs^Fp, Gs^Fp, Gs^Fp, Gs^Fms, Gs^Fp, Gg, Re, Re, Gs^Fms, Gs^Fms, Gs^Fp, Gg, Gg, Gg, Gg, Gll^Fp, Gll^Fp, Gll^Fp, Gll^Fp, Gll^Fp, Gg
Gg, Gg, Gg, Gs^Fp, Gg, Gll^Vh, Gs^Fp, Gs^Fp, Gs^Fp, Re, Gs^Fp, Gs^Fp, Gg, Gg, Gll^Fp, Gll^Fp, Gll^Fp, Gll^Fp, Gg, Gg, Gs, Gs
Gg, Gg, Gg, Gg, Gs^Fds, Gs^Fds, Gs^Fms, Gs^Fp, Gs^Fp, Re, Gg, Gg, Gll^Vh, Gll^Fp, Gll^Fp, Gll^Fp, Gll^Fp, Gg, Gg, Gs, Hh, Hh
Gg, Gg, Gg, Gg, Gs^Fms, Gs^Fds, Gs^Fms, Gs^Fp, Gg, Re, Gll^Fp, Gll^Fp, Gll^Fp, Gll^Fp, Gll^Fp, Gll^Fp, Gg, Gg, Gs, Gs, Gs, Gs
Gg, Gg, Gg, Gg, Gg, Gs^Fp, Gs^Fp, Gs^Fp, Gg, Gs, Gll^Fp, Gll^Fp, Gll^Fp, Gll^Fp, Gll^Fp, Gll^Fp, Gs, Gs, Gs, Hh, Hh, Hh
Gg, Gg, Gg, Gg, Gg, Gs^Fp, Gs^Fp, Gs^Fp, Gg, Re, Gg, Gll^Fp, Gg, Gll^Fp, Gg, Gg, Gs, Hh, Hh, Hh, Gs, Gs
Gg, Gg, Gg, Gg, Gs^Fp, Gs^Fp, Gs^Fp, Gs^Fp, Re, Re, Gs^Fp, Gg, Wo, Gg, Ds, Ds, Ds, Gs, Gs^Fp, Gs, Hh, Hh
Gs^Fp, Gs^Fp, Gs^Fp, Gs^Fp, Gs^Fp, Gs^Fp, Gs^Fp, Gs^Fp, Re, Gs^Fp, Rb^Vh, Gg^Fp, Gg^Fp, Gg^Fp, Gs^Fp, Gs^Fp, Gs^Fp, Gs^Fp, Hh, Hh, Hh, Hh
Gs^Fp, Gs^Fp, Gs^Fp, Gs^Fp, Gg^Fp, Gs^Fp, Gg^Fp, Gs^Fp, Gs, Gs^Fp, Gs^Fp, Gs^Fp, Gg^Fp, Gs^Fp, Gg^Fp, Gg^Fp, Gg^Fp, Hh, Hh, Gs^Fp, Hh, Hh
Gs^Fp, Gs^Fp, Gg^Fp, Gg^Vh, Ww, Gg^Fp, Ww, Re, Gg^Fp, Gg^Fp, Gg^Fp, Gg^Fp, Ww, Gg^Fp, Ww, Ww, Ww, Gg^Fp, Hh, Gg^Fp, Gg^Fp, Gs^Fp
Gg^Fp, Gg^Fp, Ww, Ww, Ww, Ww, Gg^Fp, Ww^Bw|, Ww, Ww, Ww, Ww, Gg^Fp, Ww, Ww, Ww, Ww, Ww, Ww, Ww, Ww, Ww
Ww, Ww, Ww, Ww, Gg^Fp, Gg^Fp, Gs^Fp, Re, Re, Gg^Fp, Gll^Fp, Gg^Fp, Gll^Fp, Gg^Fp, Gg^Fp, Ww, Gg^Fp, Ww, Ww, Ww, Ww, Ww
Gg^Fp, Gg^Fp, Gg^Fp, Gg^Fp, Gs^Fp, Gs^Fp, Gs^Fp, Gs^Fp, Re, Gll^Fp, Gll^Fp, Gll^Fp, Gll^Fp, Gll^Fp, Gll^Fp, Gg^Fp, Hh, Hh, Gg, Gg^Fds, Hh, Hh
Gs^Fp, Gs^Fp, Gs^Fp, Gs^Fp, Gs^Fp, Gs^Fp, Rb^Vh, Gs^Fp, Gs^Fp, Re, Gs, Gll^Fp, Gll^Fp, Gll^Fp, Gll^Fp, Gll^Fp, Hh, Hh, Hh^Fds, Hh, Hhd^Fdw, Hhd^Fds
Gs^Fp, Gs^Fp, Gs^Fp, Gs^Fp, Gs^Fp, Gs^Fp, Gs^Fp, Wo, Gs^Fp, Re, Re, Gll^Fp, Gll^Fp, Gll^Fp, Gll^Fp, Hh, Hh, Hh, Hhd, Hhd, Hhd^Fds, Hhd^Fds
Gs^Fp, Gs^Fp, Rb^Vh, Gs^Fp, 1 Re, Gs^Fp, Re, Gs^Fp, Re, Re, Gll^Fp, Gll^Fp, Gll^Fp, Gs^Fms, Hh, Hh, Hh^Fds, Hh^Fds, Gs^Fds, Hhd^Fdw, Hhd, Hhd
Gs^Fp, Gs^Fp, Gs, Re, Gs^Fp, Re, Gs^Fp, Re, Gll^Fp, Gll^Fp, Gll^Fp, Gs^Fms, Gs^Fms, Gs^Fms, Hh, Hh, Gs^Fds, Hh, Hh^Fds, 2 Hhd, Hhd^Fms, Hhd^Fdw
Gs^Fp, Gs^Fp, Gs, Gs, Gs^Fp, Gll^Fp, Gs^Fp, Gll^Fp, Gll^Fp, Gs^Fms, Gs^Fms, Gs^Fds, Gs^Fds, Gs^Fds, Hh, Hh, Gs^Fds, Hh, Hh^Fds, Hh, Hh^Fms, Hh^Fms
