Gg, Gg, Ss, Ss, Ss, Ss, Ss, Ss, Ss, Gll^Fp, Gll^Fp, Gs, Gg, Gg, Gg, Gll^Fp, Gs, Gll^Fp, Gll^Fp, Gg, Gg, Gg, Gg, Gll^Fp, Gll^Fp, Gll^Fp, Gg, Gg, Gg, Gg, Hh, Gs^Fp, Hh, Hh^Fp, Hh^Fp, Hh^Fms, Hh^Fms, Hh, Gs, Hh, Hh^Fds, Gs^Fds, Gs^Fds, Gs^Fds, Gs^Fds, Gs^Fds, Gs^Fds
Gg, Gg, Ss, Ss, 4 Ss^Vhs, Ss, Ss, Ss, Ss, Gll^Fp, Gll^Fp, Gs, Gg, Gg, Gg, Gll^Fp, Gg, Gll^Fp, Gll^Fp, Gg, Gg, Gg, Gg, Gll^Fp, Gll^Fp, Gll^Fp, Gg, Gg, Gg, Gs, Hh, Gs^Fp, Hh, Hh^Fp, Gs^Fms, Hh^Fms, Hh^Fms, Hh^Fms, Gs, Hh, Hh^Fds, Gs^Fds, Gs^Fds, Gs^Fds, Gs^Fds, Gs^Fds, Gs^Fds
Gg, Gg, Ss, Ss, Ss, Ss, Gll^Fp, Gll^Fp, Gll^Fp, Gll^Fp, Gll^Fp, Gs^Vl, Gs, Gg, Gg, Gg, Gg, Gg, Gg, Gg, Gg, Gg, Gg, Gll^Fp, Gll^Fp, Gll^Fp, Gg, Gg, Gg, Gs, Gs^Fms, Hh, Hh, Hh, Gs^Fms, Gs^Fms, Hh^Fms, Hh, Hh, Hh^Fds, Gs^Fds, Gs^Fds, Gs^Fds, Gs^Vh, Gs^Fds, Gs^Fds, Gs^Fds
Gll^Fp, Gll^Fp, Ss, Ss, Gll^Fp, Gll^Fp, Gll^Fp, Re^Fp, Re^Fp, Gll^Fp, Gll^Fp, Gll^Fp, Gs, Gg, Gs, Gg, Gg, Gg, Gs, Gg, Gg, Gs, Gs, Gs, Gll^Fp, Gll^Fp, Gll^Fp, Gg, Gg, Gs, Gll^Fp, Gs^Fms, Gs^Fms, Gs^Fms, Gg, Gs^Fds, Gg, Gg, Gg, Hh^Fds, Gs^Fds, Gs^Fds, Gs^Fds, Gs^Fds, Gs^Fds, Gs^Fds, Gs^Fds
Gll^Fp, Gll^Fp, Ss, Ss, Gll^Fp, Re^Fp, Ce, Ss, Ce, Re^Fp, Re^Fp, Gll^Fp, Gll^Fp, Gs, Gll^Fp, Gs, Gs, Gg, Gg, Gg, Gg, Gg, Gs, Gll^Fp, Gll^Fp, Gll^Fp, Gll^Fp, Gll^Fp, Gll^Fp, Gs^Fms, Gll^Fp, Gs^Fms, Gs^Fds, Gg, Gg, Gg, Gg, Gg, Gg, Gs^Fds, Gs^Fds, Gs^Fds, Gs^Fds, Gs^Fds, Gs^Fds, Gs^Fds, Gs^Fds
Gll^Fp, Gll^Fp, Gll^Fp, Ss, Gll^Fp, Gll^Fp, Ss, Ke, Ce, Re^Fp, Gll^Fp, Gll^Fp, Wo, Gll^Fp, Ss^Vhs, Gll^Fp, Gll^Fp, Gs, Gg, Gg, Gs, Gg, Gs, Gll^Fp, Gll^Fp, Gll^Fp, Gll^Fp, Gs^Vh, Gll^Fp, Gll^Fp, Gs^Fms, Gs^Fms, Gs^Fms, Gs^Fms, Gs^Fds, Gg, Gs^Fds, Gs^Fds, Gs^Vl, Gs^Fds, Gs^Fds, Gs^Fds, Gs^Fds, Gs^Fds, Gs^Fds, Gs^Fds, Gs^Fds
Gll^Fp, Gll^Fp, Gll^Fp, Gll^Fp, Gll^Fp, Gll^Fp, Ss, Ce, Ss, Re^Fp, Gll^Fp, Wo, Ss, Ss, Ss, Ss, Ss, Ds, Gs, Gg, Gg, Gg, Gs, Gll^Fp, Gll^Fp, Gll^Fp, Gll^Fp, Gll^Fp, Gll^Fp, Gll^Fp, Gll^Fp, Wo, Wo, Gs^Fms, Gs^Fds, Gg, Gs^Fds, Gs^Fds, Gs^Fds, Gs^Fds, Gs^Fds, Wo, Gs^Fds, Gs^Fds, Gs^Fds, Gs^Fds, Gs^Fds
Gll^Fp, Gll^Fp, Gll^Fp, Gll^Fp, Gll^Fp, Gll^Fp, Gll^Fp, Gll^Fp, Gll^Fp, Gll^Fp, Gll^Fp, Wo, Ss, Ww, Ww, Ww, Ss, Ds, Gs, Gg, Gg, Gg, Gs, Gd, Gs, Gs, Gll^Fp, Gll^Fp, Gll^Fp, Gll^Fp, Gg, Wo, Gg, Gs^Fds, Gg, Gg, Gs^Fds, Gs^Fds, Gs^Fds, Gg, Gs^Fds, Wo, Gs^Fds, Gs^Fds, Gg, Gg, Gg
Gll^Fp, Gll^Fp, Gll^Fp, Gll^Fp, Gll^Fp, Gll^Fp, Gs, Gll^Fp, Gll^Fp, Gll^Fp, Ww, Wo, Ss, Ss, Ss^Vhs, Ss, Ss, Gll^Fp, Gs, Gg, Gg, Gs, Hh, Gs^Fp, Hh, Gll^Fp, Hh, Gll^Fp, Gg, Gg, Gg, Gg, Gg, Gg, Gg, Gg, Gs^Fds, Gs^Fds, Gs^Fds, Gs^Fds, Gs^Fds, Wo, Gg, Gg, Gs^Fds, Gg, Gg
Gll^Fp, Gll^Fp, Gll^Fp, Gll^Fp, Gll^Fp, Gll^Fp, Gll^Fp, Gll^Fp, Ww, Ww, Ww, Wo, Ww, Ss, Ss, Ss, Gll^Fp, Gll^Fp, Gll^Fp, Gs, Gll^Fp, Gs, Hh, Hh, Gll^Fp, Hh, Hh, Gll^Fp, Gg, Gg, Gg, Gg, Gs^Fms, Gs^Fds, Gs^Fms, Gg, Gg, Gs^Fds, Gll, Gs^Fds, Gs^Fds, Gs^Fds, Gg, Gs^Fds, Gs^Vh, Gs^Fms, Gs^Fds
Gs, Gs, Gs, Gs, Gs, Gll^Fp, Gll^Fp, Gll^Fp, Gll^Fp, Ss, Wo, Ww, Ss, Ww, Wo, Wo, Gll^Fp, Gll^Fp, Gs^Vh, Gll^Fp, Gg, Gll^Fp, Gll^Fp, Gll^Fp, Hh, Gll^Fp, Gll^Fp, Gll^Fp, Gll^Fp, Gg, Gg, Gs^Fds, Gs^Fms, Gs^Fms, Gs^Fds, Gs^Fds, Gs^Fms, Gg, Gs^Fds, Gs^Fds, Gs^Fds, Gs^Fds, Gg, Gs^Fms, Gs^Fds, Gs^Fms, Gs^Fms
Gll^Fp, Gll^Fp, Gll^Fp, Gs, Gs, Gs, Gs, Gll^Fp, Gll^Fp, Ss, Ss^Vhs, Wo, Wo, Ww, Ss, Wo, Gll^Fp, Gll^Fp, Gll^Fp, Gll^Fp, Gg, Gg, Gg, Gg, Gg, Hh, Gll^Fp, Gll^Fp, Gll^Fp, Gll^Fp, Gs^Fms, Gll^Vl, Gs^Fms, Gs^Fms, Gs^Fms, Gs^Fms, Gs^Fds, Gg, Ww, Gs^Fds, Gg, Gg, Gs, Gs^Fds, Gs^Fms, Gs^Fms, Gs^Fds
Gll^Fp, Gll^Fp, Gs^Fp, Gll^Fp, Gll^Fp, Gll^Fp, Gll^Fp, Gs, Gs, Gll^Fp, Gll^Fp, Wo, Gll^Fp, Ss, Gll^Fp, Gll^Fp, Gll^Fp, Gll^Fp, Ww, Gg, Gll^Fp, Gg, Gg, Gg, Gg, Gg, Gll^Fp, Gs^Vl, Gll^Fp, Gll^Fp, Gll^Fp, Gs^Fms, Gg, Gg, Gg, Gs^Fms, Gg, Ww, Wo, Ww, Gg, Gg, Gs^Fms, Gs^Fms, Gs^Fp, Gg, Gg
Gs^Fp, Gs^Fp, Ww, Gs^Fp, Gll^Fp, Gll^Fp, Gll^Fp, Gs, Gs, Gs, Gs, Gll^Fp, Gs, Gll^Fp, Gll^Fp, Gll^Fp, Ss, Ww, Ww, Gll^Fp, Gll^Fp, Gll^Fp, Gll^Fp, Gg, Gg, Gg, Gg, Gll^Fp, Gg, Gll^Fp, Gll^Fp, Gs^Fms, Gg, Gg, Gg, Gg, Gg, Ww, Ww, Ww, Gs^Fp, Gs^Fp, Gs^Fp, Gs^Fp, Gs^Fp, Gg, Gg
Ww, Ww, Ww, Ss^Vhs, Gll^Fp, Gll^Fp, Gll^Fp, Gll^Fp, Gll^Fp, Gs, Gs, Gs, Gs, Gs, Gll^Fp, Ss, Gll^Fp, Ww, Ww, Ss, Gll^Fp, Gs^Vl, Gll^Fp, Gg, Gg, Gg, Gs^Fp, Gg, Gg, Gg, Gg, Gg, Gg, Gg, Gg, Gg, Gs^Fp, Gg, Gg, Gg, Gs^Fp, Gs^Fp, Gs^Fp, Gs^Fp, Gs^Fp, Gg, Gg
Ww, Ww, Ww, Ss, Gll^Fp, Gll^Fp, Gll^Fp, Gll^Fp, Gll^Fp, Gs, Gs, Gs^Ve, Gs, Gs, Gll^Fp, Gll^Fp, Gs, Gll^Fp, Gll^Fp, Ss, Gll^Fp, Gll^Fp, Gll^Fp, Gll^Fp, Gll^Fp, Gs^Fms, Gs^Fms, Gs^Fms, Gs^Fds, Gs^Fms, Gs^Fms, Gg, Gg^Efm, Gg^Efm, Gs^Fp, Gs^Fp, Gll^Vl, Gs^Fp, Gs^Fp, Gg, Gg, Gs^Fp, Gs^Fp, Gs^Vl, Gs^Fp, Gg, Gg
Wo, Wo, Ww, Ss, Gs^Fp, Gs^Vl, Gs, Gs, Gs, Gs, Gs, Gs, Gll^Fp, Gll^Fp, Gs, Gs, Gg, Gll^Fp, Gll^Fp, Gll^Fp, Gg, Gs, Gs^Fms, Gg, Gg^Efm, Gg, Gg, Gg, Gg^Efm, Gs^Fds, Gg, Gs^Fms, 1 Gg, Gg, Gs^Fp, Gs^Fp, Gs^Fp, Gs^Fp, Gs^Fp, Gg, Gg, Gg, Gg, Gs^Fp, Gg, Gg, Gg
Wo, Wo, Wo, Ww, Ww, Gs^Fp, Gll^Fp, Gs, Gs, Gs, Gs, Gs, Gll^Fp, Gll^Fp, Gll^Fp, Gll^Fp, Gll^Fp, Gg, Gg, Gg, Gs^Fp, Gs^Fp, Gg^Efm, Gg^Efm, Gs^Fds, Gs^Fds, Gg, Gg, Re, Gg, Gs^Fds, Gs^Fds, Gs^Fms, Gs^Fms, Gs^Fp, Gs^Vh, Gs^Fp, Gs^Fp, Gs^Fp, Gg, Ss, Ww, Ss, Gg, Gg, Gg, Gg
Wo, Wo, Wo, Wo, Wo, Ss, Ss, Gll^Fp, Gll^Fp, Gll^Fp, Gll^Fp, Gll^Fp, Gs^Fp, Gs^Fp, Gs^Fp, Gll^Fp, Gll^Fp, Gll^Fp, Gg, Gs^Fp, Gg, Gs^Fms, Gg, Gs^Fds, Gs^Fds, Ce, Re, Re, Gs, Ce, Gg, Gs^Fms, Gg, Gs^Fp, Gg, Gs^Fp, Gs^Fp, Ww, Ww, Ss, Gg, Ss, Gg, Gg, Gll^Fp, Gll^Fp, Gll^Fp
Wo, Wo, Wo, Wo, Wo, Ww, Ss, Gll^Fp, Gll^Fp, Gll^Fp, Gll^Fp, Gs^Fp, Wo, Wo, Gs^Fp, Gll^Fp, Gll^Fp, Gll^Fp, Gg, Gs^Fp, Gg, Gg^Efm, Gs^Fds, Gg, Ce, Ce, 2 Ke, Re, Ke, Ce, Gg, Hh, Hh, Gg, Gg, Gs^Fp, Ss, Ss, Gll^Fp, Ss, Ss, Gg, Gll^Fp, Gll^Fp, Gll^Fp, Gll^Fp, Gll^Fp
Gs^Fp, Gs^Fp, Ds, Ww, Wo, Ww, Ss, Gll^Fp, Gll^Vl, Gll^Fp, Gll^Fp, Gs^Fp, Gs^Fp, Gs^Fp, Gll^Fp, Gll^Fp, Gll^Fp, Gll^Fp, Gg, Gs^Fp, Gs^Fms, Gg^Efm, Gg, Gg, Ce, Gs, Gs, Re, Gs, Ce, Gg, Hh, Gg, Gs^Fp, Gs^Fp, Ww, Gll^Fp, Gll^Fp, Gll^Fp, Gg, Gll^Fp, Gll^Fp, Gll^Fp, Gll^Fp, Gll^Fp, Gll^Fp, Gll^Fp
Gg, Gg, Ss, Ww, Wo, Ww, Gs^Fp, Gll^Fp, Gll^Fp, Gll^Fp, Gll^Fp, Gll^Fp, Gll^Fp, Gll^Fp, Gll^Fp, Gll^Fp, Gll^Fp, Gg, Gg, Gg, Gs, Gs^Fms, Gs^Fds, Gg^Efm, Gs^Fds, Ce, Re, Re, Re, Ce, Ce, Gs^Fds, Gs^Fms, Gg, Gg, Gg, Gg, Ww, Gll^Fp, Gll^Fp, Ss, Gll^Fp, Gll^Fp, Gll^Fp, Gll^Fp, Gll^Fp, Gll^Fp
Gg, Gg, Gg, Wo, Gg, Gg, Gll^Fp, Gll^Fp, Gll^Fp, Gll^Fp, Gll^Fp, Gll^Fp, Ss, Gll^Fp, Gll^Fp, Gll^Fp, Gll^Fp, Wo, Wo, Gs, Re, Gg, Gs^Fms, Gs^Fds, Gg, Gg, Re, Re, Gg, Gs^Fds, Gs^Fms, Gs^Fms, Gs^Fp, Gg, Gs^Fp, Gg, Ww, Gg, Gll^Fp, Ss, Ss^Vhs, Ss, Gll^Fp, Gll^Fp, Gll^Fp, Gll^Fp, Gll^Fp
Gg, Gg, Gg, Wo, Gg^Fp, Gs, Gs, Gll^Fp, Gll^Fp, Gll^Fp, Gll^Fp, Ss^Vhs, Ww, Ss, Gll^Fp, Gll^Fp, Gll^Fp, Gg, Re, Wwf, Wo, Gg, Wo, Gs^Fms, Gg, Gg, Gs^Fms, Gg, Gs^Fms, Gg, Gg, Gs^Fms, Gg, Gs^Fp, Ww, Ww, Gll^Fp, Gll^Fp, Ss, Ss, Ss, Ss, Ss, Gll^Fp, Gg, Gg, Gg
Gs^Fp, Gs^Fp, Gg^Fp, Wo, Hh, Hh, Hh, Gs, Gll^Fp, Gll^Fp, Wo, Ww, Ww, Ww, Gll^Fp, Gll^Fp, Ss, Re, Ds, Gg, Gg, Wo, Gg, Gg, Gs^Fp, Gs^Fms, Gs^Fp, Gs^Fms, Gg, Gg, Gg^Efm, Gg^Efm, Gg^Efm, Gg, Gg, Ss, Ss, Ss, Ss, Ss, Ss, Gll^Fp, Ss, Gll^Fp, Gll^Fp, Gg, Gg
Gs^Fp, Gs^Fp, Gg^Fp, Wo, Wo, Hh, Wo, Ss, Wo, Wo, Gg^Fp, Gg^Fp, Gg^Fp, Ss^Vhs, Ss, Ds, Ss, Ss, Ss, Ss, Gg, Gg, Gg, Gs^Fp, Gs^Fp, Gs^Fp, Gg^Vh, Gs^Fp, Gg, Gg^Efm, Ss, Gs^Fp, Gs^Fp, Ss^Vhs, Gll^Fp, Gg, Ss, Ss, Ss, Ss, Gll^Fp, Gll^Fp, Gs, Gll^Fp, Gll^Fp, Gll^Fp, Gll^Fp
Gs^Fp, Gs^Fp, Gg^Fp, Ww, Ww, Wo, Hh, Wo, Hh, Ww, Ss, Gg^Fp, Gs^Fp, Gg^Fp, Gs^Fp, Ss, Ss, Ss, Ss, Ds, Re, Re, Re, Gs^Fp, Gs^Fp, Gs^Fp, Gs^Fp, Gs^Fp, Gg^Efm, Gg^Efm, Ss^Vhs, Ss, Ss, Ss, Gll^Fp, Gll^Fp, Ss, Ss, Gll^Fp, Gll^Fp, Gll^Fp, Gs, Gs, Gs, Gll^Fp, Gll^Fp, Gll^Fp
Gs^Fp, Gs^Fp, Gs^Fp, Gg^Fp, Gs^Fp, Hh, Hh, Hh, Hh, Ss, Ss, Gg^Fp, Gg^Fp, Ss, Ss, Ss, Gs^Fp, Ss, Re, Re, Gs^Vl, Gs^Fp, Gs^Fp, Re, Re, Gs^Fp, Gs^Fp, Gs^Fp, Gs^Fp, Gs^Fp, Gs^Fp, Gs^Fp, Gs^Fp, Ss, Ww, Gll^Fp, Gg, Gg, Gg, Gll^Fp, Gll^Fp, Gll^Fp, Re^Fp, Re^Fp, Re^Fp, Gll^Fp, Gll^Fp
Re, Re, Re, Gs^Fp, Gs, Hh, Hh, Hh, Hh, Ss, Gs^Fp, Re, Re, Ss, Gs^Fp, Ss, Re, Re, Gs^Fp, Gs^Fp, Gs^Fp, Gs^Fp, Wo, Gs^Fp, Re, Gs^Fp, Ww, Wo, Wo, Gs^Fp, Gg, Gs^Fp, Gs^Fp, Gs^Fp, Wo, Gll^Fp, Gll^Fp, Gg, Gll^Fp, Gll^Fp, Re^Fp, Re^Fp, Ce, Ce, Gd, Gs, Gs
Gs^Fp, Gs^Fp, Re, Gs^Fp, Re, Gs^Fp, Gs^Fp, Gs^Fp, Re, Hh, Gs^Fp, Re, Gs^Fp, Re, Re, Re, Gs^Fp, Gs^Fp, Wo, Gs^Fp, Wo, Gs^Fp, Wo, Ww, Wwf, Ww, Ss, Ss, Gs^Fp, Wo, Wo, Gg, Gg, Gs^Fp, Wo, Gll^Fp, Gll^Fp, Gll^Fp, Gll^Fp, Gll^Fp, Re^Fp, Ce, Ke, Ce, Gd, Re, Gs
Gs^Fp, Gs^Fp, Gs^Fp, Re, Gs^Fp, Re, Gs, Re, Gs^Fp, Re, Gs^Fp, Gs^Fp, Gs^Fp, Gs^Fp, Gs^Fp, Gs^Fp, Gs^Fp, Wo, Gg^Fp, Wo, Gg^Fp, Wo, Gg^Fp, Gg^Fp, Re, Gg^Fp, Gs^Fp, Gs^Fp, Gs^Fp, Gs^Fp, Gs^Fp, Wo, Wo, Ww^Bw\, Gg, Gll^Fp, Gg, Gg, Gg, Gll^Fp, Gd, Ce, Ce, Re, Gs, Gs, Gs
Gs^Fp, Gs^Fp, Gs^Fp, Gs^Fp, Gs^Fp, Gs^Fp, Gs^Fp, Gs^Fp, Gs^Fp, Gs^Fp, Gs^Fp, Gs^Fp, Gs^Fp, Gs^Fp, Gs^Fp, Gs^Fp, Wo, Wo, Gg^Fp, Gg^Fp, Gg^Fp, Gg^Fp, Gg^Fp, Re, Gg^Vl, Gg^Fp, Gs^Fp, Gs^Fp, Gs^Fp, Gs^Fp, Gs^Fp, Gs^Fp, Wo, Wo, Ss, Gg, Gg, Gg^Vh, Gg, Gg, Gs^Fp, Gd, Gs, Gs, Gs, Ss, Ss
Hh, Hh, Gs^Fp, Gs^Fp, Hh, Gs^Fp, Gs^Fp, Gs^Ve, Gs^Fp, Gs^Fp, Gs^Fp, Gs^Fp, Gs^Fp, Gs^Fp, Wo, Wo, Gg^Fp, Gg^Fp, Gg^Fp, Gg^Fp, Gg^Fp, Gg^Fp, Gs^Fp, Gg^Fp, Gg^Fp, Gg, Gg, Gs^Fp, Gs^Fp, Gs^Fp, Gs^Fp, Gs^Fp, Wo, Gg, Gs^Fp, Gs^Fp, Gs^Fp, Gg, Gs^Fp, Gs^Fp, Gs^Fp, Gs^Fp, Gs^Fp, Gs, Ss, 3 Ss^Vhs, Ss
Hh, Hh, Hh, Hh, Hh, Hh, Gs^Fp, Gs^Fp, Gs^Fp, Gs^Fp, Gs^Fp, Gs^Fp, Hh, Hh, Wo, Gg^Fp, Gg^Fp, Gg^Fp, Gg^Fp, Gg^Fp, Gg^Vh, Gg^Fp, Gg^Fp, Wo, Wo, Gg^Fp, Gg^Fp, Gs^Fp, Gs^Fp, Gs^Fp, Gs^Fp, Gs^Fp, Gs^Fp, Wo, Gs^Fp, Gs^Fp, Gs^Fp, Gs^Fp, Ww, Gs^Fp, Gs^Fp, Gs^Fp, Gs^Fp, Ss, Ss, Ss, Ss
Gs^Fp, Gs^Fp, Hh, Gs^Fp, Gs^Fp, Gs^Fp, Gs, Gs, Gs, Gs^Fp, Gs, Gs, Ss, Gg^Fp, Wo, Hh, Hh, Gg^Fp, Gg^Fp, Gg^Fp, Gg^Fp, Gg^Fp, Ww, Gg^Fp, Gg^Fp, Gg^Fp, Gg^Fp, Re, Gg, Gs^Fp, Gs^Fp, Ww, Gs^Fp, Ww, Ww, Gs^Fp, Ww, Ww, Gs^Fp, Ss, Gs^Fp, Gs^Fp, Gs^Fp, Ss, Gg, Ss, Ss
Gs^Fp, Gs^Fp, Gs^Fp, Gs^Fp, Gg, Gg, Gg, Gg, Gs, Hh, Gs, Ss, Ww, Wo, Gg^Fp, Hh, Gs^Fp, Gg^Fp, Gs^Fp, Gg, Ww, Ww, Ss, Ww, Ww, Ww, Gg^Fp, Gs^Fp, Gs^Fp, Re, Ss, Ww, Ww, Ww, Ww, Ww, Ss^Vhs, Gs^Fp, Gs^Fp, Gs^Fp, Gs^Fp, Gs^Fp, Gs^Fp, Gg, Gg, Gg, Gg
Gs^Fp, Gs^Fp, Wo, Gg, Wo, Gg, Wo, Hh, Hh, Gs^Vl, Hh, Hh, Wo, Wo, Gs^Vh, Gs^Fp, Gs^Fp, Gg^Fp, Gs^Fp, Ss, Gg^Fp, Ww, Ww, Ss, Ww, Gg^Fp, Gs^Fp, Gs^Fp, Gs^Fp, Re, Gs^Fp, Ss, Gs^Fp, Ss, Gs^Fp, Gs^Fp, Gs^Fp, Gg, Gg, Gg, Gs^Fp, Gs^Fp, Gs^Fp, Gs^Fp, Gs^Fp, Gg, Gg
Wo, Wo, Gg, Wo, Gg, Wo, Gg, Wo, Wo, Hh, Wo, Hh, Wo, Hh, Gg, Gs^Fp, Gs^Fp, Gg^Fp, Gs^Fp, Gg^Fp, Gg^Fp, Gg^Fp, Gg^Fp, Ww, Gg^Fp, Gg^Fp, Gs^Fp, Gs^Fp, Re, Re, Gs^Fp, Gs^Fp, Gs^Fp, Gs^Fp, Gs^Fp, Gs^Fp, Gs^Fp, Gs^Fp, Gs^Fp, Gs^Fp, Gs^Fp, Gs^Fp, Gs^Fp, Gs^Fp, Gs^Fp, Gs^Fp, Gs^Fp
Gg, Gg, Gg, Gg, Gg, Gg, Gg, Gg, Gg, Wo, Gg^Efm, Wo, Gg, Gg, Gs, Gs^Fp, Gs^Fp, Gs^Fp, Gs^Fp, Gs^Fp, Gs, Gs^Fp, Gs^Fp, Gg^Fp, Gg, Gs^Fp, Gg, Gs^Fp, Re, Gs^Fp, Gg, Gg, Gg, Gs^Fp, Gs^Fp, Gs^Fp, Gs^Fp, Gs^Fp, Gs^Fp, Gs^Fp, Gs^Fp, Gs^Fp, Gg, Gs^Fp, Gs^Fp, Gs^Fp, Gs^Fp
Gg, Gg, Gg, Gg, Gg, Gg, Gg, Gg, Gg, Gg, Gg, Gg, Gg, Gs, Gs, Gs^Fp, Gs^Fp, Gs^Fp, Gs^Fp, Gs^Fp, Gs, Gs^Fp, Gs^Fp, Gs^Fp, Gg, Gs^Fp, Gg, Gs^Fp, Re, Gs^Fp, Gg, Gg, Gg, Gs^Fp, Gs^Fp, Gs^Fp, Gs^Fp, Gs^Fp, Gs^Fp, Gs^Fp, Gs^Fp, Gs^Fp, Gg, Gs^Fp, Gs^Fp, Gs^Fp, Gs^Fp
