Gg, Gg, Gg, Gg, Gg, Gg, Gg, Gg, Gg, Gg, Gg, Gg, Gg, Gs^Fds, Gs^Fds, Gs, Gs^Fds, Gs^Fds, Gs^Fds, Gs^Fds, Gs^Fds, Hh, Gs^Fds, Gs^Fds, Gs^Fds, Hh, Hh, Hh, Gs^Fds, Gs^Fds, Ww, Ww, Wo, Wo, Ww, Gs^Fds, Gs^Fds, Gs^Fds
Gg, Gg, Gg, Gg, Re^Gvs, Re^Gvs, Re^Gvs, Re^Gvs, Gg, Gg, Gg, Gg, Gg, Gs^Fds, Gs^Fds, Gs^Vh, Gs^Fds, Gs^Fds, Gs^Fds, Gs^Fds, Gs^Fms, Hh, Gs^Fds, Gs^Fds, Gs^Fds, Hh, Hh, Hh, Gs^Fds, Gs^Fds, Ww, Gs^Fds, Wo, Wo, Ww, Gs^Fds, Gs^Fds, Gs^Fds
Gg, Gg, Re^Gvs, Gg^Vh, Gg, Re^Gvs, Re^Gvs, Re^Gvs, Gg, Gg, Gg, Gg, Gg, Gg, Gs^Fds, Gs^Fds, Gs^Fds, Gs^Fds, Gs^Fds, Gs^Fds, Gs^Fds, Gs^Fds, Gs^Fds, Gs^Fms, Gs^Fds, Hh, Hh, Gs^Fds, Gs^Fds, Gs^Fds, Gs^Fds, Ww, Ww, Ww^Bw\, Gs^Fds, Ww, Ww, Ww
Gg, Re^Gvs, Re^Gvs, Gg, Gs^Fds, Gg, Gs^Fds, Gg^Vh, Gs^Fds, Gg, Gg, Gg, Gg, Gg, Gg, Gg, Gs^Fds, Gs^Vh, Re, Gs^Fds, Re, Gs^Fds, Gs^Fds, Wo, Gs^Fms, Hh, Gs^Fds, Gs^Fds, Re, Gs^Fds, Re, Gs^Fds, Gs^Fds, Gs^Fds, Re, Gs^Fds, Gs^Fds, Gs^Fds
Gg, Re^Gvs, Re^Gvs, Gg, Gs^Fds, Gs^Fds, Ww, Gs^Fds, Gs^Fds, Gg, Gg, Gg, Gg, Gg, Gg, Gg, Gg, Re, Gs^Fds, Re, Gs^Vh, Re, Re^Fds, Gs^Fds, Re, Re, Re, Re, Gs^Fds, Re, Gs^Fds, Re, Re^Fds, Re, Gs^Fds, Re, Re, Re
Gg, Gg, Gg^Vh, Gg, Gs^Fds, Ww, Gs^Fds, Gg, Gg, Gg, Gg, Gg, Gg, Gg, Gg, Gg, Gg, Gs^Fds, Ww, Gs^Fds, Gs^Fds, Gs^Fds, Gs^Fds, Re, Gs^Fds, Gs^Fds, Gs^Fmw, Gs^Fds, Gs^Fds, Gs^Fds, Gs^Fds, Ss^Vhs, Ss, Gs^Fds, Ss^Vhs, Gs^Fds, Gs^Fds, Gs^Fds
Gg, Gg, Gg, Gg, Gg, Gs^Fds, Gg, Gg, Gg, Gg, Gg, Gg, Gg, Gg, Gg, Gg, Gg, Gs^Fds, Gs^Fds, Ww, Gs^Fds, Gs^Fds, Ww, Gs^Fds, Gs^Fmw, Gs^Fds, Gs^Fds, Gs^Fds, Gs^Fds, Ww, Ww, Ss, Ss, Ss, Ww, Ww, Ww, Ww
Gg, Gg, Gg, Gg, Gg, Gg, Gg, Gg, Gg, Gg, Gg, Gg^Vh, Re^Gvs, Gg, Gg, Gg, Gg, Gg, Gg, Gs^Fds, Gs^Fds, Ww, Gs^Fds, Gs^Fds, Gs^Fds, Gs^Fds, Gs^Fds, Gs^Fds, Gs^Fds, Ww, Ww^Bw/, Gs^Fp, Ww, Ww, Gs^Fms, Ww, Gs^Fms, Gs^Fms
Gg, Gg, Hh, Hh, Hh, Hh, Hh, Gg, Gg, Gg, Re^Gvs, Re^Gvs, Re^Gvs, Re^Gvs, Gg, Gg, Gg, Gg, Gg, Gg, Gs^Fds, Gs^Fds, Gs^Fms, Gs^Fds, Ss, Gs^Fds, Gs^Fds, Gs^Fmw, Gs^Fds, Gs^Fds, Gs^Fds, Ww, Ss, Ss, Ss, Gs^Fms, Gs^Fp, Gs^Fp
Hh, Hh, Gs^Fds, Gg, Gg, Gg, Gg, Hh, Hh, Gg, Gg, Re^Gvs, Re^Gvs, Re^Gvs, Gg, Gg, Gg, Gg, Gg, Gg, Gg, Gs^Fds, Gs^Fds, Gs^Fds, Gs^Fds, Ss, Gs^Fds, Gs^Fds, Gs^Fds, Gs^Fms, Gs^Fms, Ss, Gs^Fms, Ss^Vhs, Gs^Fms, Gs^Fms, Gs^Fms, Gs^Fp
Gg, Gg, Gg, Gg, Gg, Gg, Gg, Gg^Vh, Hh, Gg, Gg, Gg, Gg, Gg, Gg, Gg, Gg, Gg, Gg, Gg, Gs^Fds, Gs^Fds, Gg, Gs^Fds, Gg, Gs^Fds, Gs^Fds, Hh, Hh, Gs^Fds, Gs^Fms, Gs^Fms, Gs^Fms, Gs^Fms, Gs^Fp, Gs^Fp, Gs^Fp, Gs^Fp
Gg, Gg, Hh, Hh, Hh, Gg, Gg, Gg, Gg, Gg, Gg, Gg, Gg, Gg, Gg, Gg, Gg, Gg, Gg, Gg, Gs^Fds, Gg, Gg, Gg, Gg, Gs^Fms, Gs^Fds, Hh, Gs^Fds, Gs^Fds, Gs^Fms, Gs^Fp, Gs^Fmw, Gs^Fp, Gs^Fp, Gs^Fp, Gs^Fp, Gs^Fp
Hh, Hh, Gs^Fds, Rr, Gs^Fds, Hh, Hh, Gg, Gg, Gg, Gg, Gg, Gg, Gg, Hh, Gg, Gg, Gg, Gg, Gg, Gg, Gs^Fds, Gs^Fds, Gs^Fds, Gs^Fds, Gs^Fds, Gs^Fds, Gs^Fds, Gs^Fds, Gs^Fds, Gs^Fms, Gs^Fp, Gs^Fms, Gs^Fms, Gs^Fp, Gs^Fms, Gs^Fp, Gs^Fp
Rr, Rr, Kh, Ch, Ch, Rr, Hh, Gg, Gg, Gg, Gg, Gg, Gg, Hh, Gg, Hh, Gg, Gg, Gg, Gg, Gg, Gg, Gs^Fds, Gs^Fds, Gs^Fds, Gs^Fds, Gs^Fds, Gg, Gs^Fds, Gs^Fds, Gs^Fds, Gs^Fms, Gs^Fms, Gs^Vl, Hh, Gs^Fp, Gs^Fp, Gs^Fp
Gs^Fds, Gs^Fds, Ch, Mm, 2 Kh, Gs^Fds, Hh, Gg, Gg, Gg, Gg, Gg, Gg, Gg, Gg^Vh, Gg, Gg, Gg, Gg, Gg, Gg, Gg, Gg, Gs^Fds, Gs^Fds, Gs^Fds, Gs^Fms, Gs^Fds, Gs^Fds, Gs^Fmw, Gs^Fds, Gs^Fms, Hh, Hh, Hh, Hh, Hh, Hh
Rr, Rr, Gs^Fds, Ch, Gs^Fds, Rr, Hh, Gg, Gg, Gg, Gg, Gg, Gg, Gg, Re^Gvs, Re^Gvs, Re^Gvs, Gg, Gg, Gg, Gg, Gg, Gs^Fds, Gs^Fds, Gs^Fds, Gs^Fds, Gs^Fds, Gs^Fds, Gs^Fds, Gs^Fds, Gs^Fds, Gs^Fds, Gs^Fms, Gs^Fms, Gs^Fp, Gs^Fp, Gs^Fms, Gs^Fms
Hh, Hh, Hh, Rp, Hh, Hh, Gs, Gs, Gg, Gg, Gg, Gg, Gg, Gg, Re^Gvs, Re^Gvs, Re^Gvs, Re^Gvs, Gg, Gg, Gg, Gg, Gs^Fds, Gs^Fds, Gg, Gs^Fds, Gs^Fds, Gs^Fmw, Gs^Fds, Gs^Fds, Gs^Fds, Gs^Fds, Hh, Gs^Fms, Gs^Fms, Gs^Fp, Gs^Fp, Gs^Fms
Gs, Gs, Rp, Rp, Rp, Gs^Fds, Rp, Gs, Gs, Gg, Gg, Gg, Gg, Gg, Gg, Re^Gvs, Gg^Vh, Gg, Gs^Fds, Gg, Gg, Gg, Gg, Gg, Gs^Fds, Gs^Fds, Gs^Fds, Gs^Fds, Gs^Fds, Gs^Fds, Ce, 1 Ke, Ce, Gs^Fms, Gs^Fms, Gs^Vl, Gs^Fp, Gs^Fp
Rp, Rp, Rp, Rp, Rp, Rp, Rp, Rp, Gs, Gg, Gg, Gg, Gg, Gg, Gg, Gg, Gg, Gg, Gg, Gs^Fds, Gg, Gg, Gs^Fds, Gs^Fds, Gs^Fds, Gs^Fds, Gs^Fms, Gs^Fds, Hh, Hh, Ce, Gs^Ecf, Ce, Hh, Gs^Fms, Gs^Fp, Gs^Fms, Gs^Fp
Rp, Rp, Gg, Rp, Gg, Gs, Rp, Rp, Gs, Gg, Gg, Gg, Gg, Gg, Gg, Gg, Gg, Gg, Gs^Fds, Gs^Fds, Rp, Gg, Hh, Gg, Gg, Gs^Fds, Gs^Fds, Gs^Fds, Hh, Gs^Fds, Gs^Fds, Gs^Fds, Hh, Hh, Gs^Fms, Gs^Fms, Hh, Hh
Gg, Gg, Gg, Gg, Gg, Rp, Rp, Gs^Vh, Gs, Gg, Gg, Gg, Gg, Gg, Gg, Gg, Gg, Gg, Rp, Rp, Rp, Rp, Rp, Hh, Hh, Gs^Fds, Hh, Gs^Fds, Mm, Mm, Mm, Hh, Hh, Gs^Fds, Gs^Fds, Hh, Hh, Hh
Gg, Gg, Gg, Gg, Gg, Rp, Rp, Rp, Gs, Gs, Gs, Gg, Gg, Gg, Gg, Gg, Rp, Rp, Rp, Rp, Gs, Rp, Rp, Gs, Hh, Gs, Gs, Mm, Mm, Hh, Mm, Mm, Mm, Mm, Mm, Mm, Mm, Mm
Gg, Gg, Gg, Gg, Gg, Gg, Rp, Rp, Rp, Rp, Rp, Gs, Gs, Gs, Rp, Rp, Rp, Rp, Gs, Gs, Gs, Rp, Rp, Rp, Rp, Rp, Rp, Rp, Rp, Rp, Rp, Rp, 3 Rp, Rp, Rp, Mm, Mm, Mm
Gg, Gg, Hh, Gg, Gg, Gg, Gg, Rp, Rp, Rp, Rp, Rp, Rp, Rp, Rp, Rp, Hh, Gs, Gg, Gg, Gg, Gs, Gs, Rp, Rp, Rp, Rp, Rp, Rp, Rp, Rp, Rp, Rp, Rp, Rp, Rp, Rp, Rp
Hh, Hh, Hh, Gg, Gg, Gg, Gg, Gg, Gs, Gs, Gs^Vh, Rp, Rp, Rp, Gs^Fds, Hh, Hh, Gg, Gg, Gg, Gg, Gg, Gs^Fds, Gs^Vh, Hh, Gs, Hh, Mm, Mm, Mm, Mm, Mm, Mm, Mm, Mm, Rp, Rp, Rp
Gg, Gg^Vh, Re^Gvs, Re^Gvs, Re^Gvs, Gg, Gs, Gs, Hh, Hh, Hh, Gs, Gs, Gg, Gg, Gg, Gg, Gg, Gg, Hh, Gg, Hh, Gg, Gs^Fds, Gs^Fds, Mm, Mm, Gs^Fds, Gs^Fds, Hh, Hh, Gs, Gs^Fds, Gs, Gs^Fds, Mm, Mm, Mm
Gg, Gg, Re^Gvs, Re^Gvs, Re^Gvs, Re^Gvs, Gg, Gs, Gg, Gs, Gs, Gs, Gg, Gg, Gg, Gg, Gg, Gg, Gg, Gg, Gg, Gg, Gg, Gs^Fds, Gg, Gg, Gs^Fds, Gg, Gg, Gg, Gg, Gg, Gg, Gs^Fms, Hh, Hh, Gs^Fds, Gs^Fds
Gs^Fds, Gs^Fds, Gs^Fds, Gg, Gs^Fds, Gg, Gs^Fds, Gg, Gs^Fds, Gg, Gs^Fds, Gs^Fds, Gs, Gg, Gs^Fds, Gg, Gs^Fms, Gg, Gs^Fds, Gg, Gg, Gg, Gg, Gg, Gg, Gs^Fds, Gg, Gs^Fds, Gg, Gg, Gs^Fds, Gs^Fms, Gs^Fds, Gg, Gg, Gg, Gg, Gg
Gs^Fds, Gs^Fds, Gs^Fds, Gs^Fds, Gs^Fms, Gs^Fms, Gs^Fds, Gs^Fds, Gs^Fds, Gs^Fds, Gs^Fds, Gs^Fds, Gs^Fds, Gs^Fds, Gs^Fds, Gs^Fds, Gs^Fds, Gs^Fds, Gs^Fds, Gs^Fds, Gs^Fds, Gg, Gg, Gg, Gs^Fds, Gs^Fds, Gs^Fds, Gs^Fds, Gg, Gg, Gs^Fds, Gs^Fds, Gs^Fds, Gg, Gg, Gg, Gg, Gg
