Wo, Wo, Wo, Wo, Wo, Wo, Wo, Wo, Wo, Wo, Wo, Wo, Wo, Wo, Wo, Wo, Wo, Wot, Wot, Wot, Wot, Wwt, Dd, Gg, Gg, Gg, Gg, Gll^Fms, Gll^Fms, Gll^Fp, Gll^Fp, Gll^Fp, Gll^Fp, Gll^Fp
Wo, Wo, Wo, Wo, Wo, Wo, Wo, Wo, Wo, Wo, Wo, Wo, Wo, Wo, Wo, Wo, Wo, Wo, Wot, Wot, Wot, Wwt, Dd, Gg, Gg, Gg, Gg, Gll^Fds, Gll^Fms, Gll^Fms, Gll^Fms, Gll^Fp, Gll^Fms, Gll^Fp
Wo, Wo, Wo, Wo, Wo, Wo, Wo, Wo, Wo, Wo, Wo, Wo, Wo, Wo, Wo, Wot, Wot, Wot, Wot, Wot, Wot, Wwt, Dd, Gg, Gg, Gg, Gg, Gll^Fds, Gg, Gs^Fds, Gll^Fms, Gll^Fms, Gll^Fms, Gll^Fp
Wo, Wo, Wo, Wo, Wo, Wo, Wo, Wo, Wo, Wo, Wo, Wo, Wo, Wo, Wo, Wot, Wot, Wot, Wot, Wot, Wot, Wwt, Dd, Gg, Gg, Gg^Vh, Gg, Gg, Gg, Gll^Fms, Gll^Fms, Gs^Fds, Gll^Fms, Gll^Fms
Wo, Wo, Wo, Wo, Wo, Wo, Wo, Wo, Wo, Wo, Wo, Wo, Wo, Wo, Wo, Wo, Wo, Wot, Wot, Wot, Wot, Wwt, Dd, Gg, Gg, Gg, Gg, Gs, Gs, Gs, Gll^Fds, Gll^Fms, Gll^Fds, Gll^Fms
Wo, Wo, Wo, Wo, Wo, Wo, Wo, Wo, Wo, Wo, Wo, Wo, Wo, Wo, Wo, Wo, Wo, Wo, Wot, Wot, Wot, Wwt, Wwt, Dd, Gg, Gg, Gg, Gs, Gs, Gs, Gll^Fds, Gll^Fms, Gll^Fds, Gll^Fds
Wo, Wo, Wo, Wo, Wo, Wo, Wo, Wo, Wo, Wo, Wo, Wo, Wo, Wo, Wo, Wo, Wo, Wo, Wot, Wot, Wot, Wwt, Wwt, Dd, Dd, Gg, Gs, Gs, Gs, Gs, Gs^Vh, Gll^Fds, Gll^Fds, Gs^Fms
Wo, Wo, Wo, Wo, Wo, Wo, Wo, Wo, Wo, Wo, Wo, Wo, Wo, Wo, Wo, Wo, Wo, Wo, Wo, Wot, Wot, Wot, Wwt, Dd, Dd, Gg, Gs, Gs, Gs, Gs, Gs, Gll^Fds, Gll^Fds, Gll^Fds
Wo, Wo, Wo, Wo, Wo, Wo, Wo, Wo, Wo, Wo, Wo, Wo, Wo, Wo, Wo, Wo, Wo, Wo, Wo, Wo, Wot, Wot, Wot, Wwt, Dd, Gs, Gg, Gs, Gs, Gs, Gs, Gll^Fds, Gll^Fds, Gll^Fds
Wo, Wo, Wo, Wo, Wo, Wo, Wo, Wo, Wo, Wo, Wo, Wo, Wo, Wo, Wo, Wo, Wo, Wo, Wo, Wo, Wo, Wot, Wot, Wwt, Wwt, Dd, Gg, Gg, Gs, Gs, Gs, Gll^Fds, Gll^Fds, Gll^Fds
Wo, Wo, Wo, Wo, Wo, Wo, Wo, Wo, Wo, Wo, Wo, Wo, Wo, Wo, Wo, Wo, Wo, Wo, Wo, Wo, Wo, Wo, Wot, Wwt, Wwt, Dd, Dd, Gg, Gg^Es, Gs, Gs, Gs, Gs, Gs
Wo, Wo, Wo, Wo, Wo, Wo, Wo, Wo, Wo, Wo, Wo, Wo, Wo, Wo, Wo, Wo, Wo, Wo, Wo, Wo, Wo, Wo, Wot, Wot, Wwt, Dd, Dd, Gg, Gg, Gg, Gs, Gs, Gd, Gs^Es
Wo, Wo, Wo, Wo, Wo, Wo, Wo, Wo, Wo, Wo, Wo, Wo, Wo, Wo, Ww, Wo, Ww, Wo, Wo, Wo, Wo, Wo, Wo, Wot, Wot, Wwt, Dd, Gg, Gll^Vo, Gs, Rb, Gd^Es, Rb, Gd
Wo, Wo, Wo, Wo, Wo, Wo, Wo, Wo, Wo, Wo, Wo, Wo, Ww, Ww, Ww^Bw\, Ww, Gd^Vh, Wo, Wo, Wo, Wo, Wo, Wo, Wot, Wot, Wwt, Dd, Gg, Gs, Gs, Co, Rb, Rb^Es, Rb
Wo, Wo, Wo, Wo, Wo, Wo, Wo, Wo, Wo, Wo, Wo, Wo, Ww, Ww, Gd^Vo, Rb, Gd, Ww, Ww, Wo, Wo, Wo, Wo, Wo, Wot, Wwt, Wwt, Dd, Gs, Co, 3 Ko, Co, Rb, Rb
Wo, Wo, Wo, Wo, Wo, Wo, Wo, Wo, Wo, Wo, Wo, Wo, Ww, Ww^Bw\, Gll, Rb, Co, Ww, Dd, Wo, Wo, Wo, Wo, Wot, Wot, Wwt, Wwt, Dd, Dd, Co, Co, Co, Rb, Gd
Wo, Wo, Wo, Wo, Wo, Wo, Wo, Wo, Wo, Wo, Wo, Wo, Ww, Gd^Es, Rb, Gll, Co, Dd, Gd, Ww, Ww, Wo, Wo, Wo, Wo, Wot, Ww, Dd, Dd, Co, Gll, Gll, Gs^Es, Gd
Wo, Wo, Wo, Wo, Wo, Wo, Wo, Wo, Wo, Wo, Wo, Ww, Ww, Gd^Vh, Ww, Co, 2 Ko, Co, Gll^Es, Dd, Ww, Wo, Wo, Wo, Wo, Wo, Wo, Ww, Wwf, Gs, Gs^Vh, Gs, Gs, Gs
Wo, Wo, Wo, Wo, Wo, Wo, Wo, Wo, Wo, Wo, Wo, Ww, Ww, Ww, Gd, Co, Co, Co, Dd, Dd, Wo, Wo, Wo, Wo, Wo, Wo, Wo, Ww, Ww, Wwf, Ww, Gs, Gs, Gs
Wo, Wo, Wo, Wo, Wo, Wo, Wo, Wo, Wo, Wo, Wo, Wo, Wo, Ww, Ww^Bw/, Rb, Dd, Gd, Wwr, Wwr, Ww, Wo, Wot, Wot, Wot, Wo, Wo, Ww, Wwf, Ww, Ww, Ww, Ww, Ww
Wo, Wo, Wo, Wo, Wo, Wo, Wo, Wo, Wo, Wo, Wo, Wo, Wo, Ww, Ww, Dd, Wwt, Dd, Wwr, Wwr, Wwr, Wot, Wot, Wot, Wot, Wot, Wwt, Ww, Ds, Gg, Gg, Ww, Ww, Ww
Wo, Wo, Wo, Wo, Wo, Wo, Wo, Wo, Wo, Wo, Wo, Wo, Wo, Ww, Ww, Wwt, Wwt, Wwt, Wwt, Wwt, Wwr, Wot, Wot, Wot, Wot, Wot, Wwt, Wwf, Gg, Gg, Gg, Gg, Gg, Gg
Wo, Wo, Wo, Wo, Wo, Wo, Wo, Wo, Wo, Wo, Wot, Wot, Wot, Wot, Wwt, Ww, Wwt, Wwr, Wwt, Wwt, Wwt, Wwr, Ww, Wot, Wot, Wot, Wwt, Ds, Gg, Gg^Vh, Gs, Gs, Gg, Gg
Wo, Wo, Wo, Wo, Wo, Wo, Wo, Wo, Wo, Wo, Wot, Wot, Wot, Wot, Wot, Wwt, Wwt, Wwt, Wwt, Ww^Vm, Wwt, Wwr, Wwr, Wot, Wot, Wot, Wwt, Ds, Gs, Gs, Gs, Gs, Gs, Gs
Wo, Wo, Wo, Wo, Wo, Wo, Wo, Wo, Wo, Wot, Wot, Wot, Wot, Wot, Wot, Wwt, Wwt, Wwr, Wwt, Wwt, Wwt, Wwr, Wwt, Wwt, Wot, Wwt, Ds, Ds, Gs, Gs, Gs, Gs, Gs, Gs
Wo, Wo, Wo, Wo, Wo, Wo, Wot, Wo, Wot, Wot, Wot, Wot, Wot, Wot, Wot, Wot, Wwt, Wwt, Wwt, Wwr, Wwr, Wwt, Ww^Vm, Wwt, Wwt, Wwt, Ds, Ds, Gs, Gs, Gs, Gs, Gs, Gs
Wo, Wo, Wo, Wo, Wot, Wot, Wot, Wot, Wot, Wot, Wot, Wot, Wot, Wot, Wot, Wot, Wwt, Wwt, Wwt, Wwr, Wwr, Ds, Wwt, Wwt, Wwt, Wwt, Ds, Gg, Gs, Gg, Gs, Gs, Gs, Gs
Wot, Wo, Wot, Wo, Wot, Wot, Wot, Wot, Wot, Wot, Wot, Wot, Wot, Wot, Wot, Wot, Wwt, Wwt, Wwt, Wwt, Wwt, Wwr, Wwt, Wwt, Wwt, Ds, Gg, Gg^Vh, Gg, Gs, Gs, Gs, Gs, Gs
Wot, Wot, Wot, Wot, Wot, Wot, Wot, Wot, Wot, Wot, Wot, Wot, Wot, Wot, Wot, Wot, Wot, Wwt, Ww^Vm, Wwt, Wwt, Wwr, Wwr, Wwt, Ds, Ds, Gs, Gs, Gs, Gs, Gg, Gs, Gg^Es, Gs
Wot, Wot, Wot, Wot, Wot, Wot, Wot, Wot, Wot, Wot, Wot, Wot, Wot, Wot, Wot, Wot, Wwt, Wwt, Wwt, Wwt, Wwr, Wwr, Wwt, Wwt, Ds, Ds, Gs, Gs, Gs, Gg, Gs, Gs, Gs, Gs
Wot, Wot, Wot, Wot, Wot, Wot, Wot, Wot, Wot, Wot, Wot, Wot, Wot, Wot, Wot, Wot, Wot, Wwt, Wwt, Wwt, Wwt, Wwr, Ds, Ds, Gs, Gs, Gg, Gs, Gg, Gg, Gs^Vh, Gs, Gg, Gg
Wot, Wot, Wot, Wot, Wot, Wot, Wot, Wot, Wot, Wot, Wot, Wot, Wot, Wot, Wot, Wot, Wot, Wwt, Wwt, Wwt, Ds, Ds, Gs, Ds, Gs, Gs^Vh, Gg, Gs, Gs, Gs, Gg, Gg, Gg, Gg
Wot, Wot, Wot, Wot, Wot, Wot, Wot, Wot, Wot, Wot, Wwt, Wot, Wwt, Wot, Wwt, Wot, Wwt, Wwt, Ds, Ds, Gg, Ds, Gg, Gs, Gg, Gg, Gs, Gg, Gs, Gs, Gs, Gs, Gg, Gg
Wwt, Wwt, Wwt, Wot, Wot, Wot, Wwt, Wot, Wwt, Wot, Wwt, Ww^Vm, Wwt, Wot, Wwt, Wwt, Ds, Ds, Gg, Ds, Gg, Gg, Gg^Em, Gg, Rp, Gs, Gg, Gs, Gg, Gs, Gs, Gs, Gg, Gg
Wwt, Wwt, Wwt, Wot, Wot, Wot, Wwt, Wwt, Wwt, Wot, Wwt, Wwt, Ds, Wwt, Ds, Ds, Gg, Ds, Gg, Gg, Gg^Vh, Gg, Rp, Rp, Gg, Gs, Gg, Gg, Gg, Gs, Gs, Hh, Hh, Hh
Ds, Ds, Ds, Wwt, Wwt, Wot, Wwt, Ww^Vm, Wwt, Wwt, Ds, Wwt, Ds, Ds, Gg, Ds, Gg, Gg, Gg, Gg, Rp, Rd, Gg, Gg, Gg, Gg, Gg, Gs, Gg, Gs, Hh, Hh, Hh, Hh
Gg, Gg, Ce, Ds, Wwt, Wwt, Wwt, Wwt, Ds, Ds, Gg, Ds, Gg^Efm, Gg, Gg, Gg, Rd, Rd, Rd, Rd, Gg, Gg, Gg, Gg, Gg, Gg, Gg, Gg, Gs, Gs, Hh, Hh, Hh, Hh
Gg, Gg, 1 Ke, Ds, Wwt, Wwt, Wwt, Ds, Gg, Ds, Gg^Vh, Gg, Gg, Gg, Rd, Rp, Gg^Vh, Gg, Gg, Gg, Gg, Gg, Gg, Gg^Efm, Gg, Gg, Gg, Gg, Gs, Gs, Hh, Hh, Hh^Fms, Hh^Fms
Gg, Gg, Ce, Ds, Wwt, Gs^Vht, Wwt, Ds, Gg, Gg, Rr, Gg, Rr, Rp, Gg, Gg, Gg, Gg, Gg, Gg^Efm, Gg, Gg, Gg, Gg, Gg, Gg^Vh, Gg, Gg, Hh, Hh, Hh, Hh, Hh, Hh^Fms
Gg, Gg, Ce, Ds, Wwt, Wwt, Wwt, Ds, Rr, Rr, Gg, Rp, Gg, Gg, Gg, Gg^Efm, Gg, Gg, Gg, Gg, Gg^Vh, Gg, Gg, Gg, Hh, Gg, Hh, Hh, Hh, Hh^Fds, Hh^Fds, Hh^Fms, Hh^Fms, Hh^Fms
Gg, Gg, Gg, Ds, Wwf, Wwf, Wwf, Ds, Gg, Gg, Gg^Efm, Gg, Gg, Gg, Gg, Gg, Gg, Gg^Em, Gg, Gg, Gs, Gs, Gs, Gs, Hh^Fds, Hh, Hh, Hh, Hh^Fms, Hh, Hh^Fds, Hh^Fds, Hh^Fds, Hh^Fds
Gg, Gg, Gg, Ds, Wwf, Wwf, Wwf, Ds, Gg, Gg, Gg, Gg, Gg, Gg, Gg, Gg, Gg, Gg, Gg, Gg, Gs, Gs, Gs, Hh^Fds, Hh^Fms, Hh^Fms, Hh, Hh, Hh^Fms, Hh^Fms, Hh^Fms, Hh^Fds, Hh^Fds, Hh^Fds
