Mm, Mm, Mm, Hh, Hh, Re, Re, Gg, Gs^Fp, Gg, Gg, Gg, Gs^Fp, Hh^Fms, Hh^Fms, Hh, Mm, Mm, Mm, Mm, Mm, Hh, Hh^Fms, Gg, Gs^Fp, Gg, Gg, Gg, Gg
Mm, Mm, Mm, Hh, Hh, Re, Re, Gg, Gs^Fp, Gg, Gg, Gg, Gs^Fp, Gs^Fms, Hh^Fp, Hh, Mm, Mm, Mm, Mm, Mm, Hh^Fp, Hh^Fp, Gg, Gs^Fp, Gg, Gg, Gg, Gg
Mm, Mm, Mm, Hh, Gg^Vh, Gg, Re, Gg, Gg, Gg, Gg, Gs^Fms, Gs^Fp, Gs^Fp, Gs^Fms, Hh, Hh, Hh, Mm, Mm, Hh, Hh^Fms, Hh^Fp, Gs^Fms, Gs^Fp, Gg, Gg, Gg, Gg
Hh, Hh, Hh, Mm, Gg, Gg, Re, Gg, Gg, Gs, Gs, Gs, Gs^Vh, Gs, Gs^Fp, Hh, Mm, Mm, Hh, Hh, Gg, Hh, Gg, Gg, Gg, Gg, Gg, Gg, Gg
Gg, Gg, Gg, Gs, Gs, Gs, Gs, Re, Re, Gs, Ss, Ss, Gs, Gs, Hh, Hh, Mm, Mm, Hh, Hh, Gg, Gg, Gg, Gg^Vh, Re, Re, Re, Re, Re
Ds, Ds, Ds, Gg, Gs, Ss, Gs, Gg, Re, Gs, Ss, Ss, Gs^Fp, Gs, Mm, Hh, Mm, Mm, Hh, Hh, Gg, Gg, Re, Re, Gg, Ss, Gg, Gg, Gg
Ww, Ww, Ww, Ds, Gg, Gs, Gg, Gg, Gg, Re, Re, Gs, Gs^Fms, Hh, Hh, Mm, Mm, Hh, Gg, Gg, Gg, Re, Gs^Fp, Gs^Fms, Gs^Fp, Gg, Gg, Gg, Gg
Ww, Ww, Ww, Ds, Ds, Ds, Gg, Gg, Gg^Vh, Gg, Re, Gg, Gs^Fms, Gs^Fms, Hh, Mm, Hh, Hh, Gg, Gg, Re, Re, Gg, Gs^Fms, Gs^Fms, Gg, Gg, Gg, Gg
Wo, Wo, Ww, Ww, Ww, Ww, Ds, Gg, Gg, Gg, Re, Gg, Hh, Mm, Hh^Vhh, Mm, Hh, Gg, Re, Re, Gg, Gg, Ce, Gg, Gg, Ds, Ww, Ww, Ww
Wo, Wo, Wo, Ww, Ww, Ww, Ds, Gs^Fms, Gs^Fms, Gs^Fms, Gs^Fms, Re, Re, Hh, Gg, Hh, Re, Gg, Re, Gg, Re, Ce, 1 Ke, Gg, Ds, Ds, Ww, Ww, Ww
Wo, Wo, Wo, Wo, Ww, Ds, Gg, Gs^Fds, Gs^Fms, Gs^Fds, Hh^Fds, Hh, Hh, Re, Re, Re, Hh, Re, Hh, Gg, Gg, Re, Ce, Ce, Ds, Ww, Wo, Wo, Wo
Wo, Wo, Wo, Wo, Ww, Ds, Gg, Gs^Fds, Gs^Fds, Gs^Fds, Hh^Fds, Mm, Hh, Mm, Hh, Mm, Mm, Hh^Vhh, Hh, Mm, Gg, Gg, Gg, Ds, Ww, Ww, Wo, Wo, Wo
Wo, Wo, Wo, Wo, Wo, Ww, Ds, Gg, Gg^Vh, Mm, Mm, Mm, Mm, Hh, Mm, Mm, Hh, Hh, Mm, Mm, Gg, Gg, Gg, Ww, Ww, Wo, Wo, Wo, Wo
Wo, Wo, Wo, Wo, Ww, Ww, Ds, Gg, Hh, Hh, Mm, Mm, Mm, Hh, Mm, Hh, Hh, Mm, Mm, Hh, Hh, Hh, Gg, Gg, Ww, Wo, Wo, Wo, Wo
Wo, Wo, Wo, Ww, Ww, Gg, Gg, Gs, Gs, Hh, Mm, Hh, Hh, Mm, Hh, Hh, Mm, Mm, Hh, Hh, Hh, Gg, Gg, Gg, Ww, Ww, Wo, Wo, Wo
Wo, Wo, Wo, Ww, Ww, Gg, Gs, Gg, Gs, Mm, Hh^Vhh, Hh, Mm, Mm, Hh, Hh, Hh, Hh, Hh, Hh, Gg, Gg^Vh, Gg, Ww, Ww, Ww, Ww, Wo, Wo
Wo, Wo, Wo, Ww, Ww, Gg, Gg, Gs, Hh, Hh, Hh, Hh, Hh, Hh, Gs, Hh, Hh, Gs^Fp, Ss, Gs, Gs, Gg, Ds, Ww, Ww, Ds, Ww, Wo, Wo
Wo, Wo, Wo, Wo, Ww, Ww, Gs, Gs, Gs, Ww, Ww, Hh, Hh, Gs, Gs, Gs, Gs, Ss, Ss, Gs, Gs, Gs, Ww, Ww, Ww, Gg, Ww, Wo, Wo
Wo, Wo, Wo, Wo, Wo, Ww, Gs^Vh, Gs^Fdw, Ss, Ss, Ss, Gs, Hh, Gs, Gs, Hh, Gs, Gs, Ss, Gs, Gs, Ds, Ww, Ww, Ds, Gs, Ww, Wo, Wo
Wo, Wo, Wo, Wo, Ww, Ww, Gs^Fdw, Gs^Fdw, Gs, Gs, Gs^Fdw, Gs, Gs, Gs, Ss, Hh, Gs, Gs, Ww, Ww, Ww, Ww, Wo, Ww, Ww, Gs^Vh, Ww, Wo, Wo
Wo, Wo, Wo, Wwr, Wwr, Ww, Gs^Fdw, Gs^Fdw, Gs^Fdw, Gs, Gd^Fdw, Gs^Fdw, Gs^Vh, Gs, Ss, Ss, Gs, Gs, Ww, Ww, Ww, Ww, Wo, Wo, Ww, Ww, Ww, Wo, Wo
Wo, Wo, Wwr, Ds, Ww, Ww, Gs^Edp, Gd^Fdw, Gd^Vh, Gs, Gd, Gs, Gs, Ss, Gs, Gs^Edp, Gs, Ww, Wo, Wo, Wo, Wo, Wo, Wo, Ww, Wo, Wo, Wo, Wo
Wo, Wo, Ww, Gs^Vh, Ds, Wo, Ww, Gs^Fdw, Gd, Gd, Gd, Gd^Vh, Gs, Ww, Wwr, Gs, Gs^Vh, Ww, Wo, Wo, Wo, Wo, Wo, Wo, Wo, Wo, Wo, Wo, Wo
Wo, Wo, Ww, Gs, Ww, Wo, Wo, Ww, Chr, Chr, Gd, Gs, Ww, Ww, Wwr, Gs, Gs, Ww, Wo, Wo, Wo, Wo, Wo, Ww, Ww, Wo, Wo, Wo, Wo
Wo, Wo, Ww, Ww, Gs, Wo, Ww, Ww, Chr, 2 Khr, Chw, Ww, Ww, Wo, Wo, Wwr, Wwr, Wo, Wo, Wo, Wo, Wo, Wo, Wo, Ww, Wo, Wo, Wo, Wo
Wo, Wo, Ww, Gs^Vh, Wwr, Wwr, Gd, Ww, Ds, Chw, Ww, Ww, Ww, Wo, Wo, Wwr, Wwr, Wo, Wo, Wo, Wo, Wo, Ww, Ww, Ww, Wo, Wo, Wo, Wo
Wo, Wo, Wo, Ds, Wwr, Wo, Mm, Gd^Edp, Ds, Wwr, Wwr, Wo, Wo, Wo, Ww, Wo, Wo, Ww, Wwr, Wwr, Wwr, Ww, Ds, Wwr, Wwr, Ww, Wo, Wo, Wo
Wo, Wo, Wo, Wwr, Wo, Wo, Ww, Mm, Gs^Vh, Wwr, Wwr, Ww, Wo, Wo, Wwr, Wo, Wo, Wo, Wwr, Wwr, Gs^Vh, Gs, Hh^Vhh, Hh, Hh, Ww, Wo, Wo, Wo
Wo, Wo, Wo, Wo, Wo, Wo, Wo, Ww, Wwr, Wwr, Wo, Wwr, Wwr, Wo, Wo, Ww, Ww, Wo, Wo, Wo, Ww, Ww, Gs^Fds, Hh^Fds, Hh^Vhh, Ww, Ww, Wo, Wo
Wo, Wo, Wo, Wo, Wo, Wo, Wo, Wo, Wo, Wo, Wwr, Ds, Ds, Wwr, Wo, Gs^Vh, Ds, Ww, Wo, Wo, Wo, Ww, Gs^Vh, Gs^Fds, Gg, Ww, Ww, Wo, Wo
Wo, Wo, Wo, Wo, Wo, Wo, Wo, Wo, Wo, Wo, Wo, Wwr, Gs^Vh, Wo, Wo, Wwr, Wwr, Wwr, Wo, Wo, Wo, Ww, Ww, Ww, Ww, Ww, Wo, Wo, Wo
Wo, Wo, Wo, Wo, Wo, Wo, Wo, Wo, Wo, Wo, Wo, Wo, Ww, Wo, Wo, Wo, Wo, Wo, Wo, Wo, Wo, Wo, Wo, Wo, Wo, Wo, Wo, Wo, Wo
Wo, Wo, Wo, Wo, Wo, Wo, Wo, Wo, Wo, Wo, Wo, Wo, Ww, Wo, Wo, Wo, Wo, Wo, Wo, Wo, Wo, Wo, Wo, Wo, Wo, Wo, Wo, Wo, Wo
