Gs^Fp, Gs^Fp, Ss, Gs^Fp, Gs^Fms, Gs^Fms, Gs, Hh, Hh, Mm, Mm, Xu, Xu, Xu, Xu, Xu, Xu, Xu, Xu, Xu, Xu, Xu, Xu, Xu, Xu, Xu, Xu
Gs^Fp, Gs^Fp, Ss, Gs^Fp, Gs^Fdw, Gs^Fms, Gs, Hh, Hh, Mm, Mm, Xu, Xu, Xu, Xuc, Xu, Xu, Xu, Xu, Xu, Xu, Xuc, Xuc, Xu, Xu, Xu, Xu
Gs^Fms, Gs^Fp, Ss, Ss, Gs^Fmw, Gs^Fdw, Gs, Gs, Gd, Hh, Gd, Mm, Xuc, Xuc, Uu^Vu, Cer, Cer, 3 Ke, Cer, Cer, Uu, Uu, Xu, Xu, Mm, Xu, Xu
Gs^Fp, Gd^Fmw, Gs^Fmw, Gs^Fmw, Gs, Gs^Fmw, Gs, Gs^Fms, Gs^Vh, Gd, Hh, Rb, Rb, Uu, Uu, Uu, Uu, Cer, Uu, Uu, Uu, Uu, Xu, Xu, Mm, Mm, Mm
Gs^Fms, Gs^Fms, Gs^Fms, Gs, Gs^Fms, Gs, Gs^Fms, Gs^Fdw, Hh^Fp, Hh, Mm, Hh, Hh, Uu, Xu, Uu, Uu, Uu, Uu, Uu, Uu^Vud, Uu, Xu, Mm, Mm, Mm, Mm
Gs, Gs, Gs, Gs, Gd^Fmw, Gs^Fms, Gd^Fmw, Hh^Fms, Gs^Fms, Hh^Fms, Hh, Mm, Mm, Xu, Xu, Xu, Uu, Uu, Xu, Xu, Xu, Xu, Xu, Mm, Hh^Vhh, Hh, Hh
Gs, Gs, Gg, Gg, Gd^Fmw, Gs^Fms, Gd^Fmw, Gs^Fms, Gs, Gs, Hh, Mm, Mm, Xu, Mm, Xu, Hh, Rb, Rb, Hh, Hh, Mm, Mm, Mm, Hh, Gs, Gs
Gs, Gs, Gs, Gg^Vh, Gg, Gs^Fms, Gg, Gs^Fms, Gs, Hh, Hh, Mm, Hh, Mm, Hh, Mm, Hh, Rb, Rb, Gd, Gd, Hh, Hh, Hh, Hh, Gs, Gs
Ss, Ss, Gs, Gg, Rb^Gvs, Gg, Gg, Gg, Gg, Gg, Hh, Hh, Hh, Hh, Gs, Hh, Gd, Gd, Gd, Rb, Gd, Gd, Gd, Gs, Gs, Gs, Gs
Gs, Gs, Gg^Vh, Gg, Gg, Rb^Gvs, Rb^Gvs, Gg, Gg, Gs, Gs, Gs, Gs, Gs, Gs, Gd, Gs, Gs, Gd, Gs, Rb, Gs, Gs, Gs, Gs^Fmw, Gs^Fmw, Gs^Fmw
Gg, Gg, Gg, Gg, Gg^Vh, Gg, Gg, Gg, Gs^Fmw, Gs^Fmw, Gs^Fdw, Gg, Gg, Gg, Gs, Gs, Gs^Fms, Gs^Vht, Gs^Fms, Gs, Gs, Gs, Gs, Gs, Gs^Fmw, Gs^Fmw, Gs^Fmw
Ww, Ww, Ds, Gg, Gg, Gg, Gg, Gs^Fms, Gs^Fmw, Ss, Gs^Fms, Gg, Gg, Gs, Gg, Gs, Gs^Fmw, Gs^Fmw, Gs^Fms, Gs, Rb, Gs, Gg, Gg, Gg, Gs^Fms, Gs^Fms
Ww, Ww, Ww, Ds, Gg, Gg, Gg, Gd^Fmw, Gs^Fms, Gs^Fmw, Gs^Fms, Gg, Gg, Gg, Gg, Gs, Gs, Gs^Fms, Gs, Gs, Rb, Gs, Gg, Gs, Gs, Gs, Gs
Ww, Ww, Ww, Ww, Gg, Gg, Gs^Fms, Gd^Fmw, Gs^Fp, Ss, Gs^Fp, Gs^Fms, Gs^Fms, Gg, Gg, Gg, Gs, Gs, Gs, Re, Gs, Rb, Gs, Gs, Ss, Ss, Ss
Ww, Ww, Ww, Ww, Ww, Gg, Gs^Fms, Gs^Fms, Gs^Fms, Gs^Fp, Ss, Ss, Gs^Fms, Gg, Gs, Gg, Gs, Re, Gs, Gs, Ss, Gs, Re, Gs, Ss^Vhs, Ss, Ss
Ww, Ww, Ww, Ww, Ds, Ds, Gg, Gs^Fp, Gs^Fms, Ss, Ss, Gs^Fms, Rb^Gvs, Rb^Gvs, Gs, Gs, Re, Re, Gs^Vh, Ss, Ss, Gs, Gs, Gs, Gs, Ss, Ss
Wo, Wo, Ww, Ww, Ds, Ds, Gg, Gg, Gs, Gs, Ss, Gs, Gs, Rb^Gvs, Gs, Re, Gs, Gs, Gs, Ss, Ss, Ss, Gs, Gs, Re, Gs, Gs
Wo, Wo, Ww, Ww, Ww, Ds, Gg, Gs, Ss, Ss, Gg^Vh, Ss, Ss, Gs, Ww, Re, Ww, Ww, Ww, Ss, Gs, Gs, Gs, Gs, Gs, Gs, Gs
Wo, Wo, Wo, Ww, Ww, Gg, Gs, Gs, Ss, Ss, Gg, Gg, Ww, Ww, Ww, Ww^Bw|, Ww, Wo, Wo, Ww, Gs, Gs, Re, Re, Gs, Gs, Gs^Fms
Wo, Wo, Wo, Ww, Ww, Gg, Gg, Gs, Gs, Ss, Ww, Ww, Wo, Wo, Ww, Ww^Bw|, Gg, Ww, Ww, Ww, Ww^Bw/, Re, Gs, Gs, Gs, Gs^Fms, Gs^Fms
Wo, Wo, Wo, Ww, Ww, Ww, Gg, Gs, Gg, Ww, Wo, Wo, Ww, Ww, Ch, Rr, Ch, Ww, Ww^Bw/, Ww^Bw/, Ww, Ww, Ww, Ss, Gs, Gs^Fms, Gs^Fp
Wo, Wo, Wo, Ww, Ww, Ww, Gg, Gg^Vh, Ww, Ww, Ww, Ww, Ds, Gg, Gg, Rr, Rr, Rr, Ch, Ww, Ww, Wo, Wo, Ww, Ww, Ww, Ww
Wo, Wo, Wo, Ww, Ww, Ww, Ww, Ww, Wo, Wo, Ww, Ww^Bw\, Ds, Gg, Rp^Vhc, Rr, Gs^Fds, Gg, Gg, Gg, Ds, Ww, Ww, Wo, Wo, Ww, Ww
Wo, Wo, Wo, Wo, Wo, Ww, Ww, Ww, Ww, Ww, Ww^Bw\, Ds, Rr, Rr, Rr, Rr, Gs, Gs^Fds, Rr^Vhc, Gg, Gg^Vh, Ds, Gs^Fds, Ww, Ww, Wo, Wo
Wo, Wo, Wo, Wo, Ww, Ww, Ww^Bw\, Ww, Gg, Ww, Ww, Ds, Gs, Rr^Vhc, Gs, Rr, Rr, Gs, Gs, Gg, Gg, Gs^Fds, Gs^Fds, Ww, Ww, Wo, Wo
Wo, Wo, Wo, Wo, Ww, Ww, Ds, Ds, Gg, Gg, Ww, Ww, Ch, Gs, Rr, Rr, Ch, Rr, Rr, Gs, Gg^Efm, Gg^Vh, Ds, Ww, Wo, Wo, Wo
Wo, Wo, Wo, Ww, Ww, Ww, Ds, Rr, Rr, Gg^Vh, Gg, Ww, Rr, Rr, Rr, Ch, 2 Kh, Ch, Rr, Gs, Gs, Ds, Ww, Ww, Ww, Ww, Ww
Wo, Wo, Wo, Ww, Ww, Ww^Bw\, Ds, Gg, Rr, Rr, Rr, Ww^Bw/, Ch, Gs, Rr, Ch, Ch, Chr, Rr, Rr^Vhc, Gs, Ds, Ww, Wo, Ww, Ww, Ww
Wo, Wo, Wo, Ww, Ww, Ww, Ds, Rr, Gg, Gg^Vh, Gg^Efm, Ww, Gs, Gs, Rr^Vhc, Rr, Rr, Rr, Gs^Fds, Gs, Ch, Ww, Wo, Ww, Gg, Gg, Gg
Wo, Wo, Wo, Ww, Ww, Ww^Bw/, Ww, Ds, Ds, Gg^Efm, Ww, Ww, Gs^Fds, Gs^Fds, Gs, Gs, Gs, Rr, Rr, Gs, Rr, Ww, Ww, Ww, Gg, Gg, Gg
Wo, Wo, Wo, Wo, Ww, Ww, Ww, Ww^Bw/, Ww, Gg, Ww, Ww, Ww, Gs^Fds, Gs, Rr^Vhc, Rr, Rr, Rr^Vh, Rr, Ch, Ww^Bw\, Ww^Bw\, Gg, Gg, Gg^Vh, Gg
Wo, Wo, Wo, Wo, Wo, Ww, Ww, Ww, Ww, Ww, Ww, Wo, Ww^Bw/, Ds, Rr, Rr, Gg, Rr, Gg, Gg, Ds, Ww, Ww, Re, Re, Gg, Gg
Wo, Wo, Wo, Wo, Ww, Ww, Gg, Ww, Ww, Ww, Wo, Ww, Ww, Ds, Ds, Gg, Chr, Rr, Ch, Ds, Ww, Ww, Ww, Gg, Re, Gg, Gg
Wo, Wo, Wo, Ww, Ww, Ww, Gg, Gg, Gg, Ww, Wo, Ww, Ww, Ww^Bw/, Ww, Gg, Ww, Ww^Bw|, Ww, Ww, Ww, Ww, Gg, Gg, Re, Gg, Gg^Efm
Wo, Wo, Ww, Ww, Gg, Gg, Gs^Fds, Gg, Gg, Ww, Ww, Ww, Ww, Ww, Ww, Ww, Ww, Ww^Bw|, Ww, Ww, Gg, Gg, Gg, Gg, Re, Gg^Efm, Gg
Wo, Wo, Ww, Ww, Gg, Gs^Fms, Gs^Fms, Gg, Gg, Gg, Gg, Gg, Gg, Ww, Gg^Efm, Ww, Gg, Re, Gg, Gg, Re^Gvs, Re^Gvs, Gg, Re, Gg, Gg, Gg^Efm
Wo, Wo, Ww, Ww, Gg, Gs^Fds, Gs^Fds, Gg^Vh, Re^Gvs, Re^Gvs, Gg, Gg, Re^Gvs, Gg^Efm, Gg^Efm, Gg, Gg, Re, Gg, Re^Gvs, Gg, Gg, Re, Re, Gg, Gg, Gg
Wo, Wo, Wo, Ww, Gg, Gg, Gg^Efm, Gg, Gg, Gg, Re^Gvs, Re^Gvs, Re^Gvs, Re^Gvs, Gg, Gg^Efm, Gg, Re, Re, Gg, Re, Re, Gg, Gg, Gg^Vh, Gs^Fms, Gs^Fms
Wo, Wo, Wo, Ww, Ww, Gg, Gg, Gg, Gs^Fds, Gs^Fds, Gs^Fms, Re^Gvs, Gg, Gg, Gg^Vh, Gg, Gs^Fds, Gs^Fds, Re, Re, Gg, Gg, Re^Gvs, Re^Gvs, Gs^Fds, Gs^Fds, Gs^Fds
Wo, Wo, Ww, Ww, Ww^Bw\, Ds, Gg, Gs^Fms, Gs^Fds, Gs^Fds, Gs^Fms, Gg, Gs^Fds, Gg, Gg, Gg, Gg, Gs^Fds, Re, Gs^Fds, Gs^Fds, Gg^Vh, Re^Gvs, Re^Gvs, Gg, Gs^Fds, Gs^Fms
Wo, Wo, Ww, Ww, Ds, Ds, Gg, Gg^Vh, Gs^Fds, Gs^Fms, Gs^Fds, Gs^Fms, Gs^Fms, Gg^Efm, Gg, Gg, Gg, Gg, Re, Gs^Fds, Gs^Fds, Gs^Fds, Gg, Gg, Re^Gvs, Gg, Gg
Wo, Wo, Ww, Ww^Bw\, Ds, Rd, Gg, Gs^Fds, Gg, Gs^Fms, Gg, Gg, Gg, Gg, Re, Re, Re, Re, Re, Gg, Gg, Gg, Gg, Re^Gvs, Re^Gvs, Gg, Gg
Wo, Wo, Ww, Ww, Ds, Rd, Rd, Gg, Rd, Gg, Re, Re, Re, Re, Gg, Gg, Ce, Re, Gg, Re, Re, Re, Re, Gg, Gg, Gg, Gg
Wo, Wo, Ww, Ww^Bw\, Ds, Rd, Gg, Rd, Gg, Re, Gg, Gg, Gs^Fms, Gg, Gg, Ce, 1 Ke, Ce, Gg, Gg, Gg, Gg^Vh, Gg, Re, Re, Gg, Gg
Wo, Wo, Ww, Ww, Ds, Gg^Vh, Gg, Gg, Gs^Fms, Gg, Gs^Fds, Gs^Fds, Gs^Fds, Gg, Gg, Ce, Ce, Ce, Gg, Gg, Gs^Fds, Gg, Gs^Fms, Gg, Gg, Re, Re
Wo, Wo, Ww, Ww, Gg, Gg, Gg, Gs^Fms, Gs^Fds, Gs^Fms, Gs^Fms, Gs^Fms, Gs^Fds, Gs^Fds, Gg, Gg, Gg, Gg, Gg, Gg^Efm, Gg, Gs^Fds, Gs^Fms, Gs^Fds, Gs^Fms, Gg, Gg
Wo, Wo, Ww, Ww, Gg, Gg, Gg, Gs^Fms, Gs^Fms, Gs^Fms, Gs^Fds, Gs^Fms, Gs^Fms, Gs^Fds, Gg, Gg, Gg, Gg, Gg, Gg, Gg, Gs^Fms, Gs^Fms, Gs^Fds, Gs^Fms, Gg, Gg
