Gs^Fms, Gs^Fms, Gs^Fms, Gs^Fms, Gg, Hh, Hh, Hh, Hh, Mm, Hh, Mm, Mm, Mm, Mm, Hh, Hh, Mm, Mm, Mm, Mm, Mm, Mm, Mm, Mm, Mm, Hh, Mm, Mm, Mm, Mm, Hh^Fds, Hh^Fds, Hh^Fds, Gg, Gg, Gs^Fds, Gs^Fds, Gg, Gs^Fds, Gs^Fds, Gs^Fms
Gs^Fms, Gs^Fms, Gs^Fds, Gs^Fds, Gg, Hh, Hh, Hh, Hh, Mm, Hh, Mm, Mm, Mm, Mm, Hh, Hh, Mm, Mm, Mm, Mm, Mm, Mm, Mm, Mm, Mm, Hh, Mm, Mm, Mm, Mm, Hh^Fds, Hh, Hh^Fds, Gg, Gg, Gs^Fds, Gs^Fds, Gg, Gs^Fds, Gs^Fms, Gs^Fms
Gs^Fms, Gs^Fms, Gg, Gg, Gg, Hh, Hh, Hh, Hh, Mm, Mm, Mm, Mm, Hh, Mm, Mm, Mm, Mm, Hh, Mm, Mm, Mm, Hh, Mm, Hh, Hh, Hh^Vhh, Hh, Mm, Mm, Mm, Mm, Hh, Hh, Hh, Gg, Gg, Gs^Fms, Gs^Fds, Gs^Fms, Gs^Fds, Gs^Fms
Gs^Fds, Gs^Fms, Gg, Gg, Gg, Hh, Hh, Hh, Hh, Hh, Hh, Hh, Mm, Mm, Mm, Mm, Hh, Mm, Mm, Mm, Mm, Hh, Mm, Mm, Hh, Hh, Gg, Hh, Hh, Mm, Hh, Mm, Mm, Hh, Gg, Gg, Gg, Gs^Fms, Gg, Gg, Gs^Fms, Gs^Fms
Gs^Fds, Gs^Fds, Gg, Gg, Gg, Gg, Hh, Hh, Gg, Hh, Hh, Hh, Mm, Hh, Mm, Hh, Mm, Hh, Mm, Mm, Mm, Hh, Hh, Hh, Hh, Hh, Hh, Hh, Hh^Fds, Hh^Fds, Hh, Hh, Hh, Hh, Hh, Hh, Gg, Gg, Gg, Gg, Gg, Gg
Gg, Gg, Gg, Gg^Vh, Gg, Gg, Gg^Efm, Gg, Gg, Hh, Hh, Hh, Mm, Mm, Mm, Hh, Hh, Mm, Mm, Mm, Mm, Mm, Hh, Hh, Hh, Hh, Gg, Hh, Gs^Fds, Gs^Fds, Gg, Hh, Hh, Hh, Hh, Gs^Vh, Gs, Gg, Gs, Gg, Gg, Gg
Gg, Gg, Gg, Gg, Gg, Gg, Gg^Efm, Gg^Efm, Gg, Hh, Hh, Hh, Mm, Mm, Mm, Mm, Mm, Mm, Mm, Mm, Mm, Hh, Hh, Hh, Gg, Gg, Gg, Gg, Gg, Gs^Fds, Gs, Gg, Gs, Hh, Gs, Gs, Gs, Gs, Re, Gg, Re, Re
Rr, Rr, Rr, Gg, Gg, Gg, Gg, Gg, Gs^Fds, Gg, Hh^Fms, Hh, Hh, Mm, Mm, Hh, Hh, Gg^Vh, Mm, Mm, Hh, Hh, Hh, Hh, Hh, Gg, Gg, Gg, Gs, Gg, Gg, Gs, Gs, Gs, Gs, Ss, Re, Re, Gs, Re, Gs, Gs
Gg, Gg^Efm, Gg, Rr, Rr, Gg, Gg, Gg, Gs^Fms, Hh^Fms, Hh^Fms, Hh, Hh, Hh, Hh, Hh, Hh, Hh, Hh, Hh, Hh, Hh, Hh, Hh, Hh, Gg, Gg, Gg, Gg, Gs, Gs, Gs, Gs, Gs, Re, Rb, Rb, Gs, Gs, Gs, Gs, Gs
Gg, Gg^Efm, Gg^Efm, Gg, Gg, Rr, Rr, Gg, Gg, Hh^Fms, Hh, Hh, Hh, Hh, Hh, Hh, Hh, Hh, Gg^Vh, Hh, Hh, Hh, Gg, Hh, Gg, Gg, Hh, Hh, Hh, Gs, Gs, Gs, Re, Rb, Rb, Co, Co, Rb, Re, Gs, Gg, Gg
Gg, Gg, Gg, Gg, Ce, Gg, Gg, Rr, Gg, Gg, Gg, Hh, Gg, Hh, Hh, Hh, Hh, Hh, Hh, Gg, Gg, Gg, Gg, Gg, Gg, Gg, Hh, Hh, Gs^Vh, Hh, Gs, Re, Rb^Es, Rb, Co, 2 Ko, Rb, Rb, Gs, Gs, Gs, Gs
Gg, Gg, Gg, Ce, 1 Ke, Ce, Gg, Rr, Rr, Gg, Gg, Gg, Gg^Vh, Gg, Hh, Hh, Hh, Hh, Hh, Hh, Hh, Gg, Gg, Gg, Gg, Hh, Hh, Hh, Hh, Gs, Gs, Re, Re, Re, Re, Co, Re, Gs^Es, Gg, Gg, Gg, Gg
Gg, Gg, Gg, Ce, Ce, Ce, Gg, Gg, Gg, Rr, Rr, Gg, Hh, Hh, Hh, Hh, Mm, Mm, Hh, Hh, Hh, Gg, Gg, Gg, Gg, Gg, Hh, Hh, Gs, Gs, Re, Re, Gs, Gs, Hh, Rb, Gs, Gs, Gs^Vh, Gs^Fds, Gg, Gg
Gg, Gg, Gg, Gg, Gg, Gg, Gg^Efm, Gg, Gg, Gg, Rr, Gg, Gs^Fms, Hh, Hh, Hh, Mm, Mm, Hh, Hh, Hh, Hh, Gg, Gg, Gg, Gg, Re, Re, Re, Re, Gg, Gs, Gs, Gs, Hh, Hh, Gs, Gs, Gs^Fds, Gs^Fds, Gs^Fms, Gs^Fms
Gg, Gg, Gg, Gg, Gg, Gg^Em, Gg, Gg^Efm, Gg, Gg, Gg, Rr, Gs^Fms, Hh, Hh, Hh, Hh, Hh, Hh, Hh, Gg, Gg, Re, Re, Re, Re, Gg, Gg, Hh, Hh, Gg^Vh, Gg, Gs, Ss, Ss, Gs, Gs, Gg, Gs^Fms, Gs^Fms, Gs^Fms, Gs^Fms
Gg, Gg, Gg, Gg^Vh, Gs^Fds, Gg, Gg, Gg^Efm, Gg, Hh, Hh, Rr, Rr, Hh^Fms, Gg, Hh, Hh, Hh, Gg, Gg, Re, Re, Gs^Fds, Gs^Fds, Hh, Gg, Hh, Hh, Hh, Hh, Gg, Gg, Gs, Ss, Gs, Gs, Gs, Gg, Gg, Gs^Fms, Gs^Fms, Gs^Fms
Hh^Fms, Gs^Fds, Gs^Fms, Gs^Fms, Gs^Fds, Gs^Fms, Gg, Gg, Gg, Hh, Gg, Gg, Gg, Re, Rr, Gg, Gg, Gg, Rr, Rr, Hh, Hh, Hh, Hh, Hh, Hh, Hh^Fds, Hh, Hh, Gg, Hh, Gs, Hh, Gs, Hh, Gs, Hh, Gg, Gg, Gg, Gg, Gg
Hh^Fms, Hh^Fms, Hh^Fms, Gg, Hh, Gs^Fds, Gs^Fms, Gg, Gg, Gg, Ss, Gg, Gg, Gg, Gg, Re, Re, Re, Gg, Gg, Hh, Hh, Gg, Hh, Hh, Hh^Fds, Hh, Hh, Hh, Hh, Hh, Gs, Hh, Hh, Hh, Hh, Hh, Hh, Hh, Hh, Hh, Hh
Hh, Hh, Hh, Hh, Hh, Hh^Fms, Gs^Fms, Gs^Fms, Gs^Fp, Ss, Ss, Ss, Gs^Fp, Hh^Fms, Hh, Gg, Re, Gg, Hh, Hh, Hh, Hh, Hh, Hh, Gg, Hh, Gg, Hh, Hh, Hh, Hh, Hh, Hh, Hh, Hh, Hh, Hh, Hh, Hh, Hh^Fds, Hh^Fds, Hh
Hh, Hh, Hh, Hh, Hh, Hh^Fms, Hh, Gs^Fms, Gs^Fp, Gg, Gs^Fp, Ss, Gs^Fp, Gs^Fms, Hh, Gg, Re, Gg, Gg, Hh, Hh, Hh, Hh, Hh, Gg, Gg, Gg, Hh, Hh, Hh, Hh, Hh, Hh, Hh, Hh, Hh, Hh, Hh, Hh, Hh^Fds, Hh, Hh
Hh, Hh, Hh, Hh, Hh, Hh, Hh, Hh, Hh, Gs^Fp, Hh, Gs^Fp, Hh, Hh, Hh, Hh, Re, Gg, Gg, Hh, Hh, Hh, Hh^Fds, Hh, Hh, Gg, Gg^Vh, Hh, Hh, Hh, Hh, Hh, Hh, Hh, Hh, Hh, Gg, Hh, Hh, Hh, Hh, Hh
Hh, Hh, Hh, Hh, Hh, Gg, Gg, Gg, Gg, Hh, Hh, Hh, Gg^Vh, Hh, Hh^Fms, Hh, Rb, Gg, Hh, Hh, Hh, Hh, Hh, Hh, Hh, Hh, Hh, Hh, Hh, Hh, Hh, Hh, Gg^Vh, Hh, Hh, Hh, Hh, Hh, Hh, Gg, Gg, Gg
Hh, Hh, Hh, Hh, Hh, Hh, Gg^Vh, Gg, Hh, Hh, Hh, Hh, Gg, Hh, Hh, Gg, Rb, Gg, Gg, Hh, Hh, Hh, Gs, Hh, Hh, Hh, Hh, Hh, Hh, Hh, Hh, Gg, Hh, Gg, Gs^Fds, Gs^Fds, Hh, Hh, Gg, Gg, Hh, Hh
Hh^Fms, Hh^Fms, Gs^Fms, Hh, Hh, Hh, Hh, Hh, Hh, Hh, Hh^Fds, Hh, Hh, Hh, Hh, Gs^Fms, Gs, Rb, Rb, Gs, Hh, Hh, Hh, Hh, Gs, Hh, Hh, Hh, Hh, Hh, Hh, Hh, Hh, Hh, Hh, Hh, Hh, Hh, Hh, Gg, Hh, Hh
Gg, Gg, Gs^Fms, Gs^Fms, Hh, Hh, Hh, Hh, Hh^Fds, Hh, Hh, Hh, Hh, Hh, Hh, Gs^Fms, Hh, Gs, Rb, Gs, Hh, Hh, Hh, Hh, Hh, Hh, Hh, Hh, Hh, Hh, Hh, Hh, Hh, Hh, Hh, Hh, Hh, Hh, Hh, Hh, Hh, Hh
Gs^Fms, Gs^Fms, Gs^Fms, Gs, Gs, Hh, Gg, Hh, Gs^Fds, Gs^Fds, Gs^Fds, Hh, Hh, Hh, Hh, Hh, Hh, Hh, Rb, Gs, Gs, Hh, Hh, Hh, Hh, Hh, Hh, Hh, Hh, Gg, Gg, Hh, Hh, Hh, Hh, Hh, Hh, Hh, Hh, Hh, Hh, Hh
Gs^Fms, Gs^Fms, Gs^Fms, Ss, Ss, Gs, Gs, Gg, Gg, Gs^Fds, Hh^Fds, Gg, Hh, Hh, Hh, Hh, Gs^Vh, Hh, Gs, Rb, Rb, Rb, Hh, Hh, Hh, Hh, Hh, Gg, Gg, Gg, Gg, Hh, Hh^Vhh, Hh, Hh, Gg, Gg, Hh, Hh, Hh, Hh, Hh
Gs^Fms, Gs^Fms, Ss, Ss^Vhs, Ss, Gs, Gs, Gg, Gg, Gg, Gg, Hh, Gg, Gg, Gg, Hh, Gs, Gs, Hh, Rb, Co, Rb, Ss, Hh, Hh^Fms, Hh^Fms, Gs^Fms, Gg, Gs, Gg, Gs, Gg, Gg, Hh, Hh, Hh, Hh, Hh, Hh, Gg^Vh, Hh, Hh^Fms
Gs^Fms, Gs^Fms, Gs^Fms, Ss, Ss, Gs, Gg, Gg, Hh, Hh, Gg, Gg, Gg, Gg, Gg, Gg, Gs, Hh, Hh, Co, 3 Ko, Rb, Rb, Hh, Hh, Gs^Fms, Gs^Fms, Gs, Gg, Gs, Ss, Gs, Gs, Hh, Hh, Hh, Gg, Hh, Gg, Gg, Hh^Fms, Hh^Fms
Gs^Fms, Gs^Fms, Gs^Fms, Ss, Gs^Fms, Gs, Gg, Hh^Vhh, Hh, Hh, Hh, Gg, Gs, Gs, Gs, Gg, Gs, Hh, Hh, Hh, Co, Co, Rb, Rb, Rb, Gs^Vh, Gs, Gg, Gg, Gs, Gs, Gs, Gg, Gg, Gg, Hh, Gg, Gg, Hh^Fms, Hh^Fms, Hh^Fms, Hh^Fms
Gs^Fms, Gs^Fms, Gs^Fms, Ss, Gs^Fms, Gs, Gs^Fds, Gg, Hh, Hh, Gg, Gg, Gs^Fms, Gs^Fms, Gs^Fp, Gs, Gs, Gs, Hh, Hh, Hh, Hh, Hh, Gs, Gs, Rb, Rb, Gg, Gs, Gs, Gs, Gs, Gs, Gs, Gs^Fms, Gs, Gs^Fms, Gs^Fms, Gs^Fms, Gs^Fms, Gs^Fms, Gs^Fms
Gs^Fms, Gs^Fms, Gs^Fms, Ss, Gs^Fms, Gs^Fms, Gs^Fds, Gs^Fds, Hh, Hh, Gg, Gs, Gs^Fms, Gs^Fp, Gs^Fp, Gs, Gs, Gs, Hh, Hh, Hh, Hh, Hh, Gs, Gs, Rb, Rb, Gs, Gs, Gs, Gs, Gs, Gs, Gs^Fms, Gs^Fms, Gs^Fms, Gs^Fms, Gs^Fms, Gs^Fms, Gs^Fms, Gs^Fms, Gs^Fms
