Gll^Fdf, Gll^Fdf, Gll^Fdf, Gll^Fdf, Gll^Fdf, Gll^Fdf, Gll^Fdf, Gs, Gll^Fdf, Gs, Hh, Hh, Gs, Gs, Hh, Hh, Hh, Ww, Gs, Hh, Hh, Hh, Mm, Hh, Mm, Mm, Hh, Gs, Gs, Gll^Fmf, Gs, Gs, Gll^Fdf, Gd, Gs, Gs, Gs, Gs, Gs, Gs, Gs, Gs, Gs, Gs, Gs
Gll^Fdf, Gll^Fdf, Gll^Fdf, Gll^Fdf, Gll^Fdf, Gll^Fdf, Gs, Gll^Fdf, Gs, Gs, Hh, Gs, Gs, Gs, Gs, Hh, Hh, Ww, Gg, Hh, Hh, Hh, Hh, Hh, Mm, Mm, Hh, Hh, Gs, Gll^Fdf, Gll^Fmf, Gll^Fdf, Gll^Fdf, Gs, Gs, Gs, Gs, Gs, Gs, Gs, Gs, Gs, Gs, Gs, Re
Gll^Fdf, Gll^Fdf, Gll^Fdf, Gll^Fdf, Gll^Fdf, Gs, Gs, Gs, Gs, Gs, Gs, Gs, Gs, Gs^Vl, Gs, Gs, Hh, Ww, Ww, Gg, Gs, Gs, Gs, Hh, Mm, Mm, Hh, Gs, Gs, Gll^Fmf, Gll^Fmf, Gll^Fmf, Gs, Gs, Gd, Gd, Gs, Gs, Gs, Gs, Re, Gs, Re, Re, Gs
Gll^Fdf, Gll^Fdf, Gll^Fdf, Gll^Fdf, Gs, Gll^Fdf, Gs, Gs, Gs, Gd, Gs, Gs, Gg^Gvs, Gs, Gs, Gs, Gs, Gg, Ww, Gg^Vl, Gg, Hh, Hh, Hh, Mm, Mm, Gs, Gs, Gs, Gll^Fp, Gll^Fp, Gll^Fmf, Gs, Gs, Gs, Gs, Re, Re, Re, Re, Gs, Re, Gs, Gs, Gs
Gll^Fmf, Gll^Fdf, Gll^Fdf, Gll^Fdf, Gll^Fdf, Gs, Gll^Fdf, Gs, Gd, Gd, Gg^Gvs, Gg^Gvs, Gg^Gvs, Gg^Gvs, Gs, Gs, Gs, Gg, Ww, Ww, Gg, Hh, Hh, Hh, Hh, Hh, Gs, Gs, Gll^Fp, Gll^Fmf, Gll^Fdf, Gs^Fmf, Gs^Vh, Gs, Gs, Gs, Re, Gs, Gs, Gs, Gs, Gs, Gs, Gs, Gs
Gll^Fdf, Gll^Fmf, Gs, Gll^Fdf, Gs, Gll^Fdf, Gll^Fdf, Gs, Gs, Gd, Gs, Gg^Gvs, Gs, Gs, Gs, Gs, Gs, Gg, Gg, Ww, Gg, Hh, Hh, Hh, Hh, Gs, Gs, Gs, Gll^Fp, Gll^Fp, Gll^Fp, Gs^Fmf, Gll^Fp, Gs, Re, Re, Gs, Gs, Gs^Vh, Gs, Gs, Gs, Gs, Gs, Gs
Gll^Fmf, Gll^Fmf, Gll^Fmf, Gs, Gs, Gs, Gs, Gs, Gs, Gs, Gs, Gs, Gs, Gs, Gs, Gs, Gs, Gs, Gg, Ww, Gg, Hh, Hh, Hh, Hh, Gs, Gs, Gs, Gs, Gll^Fp, Gll^Fp, Gll^Fp, Gll^Fp, Gs, Re, Gs, Gs, Gd, Gs, Gs, Gs, Gs, Gs, Gs, Gs
Gll^Fdf, Gll^Fmf, Gll^Fmf, Gs, Gs, Gs, Gs, Gs, Gs, Gs, Gs, Gs, Gg^Gvs, Gs, Gs, Gs, Gll^Fmf, Gs, Gg, Ww, Gg, Gs, Gs, Gg^Vh, Hh, Hh, Gs, Gs, Gs, Gs, Gs, Gs, Re, Re, Gs, Gs, Gs, Gs, Gs, Gs, Gs, Gs, Gs, Gs, Gs
Gll^Fmf, Gll^Fmf, Gs, Gs, Gd, Gs, Gd, Gs, Gs, Gs, Gg^Gvs, Gg^Gvs, Gg^Gvs, Gg^Gvs, Gs, Gs, Gll^Fmf, Gs, Gg, Ww, Gg, Gg, Gs, Gs, Hh, Hh, Gs, Gs, Gs, Gs, Gs, Gs, Re, Gs, Ce, Ce, Ce, Gs, Gs, Gs, Gs, Gs, Gs, Gs, Gs
Gll^Fmf, Gll^Fmf, Gs, Gd, Gd, Gd, Gd, Gll^Fdf, Gll^Fmf, Gd, Gs, Gg^Gvs, Gs, Gs, Gs^Vl, Gll^Fmf, Gll^Fmf, Gs, Gg, Ww, Gg, Gs, Gs, Gs, Hh, Hh, Gs^Vh, Gs, Gs, Gs, Re, Re, Gs, Gs, Ce, 2 Ke, Ce, Gd, Gs^Vh, Gs, Gs, Gs, Gs, Gs, Gs
Gs, Gs, Gd, Gd, Gd, Gd, Gll^Fdf, Gll^Fdf, Gll^Fmf, Gs, Gs, Gd, Gs, Gs, Gs, Gll^Fmf, Gll^Fdf, Gll^Fmf, Gg, Ww, Ww, Gg, Gs, Gs, Gs, Gs, Gs, Gs, Gs, Gs, Re, Gs, Gs, Gd, Gd, Ce, Gd, Gs, Gs, Gs, Gs, Gs, Gs, Gs, Gs
Gd, Gd, Gd, Gd, Gd, Gd, Gs, Gs, Gs, Gs, Gs^Vl, Gs, Gs, Gs, Gs, Gll^Fdf, Gll^Fdf, Gll^Fdf, Gll^Fmf, Gg, Ww, Gg, Gs, Gs, Gs, Gs, Gs, Gs, Re, Re, Gs, Gs, Gs, Gs, Gs, Gd, Gs, Gs, Gs, Gs, Gs, Gs, Gs, Gs, Gs
Gd, Gd, Gd, Gd, Gd, Gd, Gs, Gs, Gs, Gs, Hh, Gs, Gs, Gs, Gs, Gll^Fdf, Gll^Fdf, Gll^Fdf, Gll^Fmf, Gg, Ww, Gs, Gs, Gs, Gs, Gs, Gs, Gs, Re, Gs, Gs, Gs, Gs, Gd, Gs, Gd, Gd, Gs, Gs, Gs, Gs, Gs, Gs, Gs, Gs
Gd, Gd, Gd, Gd, Gd, Gs, Gs, Gs, Gs, Gs, Hh, Gs, Gs, Gs, Gs, Gs, Gll^Fdf, Gs^Vh, Gs, Gs, Ww^Bw/, Re, Re, Re, Re, Re, Re, Re, Gs, Gs, Gs, Gs^Vh, Gs, Gs, Gd, Gd, Gd, Gd, Gd, Gs, Gs, Gs, Gs, Gs, Gs
Gd, Gd, Gd, Gd, Gs, Gs, Gs, Gs, Gs, Gs, Hh, Hh, Gs, Gs, Gs, Gs, Gll^Fdf, Gs, Re, Re, Ww, Gs^Vh, Gg, Gs, Gs, Gs, Gs, Gs, Gs, Gs, Gs, Gs, Gd, Gs, Gs, Gd, Gs, Gd, Gs, Gs, Gs, Gs, Gs, Gs, Gs
Gd, Gd, Gs, Gs, Gs, Gs, Gll^Fdf, Gs, Gs, Gs, Gs, Hh, Gs, Gs, Gs, Gs, Gs, Re, Gs, Gs, Ww, Ww, Gg, Gs, Gs, Gs, Gd, Gs, Gs, Gd, Gd, Gs, Gs, Gs, Re^Gvs, Re^Gvs, Re, Gs, Gs, Gs, Gs, Gs, Gs, Gs, Gs
Gd, Gd, Gs, Gs, Gs, Gll^Fdf, Gll^Fmf, Gll^Fmf, Gll^Fmf, Gs, Gs, Gs, Gs, Gs, Gs, Gs, Re, Re, Gll^Fmf, Gg, Gg, Ww, Gg, Gs, Gs, Gs, Gs, Gs, Gs, Gs, Gs, Gs, Gs, Re^Gvs, Re^Gvs, Re^Gvs, Gs, Gs, Re, Gs, Gs, Gs, Gs, Gs, Gs
Gs, Gs, Gs, Gs, Gs, Gll^Fdf, Gs, Gs, Gs, Gs, Gs, Gs, Gs, Gs, Gs, Gs, Re, Gll^Fmf, Gll^Fmf, Gs, Gg, Ww, Ww, Gg, Gg, Gs, Gs, Gs, Re^Gvs, Re^Gvs, Re^Gvs, Gs, Gs, Gs, Gs, Gd, Re, Re, Gs, Gs, Gs, Gs, Gs, Gs, Gs
Gs, Gs, Gs, Gs, Gs, Gs, Gs, Gs, Gs, Gd, Gs, Gll^Fdf, Gd, Gs, Gs, Gs, Re, Gll^Fdf, Gll^Fdf, Gll^Fdf, Gll^Fmf, Gg, Ww, Ww, Gg^Vh, Gs, Gg, Gs, Gs, Re^Gvs, Gs, Gs, Gs, Gll^Fp, Gs, Gs, Re, Gs, Gs, Gs, Gs, Gs, Gs, Gs, Gs
Gs, Gs, Gs, Gs, Gs, Gd, Gd, Gd, Gd, Gd, Gs, Gll^Fdf, Gll^Fmf, Gll^Fmf, Gll^Fmf, Gs^Fdf, Re, Gll^Fdf, Gll^Fdf, Gll^Fdf, Gll^Fmf, Gs, Gg, Ww, Ww, Gg, Ww, Gg, Gg, Gs, Gs, Gs, Gs, Gll^Fp, Gll^Fp, Gs^Vh, Re, Gs, Gs, Gs, Gs, Gs, Gs, Gs, Gs
Gs, Gs, Gs, Gs, Gd, Gd, Gd, Gd, Gd, Gd, Gll^Fmf, Gll^Fmf, Gll^Fdf, Gll^Fmf, Gs^Vh, Gll^Fmf, Re, Gll^Fmf, Gs, Gll^Fmf, Gs, Gs, Gs, Gg, Ww, Ww, Ww, Ww, Gg, Gs^Vh, Gs, Gs, Gs, Gll^Fp, Gll^Fp, Re, Gs, Gll^Fp, Gll^Fp, Gs, Gs, Gs, Gs, Gll^Fp, Gs
Gs, Gs, Gs, Gd, Gs, Gd, Gd, Gs, Gll^Fdf, Gll^Fdf, Gll^Fdf, Gll^Fdf, Gll^Fdf, Gll^Fmf, Re, Re, Gll^Fmf, Gll^Fmf, Gll^Fdf, Gs, Gs, Gs, Gs, Gg, Gg, Ww, Gg^Vh, Ww, Ww, Gg, Gs, Gs, Gs, Gll^Fp, Re, Re, Gs, Gll^Fp, Gll^Fp, Gs, Gs, Gs, Gs, Gll^Fp, Gll^Fp
Gll^Fdf, Gll^Fdf, Gll^Fdf, Gll^Fdf, Gs, Gs, Gs, Gs, Gll^Fdf, Gll^Fdf, Gll^Fdf, Gll^Fmf, Gll^Fmf, Gll^Fdf, Re, Gs^Fdf, Gll^Fmf, Gll^Fdf, Gll^Fdf, Gs, Re^Gvs, Re^Gvs, Re^Gvs, Gs, Re, Re, Re, Gg, Ww, Gg, Gg, Gs, Gs, Gll^Fp, Re, Gll^Fp, Gs, Gll^Fp, Gll^Fp, Gll^Fp, Gs, Gs, Gs, Gll^Fp, Gll^Fp
Gll^Fdf, Gll^Fdf, Gll^Fdf, Gll^Fdf, Gll^Fdf, Gs, Gs, Gs, Gll^Fdf, Gll^Fdf, Gll^Fdf, Gll^Fmf, Gs, Gll^Fmf, Re, Gs^Vh, Gs, Gll^Fmf, Gs, Re, Re, Re^Gvs, Gs, Re, Gll^Fmf, Gll^Fmf, Re, Gg, Ww, Ww, Gg^Vl, Gs, Gs, Gs, Re, Gll^Fp, Gll^Fp, Gll^Fp, Gll^Fp, Gs, Gs, Gs, Gll^Fp, Gll^Fp, Gll^Fp
Gll^Fdf, Gll^Fdf, Gll^Fdf, Gs, Gs, Gs, Gs, Gs, Gs, Gs, Gd, Gs, Gs, Gs, Re, Gs, Re, Re, Re, Gs, Gs, Gs, Re, Re, Gll^Fmf, Gll^Fmf, Gll^Fmf, Re, Gg, Ww, Ww, Gg, Re, Re, Gll^Fp, Gll^Fp, Gll^Fp, Gll^Fp, Gll^Fp, Gs, Gs, Gll^Fp, Gd, Gll^Fp, Gll^Fp
Gll^Fdf, Gll^Fdf, Gll^Fdf, Gll^Fdf, Gll^Fdf, Gs, Gs, Gs, Gs, Gd, Re, Gd, Re, Re, Gs, Re, Gd, Gd, Gd, Re, Re, Re, Gd, Gs, Gll^Fmf, Gll^Fp, Gll^Fp, Re, Re, Gg, Ww^Bw/, Re, Gg, Gs, Gll^Fp, Gll^Fp, Gll^Fp, Gs, Gs, Gs, Gll^Fp, Gs, Gd, Gll^Fp, Gll^Fp
Gs, Gs, Gs, Gll^Fdf, Gs, Gs, Gs, Gs, Re, Re, Gd, Re, Gd, Gd, Gd, Gd, Gd, Gd, Gd, Gs, Gd, Gd, Gd, Gs, Gll^Fmf, Gll^Fp, Gll^Fmf, Gll^Fmf, Gs, Re, Ww, Ww, Gg, Gs, Gll^Fp, Gll^Fp, Gll^Fp, Gs, Gs, Gs, Gs, Gll^Fp, Gll^Fp, Gll^Fp, Gll^Fp
Gs, Gs, Gs, Gs, Gs, Gs, Gs, Gs, Gs, Gd, Gs, Gd^Vh, Gd, Gd, Gd, Gd, Gd, Gd, Gs, Gs, Gd, Gd, Gs, Gs, Gll^Fmf, Gll^Fmf, Gll^Fmf, Gll^Fp, Gs, Gg, Gg, Ww, Ww, Gg, Gs, Gs, Gll^Fp, Gs, Gs, Gs, Gs, Gs, Gs, Gll^Fp, Gll^Fp
Gs, Gs, Gs, Gs, Gs, Gs, Gd, Gs, Gd, Gs, Gd, Gd, Gd, Gd, Gd, Gd, Gd, Gd, Gd, Gs, Gs^Vh, Gs, Gs, Gs, Gs, Gll^Fp, Gll^Fp, Gll^Fp, Gs, Gg, Ds, Ww, Ww, Gg, Gg, Gs, Gll^Fp, Gs, Gs, Gs, Gs, Gs, Gs, Gs, Gs
Gs, Gs, Gs, Gs, Gs, Gd, Gs, Gs, Gs, Gd, Gs, Gd, Ce, Gd, Gd, Gd, Gd, Gs, Gs, Gs, Gs, Gs, Gs, Gd, Gs, Gs, Gs, Gs, Gs, Ds, Ww, Ww, Ds, Gg, Gg, Gs, Gs, Gs, Gs, Gs, Gs, Gs, Gs, Gs, Gs
Gs, Gd, Gd, Gd, Gd, Gd, Gs, Gs, Gs, Gs, Gd, Ce, 1 Ke, Ce, Gd, Gd, Gd, Gs, Gd, Gd, Gs, Gs, Gd, Gs, Gs, Gs, Gs, Gs, Gs, Ds, Ww, Ww, Ds, Gs^Vl, Gg, Ww, Gg, Gg, Gg, Gs, Gs, Gs, Gs, Gs, Gs
Gd, Gd, Gd, Gd, Gd, Gs, Re, Re, Gd, Gd, Gd, Ce, Ce, Ce, Gd, Gd, Gs, Gd, Gd, Gs, Gs, Gd, Gs, Gs, Gs, Gs, Gs, Gs, Gs, Ds, Ds, Ww, Ww, Ds, Ww, Ww, Gg, Gg, Gg, Gg, Gg, Gs, Gg, Gs, Gs
Gd, Gd, Gd, Gd, Gs, Gs, Re, Gs, Gs, Gd, Gs, Gd, Gs, Gd, Gs, Gs, Gs, Gs, Gs, Gs, Gs, Gs, Gs, Gs, Ds, Gs, Ds, Ds, Ds, Gs, Gs, Ds, Ww, Ww, Ww, Gg, Gg, Gg, Gg, Gg, Gg, Gg, Gg, Gg, Gs
Re, Re, Re, Gd, Gd, Gd, Re, Gs, Gs, Gs, Gs, Gs, Gs, Gd, Gs, Gs, Ds, Ds, Ds, Ds, Ds, Gs, Gs^Vh, Ds, Ww, Ds, Ww, Ww, Ds, Gs, Ds, Ds, Ww, Ww, Wo, Ww, Ww, Gg, Ww, Gg, Gg, Gg, Gg, Gg, Gg
Gd, Gd, Gs, Re, Re, Re, Gs, Gs, Gs, Gs, Gs, Hh, Gs, Gs, Gs, Gs, Ds, Ww, Ww, Ww, Ww, Ds, Ds, Ds, Ww, Ww, Ww, Ww, Wo, Ds, Wo, Wo, Wo, Wo, Wo, Wo, Ww, Ww, Ww, Wo, Wo, Gg, Gg, Gg, Gg
Gd, Gd, Gs, Gs, Gs, Gs, Gs, Hh, Hh, Hh, Hh, Hh, Hh, Hh, Hh, Gs, Gs, Ww, Ww, Ww, Ww, Ww, Ww, Ww, Ww, Ww, Wo, Wo, Wo, Wo, Wo, Wo, Wo, Wo, Wo, Ww, Ww, Ww, Ww, Wo, Wo, Wo, Wo, Gg, Gg
Gs, Gs, Gs, Gs, Gs, Gs, Hh, Mm, Mm, Mm, Hh, Hh, Hh, Mm, Gs, Gs, Ww, Ww, Ww, Ww, Ww, Ww, Ww, Ww, Ww, Wo, Wo, Wo, Wo, Wo, Wo, Wo, Wo, Wo, Ww, Ww, Wo, Wo, Wo, Wo, Wo, Wo, Wo, Wo, Wo
Gs, Gs, Gs, Hh, Gs, Hh, Hh, Mm, Mm, Mm, Hh, Mm, Hh, Hh, Gs, Ww, Ww, Ww, Ww, Ww, Ww, Ww, Ww, Ww, Ww, Ww, Wo, Wo, Wo, Wo, Wo, Wo, Wo, Ww, Ww, Ww, Ww, Wo, Wo, Wo, Wo, Wo, Wo, Wo, Wo
Hh, Hh, Hh, Hh, Hh, Mm, Mm, Mm, Hh, Mm, Gd, Hh, Gs, Gs, Gs, Ww, Gg^Vh, Ww, Ds, Ww, Ds, Ds, Ww, Ds, Ww, Wo, Wo, Wo, Wo, Wo, Wo, Wo, Ww, Ww, Ds, Ww, Ww, Wo, Wo, Wo, Wo, Wo, Wo, Wo, Wo
Mm, Hh, Mm, Hh, Mm, Mm, Mm, Mm, Hh, Hh, Gd, Gd, Gd, Gd, Ww, Ww, Gg, Gg, Gg, Ds, Gg, Gg, Ds, Ww, Ww, Ww, Ww, Wo, Wo, Wo, Ww, Wo, Ww, Gs, Gs^Vl, Ww, Ww, Wo, Wo, Wo, Wo, Wo, Wo, Wo, Wo
Mm, Mm, Mm, Mm, Mm, Mm, Hh, Mm, Hh, Hh, Gs, Gd, Ww, Ww, Ww, Gg, Gs, Gs, Gs, Gs, Gs, Gg, Gg^Vh, Ds, Ww, Ww, Ww, Ww, Ww, Ww, Ww, Ww, Ww^Bw/, Gs, Gs^Fp, Gs, Ww, Wo, Wo, Wo, Wo, Wo, Wo, Wo, Wo
Mm, Mm, Mm, Mm, Mm, Mm, Hh, Hh, Hh, Gs, Ww, Ww, Hh, Hh, Gg^Em, Gs, Gs, Gs, Gd, Gs, Gs, Gs, Gg, Ds, Ww, Ww, Ww, Ww, Ww, Ww, Wo, Ww, Ww, Ds, Ww, Gs^Fp, Ww, Wo, Wo, Wo, Wo, Wo, Wo, Wo, Wo
Mm, Mm, Mm, Mm, Mm, Hh, Hh, Hh, Hh, Ww, Ww, Hh, Hh, Hh, Gg, Gs, Gs, Gd, Gd, Gd, Gs, Gs, Gg, Ds, Ww, Ww, Wo, Wo, Wo, Wo, Wo, Wo, Wo, Ww, Wo, Ww, Wo, Wo, Wo, Wo, Wo, Wo, Wo, Wo, Wo
