Mm, Mm, Mm, Mm, Mm, Mm, Mm, Hh, Gs, Gd, Gs, Gd, Gd, Gd, Gd, Gd, Gd, Gd, Gd, Gd, Gd, Gd, Gd, Gd, Gd, Gd, Gs, Gd, Gd, Gd, Gd, Gd, Gd, Gd, Gd, Gd, Re, Re, Gd, Gd, Gd, Gd, Gll^Fp, Gd, Gd, Gd
Mm, Mm, Mm, Mm, Mm, Mm, Mm, Hh, Gs, Gs, Gd, Gd, Gd, Gd, Gd, Gd, Gd, Gd, Gd, Gd, Gs, Gd, Gs, Gs, Gd, Gd, Gd, Gd, Gd, Gd, Gd, Gd, Gd, Gd, Gd, Gd, Re, Re, Gd, Gd, Gd, Gd, Gll^Fp, Gd, Gll, Gs
Mm, Mm, Mm, Mm, Hh, Mm, Hh, Hh, Gs, Gd, Gs, Gd, Gs, Gd, Gd, Gd, Re, Gd, Gd, Gd, Gs, Gs, Gd^Vl, Gd, Gs, Gd, Gs, Gs, Gll^Fp, Gs, Gll^Fp, Gd, Gs, Gd, Gd, Re, Re, Re, Gd, Gd, Gd, Gll, Gll^Fmf, Gll^Fp, Gll^Fp, Gll^Fp
Mm, Mm, Hh, Hh, Hh, Hh, Gs^Vc, Hh, Gs, Gs, Gs, Gs, Gs, Gs, Re, Re, Re^Es, Re, Gd, Gs, Gs^Es, Gs, Gs, Gs, Gs^Em, Gs, Gs, Gll, Gll^Fp, Gll^Fp, Gll^Fp, Gll^Fp, Gll, Gd, Re, Re, Re, Gd, Gd^Vl, Gd, Gd, Gd, Gll^Fp, Gll^Fp, Gll^Fp, Gll^Fp
Mm, Mm, Hh, Hh, Gs, Gs, Gs, Gs, Gs, Gs, Gs, Gs, Gs, Gs^Vc, Co, Co, Co, Rb, Rb, Gd, Gd, Gs, Gs, Gs, Gs, Gs, Gll, Gll^Fp, Gll, Gll^Fmf, Gll, Gll^Fp, Gll^Fp, Gd, Re, Re, Gd, Gd, Gs, Gs, Gs, Gs, Gll^Fp, Gll^Fmf, Gll^Fp, Gll^Fp
Hh, Hh, Hh, Hh, Gs, Gs, Gs, Gs, Gs, Gs, Gll^Fp, Gs, Gll^Fp, Rb, Co, 3 Ko, Co, Co^Es, Rb, Re, Gd, Gs, Gs, Gs, Gs, Gs, Gs, Gll^Fp, Gs, Gs, Gd, Gd, Re, Re, Re, Re, Gd, Gs, Gg, Gs, Gs, Gs^Em, Gll, Gll^Fp, Gll^Fp, Gs^Fp
Gs, Gs, Gs, Gs, Gs, Gs, Gg, Gs, Gll^Fmf, Gll^Fp, Gll^Fdf, Gll^Fmf, Gll^Fp, Rb, Rb^Es, Co, Rb, Rb^Es, Gd, Re, Gd, Gs, Gs, Gs, Gs, Gs, Gs^Vc, Gs, Gs, Gs, Gd, Re, Re, Re, Gd, Gd, Gs, Gg, Gg, Gg, Gs, Gg, Gs, Gs^Em, Gs, Gs
Gs, Gs, Gs, Gs, Gs^Vl, Gg, Gs, Gs, Gll^Fmf, Gll^Fmf, Gll^Fdf, Gll^Fdf, Gll, Re, Gd, Rb, Gd, Re, Gd, Gs^Es, Gs, Gs, Gs, Gs, Gs, Gs, Gs, Gs, Gs, Gs, Rd, Re, Rd, Rd, Gs^Vc, Gs, Gg, Gg, Gg, Gg, Gg, Gg, Gg, Gg, Gg^Em, Gg
Gg, Gg, Gg, Gg, Gg, Gs, Gg, Gs, Gs, Gs^Fmf, Gs, Gs, Gs, Gd, Gs, Gd, Gs, Gs, Gs, Gs, Gs, Gs, Gs, Gs, Gs, Gs, Gs, Gs, Gs, Gs, Rd, Rd, Rd, Gs, Gg, Gs, Gg, Gg, Gg, Gg, Gg, Gg, Ds, Gg, Gg, Gg
Gg, Gg, Ds, Gg, Gg, Gg, Gg, Gs, Gg, Gs, Gs, Gs, Ds, Gs, Gs, Gs^Es, Gs, Gs, Ds, Gs, Gs, Gs, Ds, Ds, Ds, Ds, Ds, Gs, Ds, Ds, Ds, Ds, Ds, Ds, Ds, Gg, Ds, Ds, Ds, Ds, Ds, Ds, Ds, Ds, Ds, Ds
Ds, Ds, Ww, Ds, Ds, Ds, Ds, Gg, Ds, Ds, Ds, Ds, Ds, Ds, Ds, Ds, Ds, Ds, Ds, Ds, Ds, Ds, Ww, Ww, Ww, Ww, Ww, Ds, Ds, Ds, Ds, Ds, Ds, Ds, Ds, Ds, Ww, Ww, Ww, Ww, Ww, Ww, Ww, Ww, Ww, Ww
Ww, Ww, Ww, Ww, Ww, Ww, Ww, Ds, Ww, Ww, Ww, Ds, Ww, Ww, Ww, Ww, Ww, Ww, Ww, Ww, Ww, Ww, Wo, Ww, Wo, Wo, Wo, Ww, Ww, Ww, Ww, Ww, Ww, Ww, Ww, Ww, Wo, Ww, Wo, Ww, Wo, Wo, Wo, Wo, Wo, Wo
Wo, Wo, Wo, Wo, Wo, Wo, Wo, Ww, Wo, Wo, Wo, Ww, Wo, Wo, Wo, Wo, Wo, Ww, Wo, Wo, Wo, Wo, Wo, Wo, Wo, Wo, Wo, Ww, Ww, Ww, Ww, Ww, Ww, Ww, Wo, Wo, Wo, Wo, Wo, Wo, Wo, Wo, Wo, Wo, Wo, Wo
Wo, Wo, Wo, Wo, Wo, Wo, Wo, Wo, Wo, Wo, Wo, Wo, Wo, Wo, Wo, Wo, Wo, Wo, Wo, Wo, Wo, Wo, Wo, Wo, Wo, Wo, Wo, Wo, Ww, Ww, Ww, Ww, Ww, Ww, Wo, Wo, Wo, Wo, Wo, Wo, Wo, Wo, Ww, Wo, Wo, Wo
Wo, Wo, Wo, Wo, Wo, Wo, Wo, Wo, Wo, Wo, Wo, Wo, Wo, Wo, Wo, Wo, Wo, Wo, Wo, Wo, Wo, Wo, Wo, Wo, Wo, Wo, Wo, Wo, Ww, Ww, Ww, Ww, Ww, Ww, Wo, Wo, Wo, Wo, Wo, Wo, Ww, Ww, Ds, Ww, Ww, Ww
Wo, Wo, Wo, Wo, Wo, Wo, Wo, Wo, Wo, Wo, Wo, Wo, Wo, Wo, Wo, Wo, Wo, Wo, Wo, Wo, Wo, Wo, Wo, Wo, Ww, Ww, Ww, Ww, Ww, Ww, Ww, Ww, Ww, Ww, Wo, Wo, Wo, Wo, Wo, Wo, Ww, Ds, Gd, Ds, Ds, Ds
Wo, Wo, Wo, Wo, Wo, Wo, Wo, Wo, Wo, Wo, Wo, Wo, Wo, Wo, Wo, Wo, Wo, Wo, Wo, Wo, Wo, Wo, Wo, Ww, Ds, Ds, Ds, Ww, Ww, Ww, Ww, Ww, Ww, Wo, Wo, Wo, Wo, Wo, Wo, Wo, Ww, Gs^Vh, Gs, Gd^Fp, Gs^Fp, Gs^Fp
Wo, Wo, Wo, Wo, Wo, Wo, Wo, Wo, Wo, Wo, Wo, Wo, Wo, Wo, Wo, Wo, Wo, Wo, Wo, Wo, Wo, Wo, Wo, Ww, Ww, Ds^Vh, Ds, Ds, Ww, Ww, Ww, Ww, Ww, Wo, Wo, Wo, Wo, Wo, Wo, Wo, Wo, Ww, Ww, Ww, Ww, Ww
Wo, Wo, Wo, Wo, Wo, Wo, Wo, Wo, Wo, Wo, Wo, Wo, Wo, Wo, Wo, Wo, Wo, Wo, Wo, Wo, Wo, Wo, Wo, Ww, Ww, Ds, Ds, Ww, Ww, Ww, Ww, Ww, Ww, Ww, Wo, Wo, Wo, Wo, Wo, Wo, Wo, Wo, Wo, Wo, Wo, Wo
Wo, Wo, Wo, Wo, Wo, Wo, Wo, Wo, Wo, Wo, Wo, Wo, Wo, Wo, Wo, Wo, Wo, Wo, Wo, Wo, Wo, Wo, Wo, Wo, Wo, Ww, Ww, Ww, Ww, Ww, Ww, Ww, Ww, Ww, Wo, Wo, Wo, Wo, Wo, Wo, Wo, Wo, Wo, Wo, Wo, Wo
Wo, Wo, Wo, Wo, Wo, Wo, Wo, Wo, Wo, Wo, Wo, Wo, Wo, Wo, Wo, Wo, Wo, Wo, Wo, Wo, Wo, Wo, Wo, Wo, Wo, Wo, Ww, Ww, Ww, Ww, Ww, Ww, Ww, Ww, Ww, Wo, Ww, Wo, Wo, Wo, Wo, Wo, Wo, Wo, Wo, Wo
Wo, Wo, Wo, Wo, Wo, Wo, Wo, Wo, Wo, Wo, Wo, Wo, Wo, Wo, Wo, Wo, Wo, Wo, Ww, Wo, Ww, Wo, Wo, Wo, Wo, Wo, Ww, Ww, Ww, Ww, Ww, Ww, Ww, Ww, Ww, Ww, Ww, Ww, Ww, Ww, Ww, Ww, Ww, Ww, Ww, Ww
Wo, Wo, Ww, Wo, Ww, Wo, Ww, Wo, Ww, Wo, Ww, Wo, Ww, Wo, Ww, Ww, Ww, Ww, Ww, Ww, Ww, Ww, Ww, Ww, Ww, Ww, Ds, Ww, Ds, Ds, Ds, Ww, Ds, Ds, Ds, Ds, Ds, Ww, Ww, Ww, Ds, Ds, Ds, Ww, Ww, Ww
Ww, Ww, Ww, Ww, Ww, Ww, Ww, Ww, Ds, Ww, Ds, Ww, Ds, Ww, Ds, Ww, Ds, Ww, Ds, Ds, Ds, Ds, Ds, Ww, Ds, Ds, Gg, Ds, Gg^Es, Ds, Rd, Ds, Rd, Gg^Es, Gg, Gg, Ds, Ww, Ww, Ww, Ds, Gg, Gg, Ds, Ds, Ds
Ds, Ds, Ds, Ww, Ds, Ds, Ds, Ds, Ds, Ds, Ds, Ds, Gg, Ds, Gg, Ds, Gg, Ds, Gg, Gg, Re, Gg^Vh, Gg, Ds, Gg, Gg, Gg, Gg, Gg, Gg^Es, Re, Rd, Re, Gs^Es, Gs, Gg^Vh, Gg, Ds, Ce, Ds, Gs, Gg, Gg, Gg, Gg, Gg
Ds, Ds, Ds, Ds, Re, Gg, Gg, Gg, Gg, Gg, Gg, Gg, Gg, Gg, Re^Gvs, Gg, Gg, Gg, Re^Gvs, Re^Gvs, Re^Gvs, Gg, Gg, Gg, Gg, Gg, Gg, Gg, Gg, Gg, Gs, Re, Re, Re, Gs, Gg, Re, Ce, Ce, Ce, Re, Gg, Gg, Gg, Gg, Gg
Gg, Gg, Gg, Gs, Ce, Ce, Ce, Gs, Gg, Gg^Vh, Gg, Gg, Re, Re^Gvs, Re^Gvs, Re, Re, Re^Gvs, Re^Gvs, Re^Gvs, Gg, Gg, Gg, Gs, Gg, Gg, Gs, Gg, Gg, Gs^Vh, Gs, Re, Re, Re, Gs, Gs, Re, Ce, 1 Ke, Ce, Gs, Gs, Gs^Vh, Gs, Gs, Gg
Gg, Gg, Gs, Re, Ce, 2 Ke, Ce, Re, Gs, Gg, Gg, Gg, Gg, Re^Gvs, Re^Gvs, Re^Gvs, Gg, Re, Gg, Gg, Gs, Gg, Gs, Gg, Gg, Gs, Gg, Gs, Gs, Gs, Gg, Gs, Re, Re, Gs, Gs, Re, Ce, Ce, Re, Gs, Gg, Gg, Gs, Gs, Gs
Gg, Gg, Gs, Gs, Gs, Re, Re, Re, Gs, Gg, Gs, Gg, Gg, Gg, Gg, Gg, Re, Gg, Re, Re, Re, Gg, Gs, Gg, Gs, Gg, Gs, Gg, Gs, Gs, Gs, Gs, Re, Re, Gs, Gs, Gs, Re, Gs, Gs, Gs, Gs, Gs, Gs, Gg, Gs
Gg, Gg, Gs, Gg, Gs, Gs, Gs, Gs, Gs, Gs, Gs, Gg, Re, Re, Re, Re, Gs, Re, Gs, Gs, Gs, Re, Re, Re, Re, Gs, Gs, Gs, Re, Gs, Re, Re, Re, Re, Re, Gs, Gs, Gs, Gs, Gs, Gg, Gs, Gs, Gg, Gg, Gs
Gs, Gg, Re, Re, Re, Re, Re, Re, Re, Re, Re, Re, Gs, Gs, Re, Gs, Gs, Gs, Gll^Fmf, Gll^Fmf, Gll^Fmf, Gll^Fmf, Gll^Fmf, Gs, Gs, Re, Re, Re, Gs, Re, Gs, Gs, Gs, Re, Re, Gs, Gs, Gs, Gs, Gg, Gg, Gg, Gs, Gg, Gs, Gs
Re, Re, Gg, Gg, Gg, Gg, Gg, Gg, Gg, Gg, Gs, Gs, Re^Gvs, Re^Gvs, Re, Gs, Gs, Gll, Gll^Fmf, Gll^Fmf, Gs, Gll^Fmf, Gll^Fmf, Gll, Gg, Gs, Gs, Gs, Gg, Gs, Gs, Gs, Gs, Re, Re, Gs, Gs, Gs, Gg, Gs, Gs, Gs, Gg, Gs, Gg, Gs
Gs, Gg, Gs, Gg, Gg, Gs^Vh, Gg, Gg, Gs, Gs, Re, Re^Gvs, Re^Gvs, Re^Gvs, Gs, Re^Vh, Gs, Gg, Gs, Gs, Gs, Gs, Re^Vh, Gs, Gg, Gs, Gs, Gg, Gs, Gs, Gs, Gs, Gs, Re, Re, Re, Gs, Gs, Gg, Gg, Gg, Gs, Gg, Gg, Gs, Gs
Gs, Gs, Gs, Gs, Gg, Gg, Gs, Gs, Gg, Gs, Gs, Re, Gs, Gs, Gs, Gg, Gg, Gs, Gs, Gs, Gs, Gg, Gs, Gg, Gs, Gs, Gs, Gg, Gg, Gs, Gs, Gg, Gs, Gs, Re, Re, Gs, Gg, Gs, Gs, Gg, Gs, Gs, Gs, Gs, Gs
Gs, Gs, Gs, Gs, Gs, Gs, Gs, Gs, Gs, Gs, Gs, Gs, Gs, Gs, Gs, Gs, Gs, Gs, Gs, Gs, Gs, Gs, Gs, Gg, Gg, Gs, Gs, Gs, Gs, Gs, Gs, Gs, Gs, Gs, Re, Re, Gs, Gs, Gs, Gs, Gs, Gs, Gg, Gs, Gs, Gs
Gs, Gs, Gs, Gs, Gs, Gs, Gs, Gs, Gs, Gs, Gs, Gs, Gs, Gs, Gs, Gs, Gs, Gs, Gs, Gs, Gs, Gs, Gs, Gs, Gs, Gs, Gs, Gs, Gs, Gs, Gs, Gs, Gs, Gs, Re, Re, Gs, Gs, Gs, Gs, Gs, Gs, Gs, Gs, Gs, Gs
