Xu, Xu, Xu, Xu, Xu, Xu, Xu, Xu, Xu, Xu, Xu, Xu, Xu, Xu, Xu, Xu, Xuc, Xu, Xu, Xu, Xu, Xu, Xu, Xu, Xu, Xu, Xu, Xu, Xu, Xu, Xu, Xu, Xu, Xu, Xu, Xu, Xu, Xu, Xu, Xu
Xu, Xu, Xu, Xu, Xu, Xu, Xu, Xu, Xu, Xu, Xu, Xu, Xu, Xu, Xuc, Xuc, Xuc, Xu, Xu, Xu, Xu, Xu, Xu, Xu, Xu, Xu, Xu, Xu, Xu, Xu, Xu, Xu, Xu, Xu, Xu, Xu, Xu, Xu, Xu, Xu
Xu, Xu, Xu, Xu, Xu, Xu, Xu, Xu, Xu, Xu, Xu, Xu, Xu, Xuc, Cud, 2 Kud, Cud, Xuc, Xuc, Xu, Xu, Xu, Xu, Xu, Xu, Xu, Xu, Xu, Xu, Xu, Xu, Xu, Xu, Xu, Xu, Xu, Xu, Xu, Xu, Xu
Xu, Xu, Xu, Xu, Xu, Xu, Xu, Xu, Xu, Xu, Xu, Xu, Xu, Xuc, Cud, Cud, Cud, Uu^Uf, Uu^Vud, Xuc, Xuc, Xu, Xu, Xu, Xu, Xu, Xu, Xu, Xu, Xu, Xu, Xu, Xu, Xu, Xu, Xu, Xu, Xu, Xu, Xu
Xu, Xu, Xu, Xu, Xu, Xu, Xu, Xu, Xu, Xu, Xu, Xu, Xu, Xuc, Uu, Rr, Rr, Rr, Uu, Uh, Xuc, Xu, Xu, Xu, Xu, Uh, Uh^Ii, Uu^Uf, Uh^Em, Xu, Xu, Xu, Xu, Xu, Xu, Xu, Xu, Xu, Xu, Xu
Xu, Xu, Xu, Uh, Uh, Uu^Vud, Xu, Xu, Xu, Xu, Xu, Xu, Xuc, Xuc, Uh, Rr, Uu^Ii, Uu, Uu^Uf, Uh, Xuc, Xu, Xu, Xu, Xu, Uh, Uu, Uu^Ii, Uu, Uu^Em, Uu^Uf, Xu, Xu, Xu, Xu, Xu, Xu, Xu, Xu, Xu
Xu, Xu, Uu^Uf, Uh, Uh^Ii, Uu, Xu, Xu, Xu, Xu, Xu, Xuc, Uu^Vud, Uu^Uf, Rr, Qxu, Uu^Ii, Uu^Em, Xuc, Xuc, Xu, Xu, Xu, Uu^Uf, Uh^Em, Rb^Em, Uu^Ii, Uu, Uh, Uu, Uu^Ii, Xu, Xu, Xu, Xu, Xu, Xu, Xu, Xu, Xu
Xu, Xu, Uh, Uh^Ii, Qxu, Uu, Uu^Uf, Xu, Xu, Xu, Xu, Xuc, Xuc, Rr, Rr, Qxu, Uu, Uu^Uf, Xuc, Xu, Xu, Xu, Xu, Xu, Uu, Rb^Uf, Uh^Ii, Xu, Xu, Rb^Em, Rb^Uf, Uh^Ii, Xu, Xu, Xu, Xu, Xu, Xu, Xu, Xu
Xu, Xu, Uu^Uf, Qxu, Qxu, Uu, Uu, Xu, Xu, Xu, Xuc, Xuc, Uu^Uf, Rr, Qxu, Re^Uf, Uu, Xuc, Xu, Xu, Xu, Xu, Xu, Uh, Rb, Uu, Xu, Xu, Xu, Uh, Rb^Uf, Uu^Ii, Xu, Xu, Xu, Xu, Xu, Xu, Xu, Xu
Xu, Xu, Uu^Uf, Uu^Vu, Ql, Qxu, Uu^Ii, Uu^Em, Uu^Uf, Xu, Xuc, Uu^Vud, Uh, Rr, Qxu, Uu, Uu^Uf, Uh, Xu, Xu, Xu, Xu, Uu^Vud, Uu, Rb, Uu, Xu, Xu, Xu, Uu^Uf, Uh, Uu, Uu, Uu^Uf, Uh, Xu, Xu, Xu, Xu, Xu
Xu, Xu, Uu, Ql, Ql, Ql, Uh^Ii, Uu, Uu^Vu, Xu, Xu, Rr, Rr, Qxu, Uu, Uu, Uu, Uh, Xu, Xu, Xu, Xu, Uu, Rb^Uf, Uu^Ii, Xu, Xu, Xu, Xu, Xu, Uu, Rb, Uu, Uh, Uu^Uf, Xu, Xu, Xu, Xu, Xu
Xu, Xu, Uu, Uu^Ii, Uh^Ii, Ql, Uu^Ii, Uh, Xu, Xu, Xu, Xu, Rr, Uu, Rr, Rr, Rr, Uu, Uu, Xu, Uu^Ii, Uu, Rb^Uf, Uu^Em, Xu, Xu, Xu, Xu, Xu, Xu, Uu^Vu, Uu, Rb, Uu, Cud, Cud, Uu, Uh, Uh^Ii, Uh^Ii
Xu, Xu, Uu, Uh, Ql, Ql, Uh^Ii, Xu, Xu, Xu, Uu^Vud, Uu^Uf, Uh^Ii, Rr, Qxu, Qxu, Qxu, Rr, Rr, Uu^Ii, Uh^Ii, Rb, Uu, Uu^Em, Xu, Xu, Xu, Xu, Xu, Xu, Uh, Uu, Rr, Cud, 1 Kud, Cud, Rb, Rb, Rb, Rb
Xu, Xu, Cud, Uu, Uu, Ql, Uh^Ii, Xu, Xu, Xu, Uu, Uh, Rr, Rr, Qxu, Qxu, Qxu, Rr, Rr, Re^Uf, Uh, Xu, Uu^Uf, Uu, Xu, Xu, Xuc, Xuc, Xu, Xuc, Xuc, Uh, Rr, Re^Uf, Cud, Cud, Uu, Uu^Ii, Uu^Uf, Uu^Uf
Xu, Xu, Cud, Cud, Cud, Re, Uh, Xu, Xu, Xu, Xu, Uu, Rr, Rr, Rr, Qxu, Rr, Rr, Uu, Uu^Uf, Xu, Xu, Uh, Uu, Xu, Xu, Xuc, Cud, Cud, Uu^Em, Uu, Rr, Uu, Uu, Uu, Xu, Xu, Xu, Xu, Xu
Xu, Xu, Cud, 3 Kud, Cud, Uu, Re, Uu^Uf, Xu, Xu, Xu, Uu, Uu, Uh, Rr, Rr, Rr, Rr, Uu, Xu, Xu, Xu, Xu, Uu, Uh, Xu, Xu, Cud, Rr, Rr, Uu, Uu, Uh, Uu^Uf, Uh^Em, Xu, Xu, Xu, Xu, Xu
Xu, Xu, Xu, Xu, Xu, Uh, Re, Uu, Xu, Xu, Cud, Re, Uu, Xu, Uh, Uh^Ii, Uu^Ii, Uu^Ii, Xu, Xu, Xu, Xu, Xu, Uu, Uu, Xu, Uu^Vud, Uu, Xu, Xu, Uh, Uu, Uu, Uh, Xu, Xu, Xu, Xu, Xu, Xu
Xu, Xu, Xu, Xu, Xu, Xu, Uu^Uf, Re, Cud, Cud, Cud, Re, Uh^Ii, Xu, Xu, Xu, Xu, Uu, Uu^Uf, Xu, Xu, Xu, Xu, Uu^Uf, Uu, Xu, Xu, Rr, Uu^Uf, Xu, Xu, Uu^Vud, Uh, Xu, Xu, Xu, Xu, Xu, Xu, Xu
Xu, Xu, Xu, Xu, Xu, Xu, Uu, Uu, Uu, Uu, Re, Uu, Xu, Xu, Xu, Xu, Uu^Uf, Uu, Xu, Xu, Xu, Xu, Xu, Uh, Uu^Uf, Xu, Uu, Rr, Xu, Xu, Xu, Xu, Xu, Xu, Xu, Xu, Xu, Xu, Xu, Xu
Xu, Xu, Xu, Xu, Xu, Xu, Xu, Cud, Uh, Uu, Uu^Uf, Uh, Xu, Xu, Xu, Xu, Xu, Uu, Uh, Xu, Xu, Xu, Xu, Uu, Uh, Xu, Xu, Uu, Uu, Xu, Xu, Xu, Xu, Xu, Xu, Xu, Xu, Xu, Xu, Xu
Xu, Xu, Xue, Xue, Xue, Xu, Xu, Uu^Uf, Uu, Uu^Uf, Xu, Xu, Xu, Xu, Xu, Uh^Ii, Uu^Ii, Uu, Uu, Xu, Uu, Uh, Uu, Uu, Xu, Xu, Xu, Rr, Uu, Xu, Xu, Xu, Xu, Xu, Xu, Xu, Xu, Xu, Xu, Xu
Xu, Xue, Ds, Ds, Ds, Xue, Xu, Xu, Uu^Vud, Uh, Xu, Xu, Xu, Xu, Xu, Uu^Ii, Uh^Ii, Rr, Uu^Ii, Uu, Rr, Rr, Rr, Uu, Uu, Uu^Uf, Xu, Xu, Uu, Uu^Uf, Uu^Vu, Xu, Xu, Xu, Xu, Xu, Xu, Xu, Xu, Xu
Xu, Xue, Ds, Wog, Wog, Xue, Xue, Xue, Xue, Xu, Xu, Xu, Xu, Wog, Wwg, Wwg, Rr, Uu^Ii, Uh^Ii, Uh^Ii, Uu^Ii, Xu, Xu, Uu^Uf, Uh, Rr, Uu, Rr, Uu, Uu, Xu, Xu, Xu, Xu, Xu, Xu, Xu, Xu, Xu, Xu
Xu, Xue, Ds, Wog, Xue, Wog, Wog, Wog, Xue, Xu, Xu, Xu, Wog, Wog, Wwg, Wwg, Wwg, Uh^Ii, Uu^Ii, Xu, Xu, Xu, Xu, Xu, Xu, Uu, Uu, Rr, Uu^Uf, Uu, Uu^Uf, Xu, Xu, Xu, Xu, Xu, Xu, Xu, Xu, Xu
Xu, Xue, Xue, Wwg, Xue, Xue, Xue, Xue, Xu, Xu, Xu, Wog, Wwg, Wwg, Wwg, Wwg, Xu, Uu^Vud, Xu, Xu, Xu, Xu, Xu, Xu, Xu, Xu, Rr, Uu, Uh, Uh, Uu^Uf, Xu, Xu, Xu, Xu, Xu, Xu, Xu, Xu, Xu
Xu, Xu, Xu, Xue, Xu, Xu, Xu, Xu, Xu, Uh, Uu^Ii, Uu^Ii, Wwg, Wwg, Wwg, Wwg, Wwg, Xu, Xu, Xu, Xu, Xu, Xu, Xu, Xu, Xu, Xu, Uh, Uh, Uh, Uh, Xu, Xu, Xu, Xu, Xu, Xu, Xu, Xu, Xu
Xu, Xu, Xu, Xu, Xu, Xu, Xu, Xu, Uu, Uu^Vu, Uu, Xu, Wog, Wog, Xu, Xu, Xu, Xu, Xu, Xu, Xu, Xu, Xu, Xu, Xu, Uh, Xu, Xu, Xu, Xu, Xu, Xu, Xu, Xu, Xu, Xu, Xu, Xu, Xu, Xu
Xu, Xu, Xu, Xu, Xu, Xu, Xu, Uu^Vu, Rr, Rr, Uu^Uf, Uu^Ii, Xu, Xu, Xu, Xu, Uu^Uf, Uh^Em, Uu^Em, Uu^Uf, Uh, Xu, Uu, Uu^Uf, Uu, Rr, Uu^Uf, Uh, Xu, Xu, Xu, Xu, Xu, Xu, Xu, Xu, Xu, Xu, Xu, Xu
Xu, Xu, Xu, Xu, Xu, Xu, Xu, Uh, Rr^Em, Rr, Rr, Xu, Xu, Xu, Xu, Xu, Uh, Uu^Uf, Uh, Uu, Uu, Uu, Cud, Cud, Rr, Uu^Uf, Xu, Xu, Xu, Xu, Xu, Xu, Xu, Xu, Xu, Xu, Xu, Xu, Xu, Xu
Xu, Xu, Xu, Xu, Xu, Xu, Xu, Xu, Uu^Vu, Uu^Uf, Re^Uf, Uu^Vu, Xu, Xu, Xu, Xu, Xu, Xu, Xu, Xu, Uu^Uf, Cud, Cud, 4 Kud, Cud, Cud, Xu, Xu, Xu, Xu, Xu, Xu, Xu, Xu, Xu, Xu, Xu, Xu, Xu, Xu
Xu, Xu, Xu, Xu, Xu, Xu, Xu, Xu, Xu, Xu, Xu, Xu, Xu, Xu, Xu, Xu, Xu, Xu, Xu, Xu, Xu, Xu, Xu, Xu, Xu, Xu, Xu, Xu, Xu, Xu, Xu, Xu, Xu, Xu, Xu, Xu, Xu, Xu, Xu, Xu
Xu, Xu, Xu, Xu, Xu, Xu, Xu, Xu, Xu, Xu, Xu, Xu, Xu, Xu, Xu, Xu, Xu, Xu, Xu, Xu, Xu, Xu, Xu, Xu, Xu, Xu, Xu, Xu, Xu, Xu, Xu, Xu, Xu, Xu, Xu, Xu, Xu, Xu, Xu, Xu
