Xu, Xu, Xu, Xu, Xu, Xu, Xu, Xu, Qxu, Qxu, Qxu, Xu, Uu, Xu, Qxu, Qxu, Qxu, Qxu, Xu, Xu, Xu
Xu, Xu, Xu, Xu, Qxu, Xu, Qxu, Uu, Qxu, Uu, Uu, Qxu^Bs/, Qxu, Xu, Qxu, Qxu, Qxu, Qxu, Xu, Xu, Xu
Xu, Xu, Qxu, Qxu, Uu^Vu, Qxu, Qxu, Uu, Qxu, Qxu, Uu, Qxu, Uu, Qxu, Uu, Qxu, Uu^Em, Qxu, Qxu, Xu, Xu
Xu, Xu, Qxu, Qxu, Qxu, Uu, Uu, Qxu, Uu, Uu, Uu, Qxu, Uu, Uu, Uu, Uu, Uu^Em, Uu^Em, Qxu, Qxu, Qxu
Xu, Xu, Qxu, Qxu, Qxu, Uu, Uu, Uu, Uu, Uu, Cte^Es, Uu, Uu, Ql, Uu, Uu, Uu, Uu, Qxu, Qxu, Uh
Xu, Xu, Qxu, Uu, Uu, Uu, Uu, Uu, Uu, Cte^Es, 3 Kte, Cte^Es, Uu, Ql, Uu, Uu^Vu, Uu, Uu, Qxu, Qxu, Uh
Qxu, Qxu, Qxu, Uu, Uu^Em, Uu, Qxu, Qxu, Uu, Cte^Edb, Cte^Edt, Cte^Es, Uu, Ql, Uu, Uu, Uu, Uu, Uh, Uh, Uh
Qxu, Qxu, Qxu, Uu, Uu, Uu, Qxu, Uu, Uu, Uu, Uu, Uu, Uu, Uu, Qxu, Qxu, Uu, Uu, Uu, Xu, Xu
Uh, Uh, Qxu, Qxu, Uu, Qxu, Uu, Uu, Ql, Uu, Ql, Ql, Ql, Uu, Qxu, Qxu, Uu, Uu, Uu, Xu, Xu
Xu, Xu, Uu^Em, Uu, Uu^Vu, Uu, Uu, Ql, Qxu, Ql, Qxu, Ql, Ql, Uu, Uu, Qxu^Bs/, Uu, Uu^Vu, Uu, Xu, Xu
Xu, Xu, Uh, Uu, Uu, Xu, Uu, Ql, Qxu, Qxu, Qxu, Qxu, Ql, Uu, Uu, Qxu, Uu, Uu, Uu, Xu, Xu
Qxu, Xu, Uu, Uu, Uu, Xu, Uu, Uu, Uu, Qxu, Qxu, Qxu, Ql, Uu, Qxu, Qxu, Uu, Uu, Qxu, Qxu, Qxu
Qxu, Qxu, Qxu, Uu, Qxu, Uu, Qxu, Uu, Qxu, Uu, Uu, Ql, Uu, Uu, Qxu, Uu, Uu, Uu, Uu, Qxu, Qxu
Qxu, Qxu, Qxu, Uu, Uu, Qxu, Qxu, Qxu, Uu, Qxu, Qxu, Uu, Uu, Uu, Uu, Uu, Uu^Vu, Uu, Uu, Qxu, Qxu
Qxu, Qxu, Qxu, Uu, Uu, Uu, Uu, Uu, Uu, Uu, Qxu, Qxu, Qxu, Uu, Uu, Uu, Uu, Uu, Uu, Qxu, Qxu
Qxu, Qxu, Qxu, Uu, Uu, Uu, Uu, Uu, Uu, Uu, Uu, Qxu, Qxu, Uu, Uh, Uh, Uh, Uu, Uu, Qxu, Qxu
Uh, Qxu, Uu, Uu, Uu, Uu, Uu, Uu, Cud, Uu, Uu, Uu, Uu, Uu, Uu, Uh, Uh, Uu^Em, Qxu, Qxu, Qxu
Uh, Uh, Uu, Uu, Uu, Uu, Uu, Cud, 1 Kud, Cud, Uu, Uu, Cud, Uu, Uu, Uu, Uh, Uu, Qxu, Qxu, Qxu
Xu, Uh, Xu, Uh, Uu, Uu, Uu, Cud, Uu, Uu, Uu, Cud, 2 Kud, Cud, Uu, Uu, Uu, Uu, Uu, Qxu, Xu
Xu, Xu, Xu, Uh, Uh, Uu, Uu, Uu, Uu, Uu, Uu, Cud, Xu, Uu, Uu, Uu, Xu, Uu, Uu^Em, Xu, Xu
Xu, Xu, Xu, Xu, Xu, Xu, Xu, Uh, Uu, Uh, Xu, Xu, Xu, Xu, Uu, Xu, Xu, Xu, Xu, Xu, Xu
Xu, Xu, Xu, Xu, Xu, Xu, Xu, Uh, Uu, Uh, Xu, Xu, Xu, Xu, Xu, Uu, Uu, Xu, Xu, Xu, Xu
