Ms, Ms, Ms, Ms, Ms, Ms, Ms, Ms, Ms, Ms, Ms, Ms, Aa, Aa, Aa^Fpa, Aa^Fpa, Aa^Fma, Aa^Fpa, Aa^Fpa, Aa, Aa, Aa, Ms, Ms, Aa, Aa, Aa, Aa, Ms, Ms, Ms, Ms, Ms
Ms, Ms, Ms, Ms, Ms, Ms, Ms, Ms, Ms, Ms, Ms, Ms, Ha^Fma, Ha^Fpa, Aa, Aa^Fpa, Aa^Fma, Aa^Fpa, Aa, Aa, Aa, Aa, Ms, Ms, Aa, Aa, Aa, Aa, Ms, Ms, Ms, Ms, Ms
Ms, Ms, Ms, Ms, Ms, Ms, Ha, Ha, Aa, Ms, Ms, Aa, Aa^Fpa, Ha^Fpa, Aa, Aa, Aa, Aa, Aa, Aa, Aa, Aa, Ha^Voa, Aa, Aa, Aa, Aa, Aa, Aa, Aa, Aa, Ms, Ms
Ms, Ms, Ms, Ms, Ms, Ms, Ms, Aa, Aa, Ha, Ha, Aa, Aa^Fpa, Aa^Fpa, Aa, Aa, Aa, Aa, Aa, Aa, Aa, Aa, Aa, Aa, Aa, Aa, Aa, Aa, Aa, Aa, Aa, Ms, Ms
Ms, Ms, Ms, Ms, Aa, Aa, Aa, Aa, Aa, Aa, Ha^Fpa, Ha^Fma, Ha^Fpa, Aa, Aa, Aa, Aa, Aa, Aa, Aa, Aa, Aa, Aa, Aa, Coa, Aa, Aa, Aa, Aa, Aa, Aa, Aa, Aa
Ms, Ms, Ms, Ms, Aa, Aa, Aa, Aa, Aa, Aa, Ha, Ha^Fpa, Ha, Aa, Aa, Aa, Aa, Aa, Aa, Aa, Aa, Aa, Aa, Coa, 2 Koa, Coa, Aa, Aa, Aa, Aa, Aa, Aa, Aa
Aa, Aa, Aa, Aa, Aa, Aa, Aa, Aa, Aa, Aa, Aa, Ha^Voa, Aa, Aa, Aa, Aa, Aa, Aa, Aa, Aa, Aa, Aa, Aa, Coa, Coa, Coa, Aa, Aa, Ha, Aa, Aa, Aa, Aa
Aa, Aa, Aa, Aa, Aa, Aa, Aa, Aa, Aa, Aa, Aa, Aa, Aa, Aa, Aa, Aa, Aa, Aa, Aa, Aa^Fpa, Aa^Fpa, Aa, Aa, Aa^Voa, Aa, Aa, Aa, Aa, Ha, Ha, Ha^Fpa, Aa, Aa
Aa, Aa, Aa, Aa, Aa, Aa, Aa, Aa, Aa, Aa, Aa, Aa, Aa, Aa, Aa, Aa, Aa, Aa, Aa, Aa^Fma, Aa^Fpa, Aa^Fpa, Aa, Aa, Aa, Aa, Aa, Aa, Aa^Fpa, Aa^Fpa, Aa^Fpa, Ha^Fpa, Ha^Fpa
Aa, Aa, Aa, Aa, Aa, Aa, Aa, Aa, Aa, Aa, Aa, Aa, Aa, Aa, Aa, Aa, Aa, Aa, Aa^Fpa, Aa, Aa, Aa^Fpa, Aa, Aa, Aa, Aa, Aa, Ha^Fpa, Aa^Vea, Aa^Fet, Aa^Fpa, Ha, Ha
Aa, Aa, Aa, Aa, Aa, Aa, Aa, Aa, Aa, Aa, Aa, Aa, Aa, Aa, Aa, Aa, Aa, Aa, Aa^Voa, Aa^Fpa, Aa, Aa, Aa, Aa, Aa, Aa, Ha, Ha^Fpa, Aa^Fpa, Aa^Fpa, Ms, Ms, Ms
Aa, Aa, Aa, Aa, Aa, Aa, Aa, Aa, Aa, Aa, Aa, Aa, Aa, Aa, Aa, Aa, Aa, Aa, Aa, Aa, Aa, Aa, Aa, Aa, Ms, Ms, Ms, Aa^Fpa, Ms, Ms, Ms, Ms, Ms
Aa, Aa, Aa, Aa, Aa, Aa, Aa, Aa, Aa, Aa, Aa, Aa, Aa, Aa, Aa, Aa, Aa, Aa, Ha, Aa, Aa, Aa, Aa, Aa, Aa, Ms, Aa, Ms, Ms, Ms, Aa, Ms, Ms
Aa, Aa, Aa, Aa, Aa, Aa, Aa, Aa, Aa, Aa, Aa, Aa, Aa, Aa, Aa, Aa, Aa, Aa, Ha^Fpa, Aa, Aa, Aa, Aa, Aa, Aa, Ms, Aa, Aa, Ha^Fpa, Ms, Aa, Aa, Aa
Aa, Aa, Aa, Aa, Aa, Aa, Aa^Voa, Aa, Aa, Aa, Aa, Aa, Aa, Aa, Aa, Aa, Aa, Aa, Aa^Fpa, Aa, Aa, Aa, Aa, Aa, Aa, Aa, Aa, Aa^Fpa, Ha^Fpa, Ha, Aa, Aa, Aa
Aa, Aa, Aa, Aa, Ha, Ha, Ha, Aa, Aa, Aa, Aa, Aa, Aa, Aa, Aa, Aa, Aa, Aa, Aa, Aa^Fpa, Aa, Aa, Aa, Aa, Aa, Aa, Aa, Aa^Fpa, Ms, Aa^Fpa, Aa, Aa, Aa
Aa, Aa, Aa, Ms, Ms, Ha, Ha, Aa, Aa, Aa, Aa, Aa, Aa, Aa, Aa^Fpa, Ha, Aa, Aa, Aa, Ha, Aa^Fpa, Aa, Aa^Voa, Aa, Aa, Aa, Aa, Ms, Ms, Aa, Aa, Aa, Aa
Aa, Aa, Aa, Aa, Ms, Ms, Ms, Aa, Aa, Aa, Aa, Aa, Aa, Aa, Aa^Fpa, Ha^Fpa, Ha, Aa, Ha, Ha, Aa, Aa, Aa, Aa, Aa, Aa, Aa, Aa, Aa, Aa, Aa, Aa, Aa
Aa, Aa, Aa, Aa, Ha, Ms, Ms, Aa, Aa, Aa, Aa, Aa, Aa, Aa, Aa, Ha, Aa^Fpa, Ha, Aa, Aa, Aa, Aa, Aa, Aa, Aa, Aa, Aa, Aa, Aa, Aa, Aa, Aa, Aa
Aa, Aa, Ms, Ha, Ms, Ms, Ms, Aa, Aa, Aa, Aa, Aa, Aa, Aa, Aa, Aa^Fpa, Aa, Ha^Fpa, Aa, Aa, Aa, Aa, Aa, Aa, Aa, Aa, Aa, Aa, Aa, Aa, Aa, Aa, Aa
Aa, Aa, Aa, Ha, Ms, Ms, Aa, Aa, Aa, Aa, Aa, Aa, Aa, Aa^Voa, Aa, Aa, Aa, Aa, Aa, Aa, Aa, Aa, Aa, Aa, Aa, Aa, Aa, Aa, Aa, Aa, Aa, Aa, Aa
Aa, Aa, Aa, Ha, Ms, Aa, Ha, Aa, Aa, Aa, Aa, Aa, Aa, Aa, Aa, Aa, Aa, Aa, Aa, Aa, Aa, Aa, Aa, Aa, Aa, Aa, Aa, Aa, Aa, Aa, Aa, Aa, Aa
Aa, Aa, Ha, Ms, Aa, Aa, Ms, Ms, Ha, Aa, Aa, Aa, Aa, Aa, Aa, Aa, Aa, Aa, Aa, Aa, Aa, Aa, Aa, Aa, Aa, Aa, Aa, Aa, Aa, Aa, Aa, Aa, Aa
Ms, Ms, Ms, Ms, Aa, Ms, Ha, Ha, Aa, Aa, Aa, Aa, Aa, Aa, Aa, Aa, Aa, Aa, Aa, Aa^Voa, Aa, Aa, Aa, Aa, Aa, Aa, Aa, Aa, Aa, Aa, Ha, Ha, Ha
Ms, Ms, Ha, Aa, Ms, Aa, Aa, Aa^Voa, Aa, Aa, Aa, Aa, Aa, Aa, Aa, Aa, Aa, Aa, Aa^Fda, Aa^Fda, Aa^Fma, Aa, Ha^Fda, Aa, Aa, Aa, Aa, Aa, Aa, Ha, Aa, Aa, Aa
Ha, Ha, Ms, Ms, Ms, Ha, Ha, Ha, Ha, Aa, Aa, Aa, Aa, Aa, Aa, Aa, Aa^Fda, Ha, Ha, Ha, Ha, Ha^Fda, Aa^Fda, Aa^Fda, Aa, Aa, Aa, Aa, Aa, Ha, Ha, Ha, Ha
Ms, Ms, Ms, Ms, Ms, Ms, Ms, Ms, Aa^Fpa, Ha, Aa, Aa, Aa, Aa, Aa, Aa^Fda, Ha^Fda, Aa^Fda, Ha, Ha, Aa, Ha, Ha, Aa^Fda, Aa, Aa, Aa, Aa, Ha, Ha, Ha, Ha, Ha
Ms, Ms, Ms, Ms, Ms, Ms, Ms, Aa^Fpa, Aa^Fpa, Aa, Ha, Aa, Aa, Aa, Aa, Aa^Fda, Ha, Ha, Aa, Aa, Aa, Aa, Aa, Aa, Aa, Aa, Aa, Ha, Ms, Ms, Ha, Ha, Ha
Ms, Ms, Ms, Ha, Ha, Ms, Ms, Ms, Ms, Ms, Ha, Aa, Aa, Aa, Aa, Aa, Ha, Ha, Ha, Aa, Aa, Aa, Aa, Aa, Aa, Aa, Ha, Ha, Ms, Ms, Ms, Ha, Ha
Ms, Ms, Ha, Ms, Ha^Fpa, Aa, Aa, Ms, Ha^Fma, Ha, Aa, Aa, Aa, Aa, Aa, Aa, Aa, Aa, Aa, Aa, Aa, Aa, Aa, Aa^Vca, Aa, Aa, Ha, Ms, Ms, Ms, Ms, Ms, Ms
Ms, Ms, Aa, Ha, Ms, Ha^Fpa, Aa^Fma, Aa^Fpa, Aa^Fpa, Aa, Aa, Aa, Aa, Aa, Aa, Aa, Aa, Aa, Aa, Aa, Aa, Aa, Aa, Aa, Aa, Ha^Fpa, Ha, Ms, Ms, Ms, Ms, Ms, Ms
Ms, Ms, Aa, Ms, Ha, Aa^Fpa, Aa, Aa^Fpa, Aa, Aa, Aa, Aa, Aa, Aa, Aa, Aa, Aa, Aa, Aa, Aa, Aa, Aa, Aa, Aa, Aa^Fpa, Ha^Fma, Ms, Ms, Ms, Ms, Ms, Ms, Ms
Ms, Ms, Ms, Ms, Ha, Ms, Ha, Aa^Vca, Aa, Aa, Cea, Cea, Cea, Aa, Aa, Aa, Aa, Aa, Aa, Aa, Aa, Aa, Aa, Aa, Aa, Aa^Fpa, Aa^Fpa, Ms, Ms, Ms, Aa, Ms, Ms
Ms, Ms, Ms, Ms, Ms, Ms, Ha, Aa, Aa, Aa, Cea, 1 Kea, Cea, Aa, Aa, Aa, Aa, Aa^Voa, Aa, Aa, Aa, Aa, Aa, Aa, Aa, Aa, Aa, Aa, Aa, Aa, Aa, Aa, Aa
Ms, Ms, Ms, Ms, Ms, Ha, Aa, Aa, Ha, Ha, Ha, Cea, Aa, Aa, Aa, Aa, Aa, Aa, Aa, Aa, Aa, Aa, Aa, Aa, Aa, Aa, Aa, Aa, Aa, Aa, Aa, Aa, Aa
Ha, Ha, Ha, Ms, Ha, Ha, Ha, Ha, Ms, Ms, Ms, Ha, Ha, Aa, Aa, Aa, Ha, Aa, Aa, Aa, Aa, Aa, Aa, Aa, Aa, Aa, Aa, Aa, Aa, Aa, Aa, Aa, Aa
Ha, Ha, Ha, Ha, Ha^Voa, Ha, Ms, Ms, Ms, Ms, Ms, Ms, Ha, Ha^Vca, Ha, Ha, Ms, Ms, Ms, Aa, Aa, Aa, Ha, Aa, Ha, Ha, Ms, Aa, Ha, Aa, Ms, Ms, Ms
Ms, Ms, Ms, Ha, Ha, Ha, Ms, Ms, Ms, Ms, Ms, Ms, Ms, Ha, Ha, Ms, Ms, Ms, Ms, Ms, Ms, Ms, Ms, Ha, Ms, Ms, Ms, Ms, Ms, Ms, Ms, Ms, Ms
Ms, Ms, Ms, Ms, Ms, Ms, Ms, Ms, Ms, Ms, Ms, Ms, Ms, Ms, Ms, Ms, Ms, Ms, Ms, Ms, Ms, Ms, Ms, Ms, Ms, Ms, Ms, Ms, Ms, Ms, Ms, Ms, Ms
Ms, Ms, Ms, Ms, Ms, Ms, Ms, Ms, Ms, Ms, Ms, Ms, Ms, Ms, Ms, Ms, Ms, Ms, Ms, Ms, Ms, Ms, Ms, Ms, Ms, Ms, Ms, Ms, Ms, Ms, Ms, Ms, Ms
