Gs^Fp, Gs^Fp, Gs, Gs, Gs, Ds, Ds, Ds, Ds, Ss, Ss, Ww, Ww, Ds, Ds, Ss, Ss, Ss, Ds, Ds, Ds, Gd, Gd, Ds, Ds, Ss, Ss, Ss, Ds, Gd, Gd, Ss, Ss, Ds, Ds, Ds
Gs^Fp, Gs^Fp, Gs^Vht, Gs, Gs, Ds, Ds, Ds, Ds, Ss, Ss, Ww, Ww, Ds, Ds, Ss, Ss, Ss, Ds, Ds, Ds, Gd, Gd, Ds, Ds, Ss, Ss, Ss, Ds, Gd, Gd, Ss, Ss, Ds, Ds, Ds
Ds, Ds, Ds, Gs, Gs, Ds, Gs, Ds, Gs, Gs, Gs, Ww, Ss^Vhs, Ss, Ds, Ss, Ss, Ss, Ds, Ds, Gd, Gd^Vht, Gd, Ds, Ss, Ss, Ss, Ds, Ds, Gd, Re, Ds, Ds, Ss, Ss, Ss
Ds, Ds, Ds, Ds, Ce, Ds, Gs, Gs, Gs, Gs, Gs, Ww, Gs, Gs, Ds, Ds, Ss, Ds, Ds, Ds, Gd, Gd, Gd, Ss, Ss, Ds, Ds, Gd, Ds, Re, Ds, Cer, Ds, Ss, Ss, Ss
Ds, Ds, Ss^Vhs, Ce, 1 Ke, Ce, Re, Ss^Vhs, Gs, Gs, Ww, Ww, Ds, Ds, Ds, Gs, Ds, Gs, Gd, Ss, Ss, Gd, Ds, Gd, Ss, Ss, Re, Re, Re, Cer, 2 Ker, Cer, Ss, Ss, Ss, Ss
Ds, Ds, Ce, Ce, Ss, Re, Ss, Ss, Ww, Ww, Ds, Ds, Ds, Ds, Ss, Gs, Ss, Ss, Ds, Ds, Ds, Ds, Ss, Ds, Ds, Ww^Bw/, Gd, Gd, Ds, Ds, Ds, Ds, Ss, Ds, Ss, Ss
Ds, Ds, Ds, Ds, Gs, Re, Gs, Ss, Ww, Ww, Gs, Gs^Vht, Gs, Gs, Ds, Ds, Ss, Ds, Gs, Gs, Ss, Ss, Ss, Ss, Ss, Ss, Ds, Ds, Gd, Gd^Vht, Gd, Gd, Gd, Ss, Ds, Ds
Gs, Gs, Gs, Gs^Vht, Gs, Gs, Gs, Ss, Ss, Ww, Ww, Gs, Gs, Gs, Gs, Gs, Gs, Ss, Gs, Gs, Gs, Ds, Ss, Ss, Ss, Ds, Ds, Gd, Ww, Gd, Gd, Gd, Gd, Ss, Ds, Ds
Ds, Ds, Ds, Ds, Gs^Vht, Ds, Ds, Gs, Ss, Ss, Ww, Gs, Gd, Ss, Ss, Ss, Gd, Gs, Ds, Ds, Ds, Gd, Gs, Ss, Ss, Gd, Gd, Gd, Gd, Gd, Ds, Gd, Ss, Ss, Ss, Ss
Ds, Ds, Ds, Ds, Rd, Ds, Ds, Gs, Ww, Ww, Gs, Ss, Ss, Ss, Gs, Gs, Gs, Gs, Ds, Ds, Ds, Gs, Gs, Gd, Ss, Ss, Ss, Ds, Gd, Gd, Ds, Ss, Ss, Ss, Gd, Gd
Ds, Ds, Ds, Ds, Ds, Rd, Ww^Bw\, Ww, Ww, Ss, Ss^Vhs, Ds, Ss, Ds, Gs, Ds, Ds, Ds, Ds, Gs, Gs, Gs^Fmw, Gs, Ds, Ss, Ds, Ds, Ds, Gd^Vht, Ds, Ds, Ds, Ds, Gd, Gd, Gd
Gs, Gs, Gs, Ds, Ss^Vhs, Ww, Gs, Rd, Gs, Ss, Ss, Ss, Ds, Ds, Ds, Ds, Ds, Gs, Gs, Gs, Ss^Vhs, Gs, Gs, Ds, Ss, Ds, Ds, Ds, Ds, Ds, Ds, Ds, Ds, Gd, Gd, Gd
Gs, Gs, Gs, Ds, Ww, Gs, Gs, Rd, Gs^Vht, Gs, Ss, Ds, Ds, Ds, Ss, Ss, Ss, Ss, Ss, Ss, Ds, Ds, Gs, Gs, Gd, Ss, Ss, Ss, Gd, Ss, Gd, Gd, Gd, Gd, Gd, Gd
Gs, Gs, Wwf, Ww, Ds, Ds, Gs, Rd, Rd, Gs, Ss, Ss, Ds, Ds, Ds, Gs, Ss, Ss, Ss, Ss, Ds, Ds, Ds, Gs, Ss, Ss, Ss, Ss, Ss, Ss, Gd, Gd, Ss^Vhs, Gd, Gd, Gd
Ww, Ww, Ds, Ds, Ds, Ds, Ds, Ds, Ds, Ss, Ss, Ss, Ss, Gs, Gs, Gs, Gs, Gd, Gs, Ss, Ss, Ds, Ds, Ds, Ds, Gs, Ss, Ds, Ds, Ds, Ds, Ds, Gd, Gd, Gd, Gd
Gs, Gs, Gs, Ds, Ds, Ds, Ds, Ds, Ss, Ss, Ss, Ww^Bw\, Rd, Gs, Gs, Ss^Vhs, Gs, Ds, Ds, Ds, Ds, Ss, Ds, Ds, Ds, Gs, Ds, Ds, Ds, Ds, Ds, Ds, Ds, Ss, Gd, Gd
Gs, Gs, Gs, Gs, Ds, Ds, Ds, Ds, Ss, Ss, Ss, Ss, Gs, Rd, Gs, Rd, Gs, Gs, Ds, Ds, Ds, Ss, Ss, Ss^Vhs, Rr, Gs, Ds, Ds, Chs, Ss, Ss, Ss, Ss, Ss, Ss, Ss
Gs, Gs, Gs, Gs, Ss, Ds, Ds, Ds, Ds, Ss, Ds, Ds, Ds, Ds, Rd, Rd, Gs, Gs, Gs, Gs, Gs, Gd, Ss, Ss, Ss, Rr, Rr, Chs, 3 Khs, Chs, Ss, Ss, Ss, Ss, Ss, Ss
Ss, Ss, Ss, Ss, Ss, Ds, Gs, Ds, Gs, Gs, Gs, Ds, Cer, 6 Ker, Cer, Ds, Ds, Ds, Gs, Gs, Gs, Gs, Gs, Gs, Ss, Ss, Ss, Ss, Ds, Ds, Ds, Ss, Ss, Ss, Ss, Ss
Ss, Ss, Ss, Ss, Ss, Gs, Gs, Gs, Gs, Ds, Ds, Cer, Ds, Ds, Ds, Ss, Ss, Ss, Gs, Ds, Gs, Ds, Ds, Ds, Ss, Ss, Ss, Ss, Ds, Ds, Ds, Ds, Ss, Gd, Ss, Ss
Gs, Gs, Gs, Ss, Ss, Ss, Gs, Gs^Fmw, Gs, Ss^Vhs, Gs, Ds, Ds, Ds, Ds, Ds, Ss, Ss, Ss, Ss, Ds, Ds, Ds, Ds, Ss, Ss, Gd, Gs, Ds, Ds, Ds, Ds, Gs, Gs, Gs, Gd
Gs, Gs, Gs, Gs, Dd, Dd, Dd, Gs, Gs, Gs, Gs, Ds, Ds, Ds, Ds, Ss, Ss, Ss, Ss, Ds, Ds, Ds, Ds, Ds, Ss, Ss, Ss, Gs, Gs, Gs, Ds, Gs, Gs^Fmw, Gs^Vht, Gs, Gs
Gs, Gs, Gs, Gs, Dd, Dd, Dd, Gs, Ss, Gs, Ss, Rr, Ds, Ds, Ds, Ds, Gs, Gs, Gs, Ds, Ds, Ds, Ds, Ds, Ss, Ss^Vhs, Gs, Ss, Ss, Gs, Gs, Gs, Gs, Gs, Gs, Gs
Gs, Gs, Gs, Dd, Dd, Dd, Ss, Ss, Ss, Ss, Gs, Rr, Gs, Gs, Gs, Gs^Vht, Gs, Gs, Ds, Ds, Ds, Ds, Gs, Gs, Gs, Ss, Ss, Ss, Gd, Ss, Gs, Ds, Ds, Ds, Gs, Gs
Ss, Ss, Ss, Gd, Gd, Gs, Ss, Dd, Dd, Gd, Rr, Rr, Gs, Dd, Dd, Ds, Ss, Ss, Ss, Ds, Ds, Ds, Ds^Esd, Ds, Ds, Ss, Ss, Ss, Ds, Ds, Ds, Ds, Ds, Ds, Ds, Ds
Ss, Ss, Ss, Ss, Ss, Ss, Ss, Gd, Gs, Rr, Gd, Gd, Gs, Dd, Dd, Ds, Ds, Gs, Gs, Ds, Ds, Ds, Ds, Ds, Ds, Ds, Rd, Rd, Gs, Gs^Vht, Gs, Gs, Ds, Gs, Gs, Gs
Gd, Gd, Gd, Gd, Ss, Ss, Ss, Ss, Gs, Rr, Gd, Gs, Dd, Dd, Dd, Dd, Ds, Ds, Gs, Gs, Gs^Vht, Gs, Gs, Ds, Ds, Ds, Ds, Rd, Rd, Gs, Rd, Gs, Ss, Ss, Ss, Ss
Gs, Gs, Dd, Dd, Dd, Dd, Dd, Dd, Rr, Rr, Gs, Gs, Ss, Gd, Gd, Gd, Dd, Ds, Ds, Ds, Ds, Gs, Gs, Rd, Rd, Rd, Ds, Rd, Rd, Chr, Rd, Rd, Ds, Rd, Ss, Ss
Gs, Gs, Gs, Dd, Dd, Dd, Dd, Chr, Dd, Dd, Dd, Dd, Gd, Ss, Ss, Ss, Dd, Dd, Ds, Ds, Ds, Gs, Ss, Ss, Rd, Ss, Ds, Rd, Chr, 4 Khr, Chr, Rd, Ds, Rd, Gs, Gs
Gs, Gs, Gs, Gs, Dd, Dd, Chr, 5 Khr, Chr, Dd, Dd, Ss, Ss, Ss, Ss, Ss, Dd, Dd, Dd, Ds, Ds, Ds, Ds, Ss, Ss, Ss, Ss, Rd, Chr, Chr, Chr, Rd, Ds, Gs, Gs, Gs
Gs, Gd, Gs, Gd, Ss, Ss, Ss, Rr, Dd, Dd, Dd, Dd, Gs, Gd, Ss, Ss, Ss, Ds, Ds, Ds, Ds, Ds, Ds, Ds, Ss, Ss, Ss, Rd, Rd, Gs, Rd, Rd, Ds, Ds, Ds, Ds
Ss, Ss, Ss, Ss, Ss, Gd, Ds, Rr, Rr, Gs^Vht, Gs, Dd, Gs, Gd, Gs, Gd, Ss, Ds, Ds, Ss^Vhs, Ds, Ds, Gs, Gs, Gs, Gs, Ds, Rd, Gs, Gs^Vht, Gs, Gs, Ds, Gs, Gs, Gs
Ss, Ss, Ss, Ss, Ss, Ss, Gd, Gs, Rr, Gs, Dd, Dd, Dd^Esd, Dd, Gs, Gs, Gs, Ss, Ss, Ds, Ss, Gs, Ss, Gs, Ds, Ds, Ds, Ds, Ds, Gs, Gs, Gs, Ss, Ss, Gs, Gs
Gs, Gd, Gs, Gd, Gs, Gs, Dd, Dd, Dd, Rr, Rr, Dd, Dd, Dd, Dd, Gs, Ss, Ss, Ss, Ss, Ss, Ss, Ss, Gs, Ds, Ds, Ds, Ds, Ds, Ds, Ss, Ss, Ss, Gs, Gs, Gs
Gs, Gs, Gs, Gs, Gs, Gs, Dd, Dd, Dd, Rr, Rr, Dd, Dd, Dd, Dd, Gs, Ss, Ss, Ss, Ss, Ss, Ss, Ss, Gs, Ds, Ds, Ds, Ds, Ds, Ds, Ss, Ss, Ss, Gs, Gs, Gs
