Gll^Fp, Gll^Fp, Ss, Gs^Fp, Gll^Fp, Gll^Fp, Gg^Efm, Ds, Ss, Ds, Wwf, Gll^Fp, Re, Gll^Fp, Gg, Gll^Fp, Gll^Fp, Hh, Gll^Fp, Gll^Fp, Gll^Fp, Gll^Fp, Xu, Xu, Xu, Xu, Xu, Xu, Xue, Xu, Xu, Xu, Xu, Xu, Xu, Xu, Xu, Xu, Gll^Fp, Gll^Fp, Ww, Ww, Ww, Gll^Fp, Gll^Fp, Gll^Fp, Gll^Fp, Gll^Fp, Gll^Fp, Gll^Fp, Gll^Fp, Gll^Fp
Gll^Fp, Gg^Fet, Ss, Gg^Fet, Cv, Gll^Fp, Gg^Efm, Ds, Ss, Ds, Wwf, Gll^Fp, Re, Gll^Fp, Gg^Vh, Gll^Fp, Gg^Fet, Hh, Gll^Fp, Gll^Fp, Gll^Fp, Gll^Fp, Xu, Xu, Xu, Xu, Xu, Xu, Uh, Xu, Xu, Xu, Xu, Xu, Xu, Xu, Xu, Xu, Gll^Fp, Gll^Fp, Ww, Ww, Ww, Gll^Fp, Gg^Fet, Gll^Fp, Gg^Fet, Gll^Fp, Cv, Gll^Fp, Gll^Fp, Gll^Fp
Gg, Gg^Ve, Gg^Fet, Ss, Gg^Fet, Cv, Gg^Fet, Hh, Gg^Efm, Wwf, Ww, Wwf, Wwf, Re, Re, Gg^Efm, Re, Gll^Fp, Re, Re, Re, Re, Re, Re, Re, Re, Re, Re, Re, Uu, Uu, Uu^Uf, Uu^Vud, Xu, Xu, Xu, Xu, Ww, Ww, Ww, Ww, Ww, Ss, Ds, Ss, Gll^Fp, Gg^Efm, Cv, 5 Kv, Cv, Gg^Ve, Gg
Gg^Efm, Gg^Efm, Kv, 4 Kv, Cv, Cv, Gg^Efm, Gg^Efm, Ss, Wwf, Ww, Chs, Ss, Gll^Fp, Hh, Re, Gll^Fp, Re, Gll^Fp, Gll^Fp, Chw, Gg, Uu^Ii, Uu^Ii, Uu^Uf, Uu^Vu, Re, Xu, Uu^Uf, Re, Re, Uu, Uu, Xu, Xu, Xu, Xu, Ww, Ww, Xu, Xu, Ds, Xu, Ss, Re^Uf, Ss, Re, Gg^Fet, Re, Cv, Gll^Fp, Gll^Fp
Gll^Fp, Gll^Fp, Cv, Gg^Fet, Cv, Gg^Fet, Gll^Fp, Ss, Wwf, Wwf, Ww, Wwf, Wwf, Ss^Vhs, Ss, Hh, Gll^Fp, Re, Ww, Ww, Ch, Ww, Ww, Uh^Ii, Uh^Ii, Xu, Ds, Xu, Xu, Xu, Re, Uh, Xu, Xu, Xu, Xu, Ww, Ww, Xu, Xu, Xu, Xu, Uu^Vu, Xu, Uu^Ii, Re^Uf, Re^Uf, Re, Gg^Efm, Gg^Fet, Ss, Ss
Gll^Fp, Gg^Fet, Gg^Ve, Gg^Efm, Gll^Fp, Gll^Fp, Ss, Ss, Ww, Ww, Ww, Ww, Wwf, Ss, Ww, Ww, Ww, Ww^Bw|, Gll^Fp, Gg^Ve, Hh, Mm, Ww, Ww, Ww, Ww, Ww, Ds, Uu, Uu, Uu, Re, Re, Xu, Xu, Ww, Xu, Xu, Xu, Xu, Xu, Xu, Uu^Ii, Uu^Ii, Uu^Ii, Uu^Ii, Uu^Ii, Re^Uf, Gll^Fp, Gll^Fp, Ss, Ss
Gll^Fp, Gg^Fet, Gg^Efm, Re, Gll^Fp, Ss, Wwf, Ww, Wo, Ww, Wo, Ww, Ww, Ww, Ss, Ss, Gll^Fp, Re, Hh, Gll^Fp, Gll^Fp, Mm, Mm, Ww, Xu, Ww, Xu, Wwf, Wwf, Ww, Ww, Uu, Re, Xu, Ww, Ww, Xu, Xu, Xu, Xu, Uu, Uu, Xu, Uu^Ii, Xu, Uu^Ii, Xu, Xu, Xu, Hh, Hh, Hh
Gll^Fp, Gll^Fp, Re, Re, Gll^Fp, Ss, Wwf, Ww, Wo, Wo, Wo, Ww^Vm, Ww, Wwf, Ss, Ss, Gll^Fp, Re, Re, Re, Re, Hh, Xu, Xu, Xu, Ww, Uu, Uu, Xu, Xu, Uu, Ww, Ww, Ww, Wwf, Xu, Xu, Xu, Uu, Re, Re, Re, Re, Re, Re, Re, Re, Xu, Xu, Xu, Xu, Xu
Re, Re, Gg^Fet, Gll^Fp, Hh, Ss, Ss, Ww, Ww, Wo, Wo, Wo, Ww, Ww, Ww, Ss, Hh, Re, Hh, Hh, Re, Gll^Fp, Uu^Ii, Xu, Xu, Ww, Uu^Vud, Re, Xu, Uh, Uu^Uf, Uu^Vu, Uu^Uf, Ww, Ww, Wwf, Wwf, Uu, Re, Re, Xu, Xu, Xu, Xu, Uu, Uu, Re, Uu^Uf, Xu, Xu, Xu, Xu
Re, Re, Re, Gg^Ve, Gg^Fet, Ss, Gg^Efm, Ss, Ss, Ww, Ww, Ww, Wwf, Wwf, Ss^Vhs, Ww, Ww, Gll^Fp, Ww, Gll^Fp, Ds, Gll^Fp, Uu^Ii, Uu^Vud, Uu, Ww, Wwf, Re, Xu, Uh, Uh, Uh, Xu, Xu, Uu, Ww, Ww, Uu, Xu, Xu, Xu, Xu, Uh, Xu, Re, Xu, Re, Uh, Xu, Xu, Xu, Xu
Gll^Fp, Gg^Fet, Gg^Fet, Re, Gll^Fp, Gll^Fp, Gll^Fp, Ds, Ds, Ww, Ss, Ww, Wwf, Ss, Ss, Gs^Ft, Gs^Ft, Ww, Gll^Fp, Wo, Wwf, Xu, Xu, Xu, Ww, Cud, Cud, Ww, Xu, Xu, Xu, Xu, Uu^Uf, Uu, Re, Re, Ww, Xu, Xu, Xu, Xu, Uh, Uu^Vud, Re, Xu, Xu, Re, Uh, Uu^Uf, Xu, Xu, Xu
Gll^Fp, Gll^Fp, Hh, Re, Re, Gg^Fet, Re, Gll^Fp, Gll^Fp, Ww, Ss, Ss, Hh, Ww, Ww, Ds, Ds, Hh, Wo, Wo, Cud, Cud, Ww, Ww, Wo, Ww^Bw|, Ww, Ww, Cud, Xu, Xu, Uu^Vud, Uu, Re, Uh, Xu, Xu, Ww, Xu, Xu, Uu^Uf, Uu^Uf, Uu, Re, Xu, Re, Re, Uu, Uu^Uf, Xu, Xu, Xu
Gll^Fp, Gg^Fet, Gll^Fp, Gll^Fp, Gll^Fp, Re, Gg^Fet, Re, Re, Ww, Gll^Fp, Hh, Mm, Gll^Fp, Gll^Fp, Ww, Gll^Fp, Hh, Wo, Wo, Cud, Xu, Wo, Wo, Uh, Uu, Uu^Uf, Ww, Ww, Cud, Re, Uu, Re, Re, Xu, Xu, Ww, Ww, Xu, Uu^Uf, Xu, Xu, Re, Xu, Uh, Re, Uu, Uu^Vud, Uu^Uf, Xu, Xu, Xu
Ds, Ds, Ww, Ww, Ww, Ds, Gll^Fp, Gll^Fp, Ds, Ww^Bw\, Re, Re, Gs, Gs, Ss, Ww, Mm, Wo, Xu, Xu, Xu, Ww^Bw\, Uu^Uf, Uh, Cud, Cud, Cud, Uh, Ww^Bw/, Cud, Xu, Re, Xu, Xu, Xu, Ww^Vm, Ww, Ww, Xu, Uu^Uf, Xu, Uu, Xu, Uu, Uu, Re, Uu, Uh, Xu, Xu, Xu, Xu
Ww, Ww, Wo, Ww, Wo, Ww, Ww, Ww, Ww, Ww, Ss, Re, Ss, Gs^Ft, Xu, Wwf, Dd, Wo, Xu, Xu, Cud, Wo, Uh, Uu, Uu^Vu, Cud, Uu^Vu, Uu^Uf, Ww, Ww, Ww, Xu, Xu, Xu, Ww, Ww, Wwf, Xu, Re, Re, Uu, Re, Xu, Uu, Xu, Re, Uu, Xu, Xu, Xu, Xu, Xu
Wo, Wo, Wo, Xu, Xu, Wo, Xu, Xu, Xu, Ww, Uu^Ii, Ss^Bw|, Ss, Xu, Re^Uf, Xu, Uh^Ii, Rd, Xu, Uu^Uf, Cud, Wo, Uh, Uu^Uf, Cud, 3 Kud, Cud, Wwf, Uh, Cud, Ww, Xu, Ww, Ww, Xu, Xu, Wwf, Uu, Xu, Xu, Xu, Xu, Uu^Uf, Uu, Re, Re, Uu, Xu, Xu, Xu, Xu, Xu
Mm^Xm, Mm^Xm, Wo, Wo^Vm, Wo, Wo, Wo, Ww, Ww, Ww, Re, Uu^Vu, Uh, Ss, Ss, Uu, Uu^Ii, Re, Xu, Xu, Xu, Wo, Ww, Uu^Uf, Uh, Cud, Uu^Uf, Wwf, Uu^Uf, Cud, Ww, Ww, Ww, Xu, Uh, Uu, Wwf, Xu, Ww, Xu, Wo, Xu, Uu^Uf, Uu, Re, Uu, Uh, Xu, Xu, Xu, Xu, Xu
Mm^Xm, Mm^Xm, Mm^Xm, Wo, Xu, Wo, Xu, Xu, Xu, Ww, Uu, Re, Uu^Uf, Uh, Xu, Ww, Xu, Re, Re, Xu, Xu, Uu^Uf, Ww^Bw/, Uu^Uf, Uu^Uf, Uh, Uu^Uf, Uu, Ww^Bw\, Ww, Uu, Xu, Xu, Xu, Re, Uu, Xu, Ww, Xu, Ww, Wo, Uu^Vud, Uu^Uf, Uu, Uu, Uu, Xu, Xu, Xu, Xu, Xu, Xu
Ww, Ww, Wo, Mm^Xm, Xu, Wo, Wo, Xu, Xu, Ww, Uu^Uf, Re, Uu^Vud, Xu, Xu, Ww, Wo, Xu, Re, Uh, Xu, Uu^Vud, Uu, Wwf, Cud, Wwf, Ww, Ww, Xu, Cud, Re, Re, Re, Re, Uh, Xu, Wo, Ww, Xu, Ww, Ww, Uh, Uh, Uu, Re, Uu, Uu^Uf, Xu, Xu, Xu, Xu, Xu
Ww, Ww, Wo, Wo, Wo, Xu, Wo, Ww, Xu, Ww, Uu, Re, Uu^Uf, Xu, Xu, Xu, Ww, Xu, Uu^Vud, Uu, Re, Xu, Xu, Uu, Cud, Re, Cud, Ww, Ww, Xu, Xu, Xu, Uu^Uf, Uu, Uu^Vud, Xu, Ww, Ww, Ww, Wo, Xu, Xu, Wwf, Uu, Re, Uu, Uu, Uu^Vu, Xu, Xu, Xu, Xu
Gll^Fp, Gll^Fp, Mm, Mm, Wo, Xu, Xu, Ww, Ww, Ww, Uu, Re, Re, Uh, Xu, Xu, Xu, Ww, Wo, Xu, Uu, Xu, Xu, Uh, Xu, Uu^Uf, Re, Uu, Uu, Ww, Wwf, Xu, Xu, Uu^Uf, Xu, Wwf, Wwf, Xu, Xu, Ww, Xu, Xu, Wwf, Uu, Uu, Re, Uu, Uu^Uf, Uh, Xu, Xu, Xu
Gg, Gg, Wo, Wo, Mm, Wo, Wo, Xu, Xu, Ww, Wwf, Uu, Uu, Re, Xu, Xu, Xu, Ww, Ww, Wo, Xu, Re, Re, Xu, Re, Xu, Xu, Re, Uu^Uf, Uu, Uu^Vud, Xu, Xu, Xu, Xu, Wo, Ww, Wwf, Wwf, Ww, Wo, Ww, Wwf, Wwf, Uu, Xu, Re, Uu, Uu, Xu, Xu, Xu
Ww, Ww, Ww, Gll^Fp, Wo, Wwf, Wwf, Xu, Xu, Ww, Uu, Uu, Re, Re, Uu^Uf, Xu, Xu, Ww, Ww, Xu, Xu, Uu^Vud, Uu, Uu, Uu, Re, Re, Re, Xu, Uu^Uf, Cud, Uh, Xu, Xu, Xu, Ww^Vm, Ww, Xu, Ww, Wwf, Wwf, Wwf, Uu, Uu, Uu^Uf, Xu, Xu, Re, Uu, Uh, Xu, Xu
Ww, Ww^Vm, Ww, Wo, Gll^Fp, Wo, Wwf, Wwf, Wwf, Wwf, Uu, Re, Uu^Vu, Uh, Xu, Xu, Xu, Ww, Ww, Xu, Xu, Wo, Xu, Wo, Wo, Xu, Cud, Xu, Ww, Cud, Ww, Cud, Ww, Xu, Xu, Xu, Ww, Xu, Wo, Ww, Xu, Uu^Vu, Xu, Xu, Re, Uu, Uu^Uf, Re, Re, Uu, Xu, Xu
Xu, Xu, Xu, Ww, Mm, Xu, Ww^Vm, Wo, Ww, Wwf, Wwf, Re, Uh, Uh, Xu, Xu, Xu, Ww^Vm, Ww, Wo, Ww, Ww, Ww, Xu, Wo, Wo, Wo, Wo, Wo, Wo, Wo, Wo, Wo, Ww, Wo, Ww, Ww, Ww, Ww, Xu, Xu, Xu, Xu, Xu, Uu^Vud, Xu, Uu^Uf, Xu, Re, Uu^Uf, Xu, Xu
Xu, Xu, Xu, Xu, Xu, Xu, Ww, Xu, Ww, Ww, Wwf, Uu, Xu, Xu, Wo, Xu, Ww, Xu, Wo, Ww, Ww, Wo, Xu, Ww, Ww, Ww, Ww, Ww, Ww, Xu, Ww, Wo, Ww, Wo, Xu, Wo, Ww, Xu, Xu, Xu, Xu, Xu, Xu, Xu, Uu, Uu^Uf, Uh, Xu, Re, Uh, Xu, Xu
Mm^Xm, Mm^Xm, Mm^Xm, Xu, Xu, Xu, Ww, Wo, Xu, Ww, Uu, Wwf, Ww, Wo, Ww, Wo, Xu, Ww, Xu, Xu, Wo, Xu, Xu, Xu, Wo, Ww, Xu, Xu, Xu, Ww, Xu, Ww, Ss^Vm, Xu, Ww, Ww, Ww, Xu, Xu, Xu, Uu^Uf, Uu^Uf, Uu, Uu, Uu, Uh, Re, Re, Re, Uu, Xu, Xu
Ww, Ww, Mm, Mm^Xm, Xu, Xu, Ww, Wo, Ww, Ww, Uh, Uu^Vu, Xu, Xu, Xu, Xu, Xu, Ww, Wo, Xu, Ww, Xu, Ww, Xu, Xu, Ww, Ww, Chs, Chs, Xu, Xu, Ss, Xu, Xu, Ww, Ss^Vm, Ss, Xu, Xu, Xu, Uu, Xu, Re, Re, Re, Re, Uu, Xu, Uu^Vu, Uu, Xu, Xu
Ww, Ww, Ww, Mm^Xm, Xu, Xu, Xu, Ww, Wo, Ww, Wwf, Wwf, Xu, Wo, Ww, Xu, Wo, Ww, Xu, Ww, Xu, Ww^Vm, Xu, Ww, Ww, Xu, Ss^Vm, Ss, Ss^Bw|, Ss, Ss^Vhs, Ss, Xu, Xu, Ss^Bw/, Ss^Bw|, Ss, Xu, Uu, Uu^Vud, Re, Re, Re, Re^Uf, Uu^Uf, Uu, Xu, Xu, Xu, Xu, Xu, Xu
Ww, Ww, Ww, Mm^Xm, Hh, Xu, Xu, Uh, Ww^Vm, Ww, Wwf, Ww, Wo, Wo, Ww, Ww, Ww, Ww, Ww, Ww, Ww, Wo, Ww, Xu, Ww, Xu, Ww, Ss^Bw\, Ss^Bw|, Ss^Bw/, Ss, Xu, Ss, Uu, Uu, Ss, Uu, Uu, Chs, Re, Re^Uf, Re^Uf, Uu^Uf, Uh, Uu, Xu, Xu, Xu, Xu, Xu, Xu, Xu
Mm, Mm, Ww, Ww, Mm^Xm, Xu, Uh^Ii, Uu^Uf, Ww, Ww, Wwf, Ww, Ww, Xu, Xu, Xu, Xu, Xu, Xu, Wo, Xu, Ww, Xu, Ww, Ww, Ww, Chw, Ss^Bw/, Xu, Ss^Bw\, Re, Uu, Uu, Uu, Ss, Uu, Ss, Chs, Xu, Ss, Xu, Uh, Uh, Uu^Uf, Uu, Xu, Xu, Xu, Xu, Xu, Xu, Xu
Mm, Mm, Ww, Ww, Ww, Uu^Ii, Ww, Ww, Ww, Wwf, Uu^Vud, Ww, Ww, Xu, Xu, Xu, Re^Uf, Xu, Uh, Xu, Xu, Xu, Xu, Xu, Xu, Xu, Ww, Chs, Xu, Xu, Re, Uu, Re^Uf, Ss^Bw\, Chs, Ss, Re, Re^Uf, Re, Xu, Re^Uf, Xu, Xu, Xu, Xu, Xu, Xu, Xu, Xu, Xu, Xu, Xu
Ww, Ww, Mm, Ww, Ww, Ww, Uu^Ii, Ww, Wwf, Wwf, Ce, Uu, Ss, Ww, Xu, Re, Ss, Re, Ss, Ss, Ww, Ss, Ww, Ss, Ww, Ww, Ss, Chs, Uu, Re^Uf, Uu, Uu, Re, Ss, Chs, Re^Uf, Chs, Ss, Ss^Bw/, Re^Uf, Re, Xu, Xu, Xu, Xu, Xu, Xu, Xu, Xu, Xu, Xu, Xu
Mm, Mm, Hh, Ww, Ww, Ww, Xu, Uu^Ii, Ce, Re, Ce, Re, Ce, Ss, Chs, Re, Ss, Ss^Vhs, Ww, Ww, Ss, Ww, Ss, Ww, Ss, Ss, Re, Re^Uf, Uu, Xu, Uu^Vu, Xu, Xu, Ss^Bw\, Re, 2 Khs, Ss, Chs, Ss^Bw\, Ss, Xu, Xu, Xu, Xu, Xu, Xu, Xu, Xu, Xu, Xu, Xu, Xu
Gll^Fp, Gll^Fp, Ww, Ww, Gll^Fp, Hh, Xu, Uu, Uu, Ce, 1 Ke, Ce, Re, Re, Xu, Ss, Ww, Ww, Wwf, Ss, Re, Ss, Re, Ss, Re^Uf, Ss^Vhs, Ss, Uu, Re^Uf, Re, Xu, Xu, Re^Uf, Ss, Chs, Chs, Ss, Ss, Xu, Re^Uf, Chs, Re^Uf, Re^Uf, Xu, Xu, Xu, Xu, Xu, Xu, Xu, Xu, Xu
Ww, Ww, Ww, Ww, Ds, Hh, Mm, Xu, Xu, Uu, Uu, Re^Uf, Uu, Xu, Wo, Ww, Ww, Ww, Re^Uf, Re^Uf, Xu, Re, Xu, Re^Uf, Xu, Re^Uf, Xu, Uu, Xu, Xu, Xu, Re^Uf, Ss, Ss^Bw/, Ss, Ss, Xu, Ss^Vm, Ss, Re, Xu, Ss, Ss, Xu, Xu, Xu, Xu, Xu, Xu, Xu, Xu, Xu
Ww, Ww, Ww, Ww, Ds, Hh, Mm, Mm^Xm, Xu, Xu, Uu, Re^Uf, Uu, Xu, Wo, Ww, Ww, Ww, Re^Uf, Re^Uf, Xu, Xue, Xu, Xue, Xu, Xue, Xu, Xue, Xu, Xu, Xu, Re^Uf, Ss, Ss, Ss, Ss, Xu, Ss, Ss, Re, Xu, Ss, Ss, Xu, Xu, Xu, Xu, Xu, Xu, Xu, Xu, Xu
