Gg^Fp, Gg^Fp, Gg^Fp, Gg^Fp, Gg^Fp, Gs^Fp, Gg^Fp, Gg^Fp, Gg^Fp, Gs^Fp, Wwt, Wwt, Gg^Fp, Gs^Fp, Gs^Fp, Gg, Gg^Fp, Gg^Fp, Gs^Fp, Gs^Fp, Gg^Efm, Gs^Fp, Gs^Fp
Gg^Fp, Gg^Fp, Gg^Fp, Gg^Fp, Gg^Fp, Gg^Fp, Gs^Fms, Gg^Fp, Gg^Fp, Gg^Fet, Wwt, Wwt, Gg^Fp, Gs^Fp, Gs^Fp, Gg^Efm, Gg^Fds, Gg^Fds, Gs^Fds, Gg^Fet, Gg^Efm, Gs^Fp, Gs^Fp
Gs^Fp, Gg^Fet, Gg^Efm, Hh, Gs^Fp, Gg^Fet, Gs^Fp, Hh, Gg^Fp, Gs^Fp, Wwt, Wwt, Gg^Fp, Gg^Fet, Gg^Fp, Gg^Fp, Gg^Fp, Gg^Fds, Gg^Fms, Gg^Fds, Gs^Fp, Gs^Fp, Gs^Fp
Gg^Fp, Gs^Fp, Gg^Efm, Gs^Fp, Gs^Fp, Gs^Fp, Gg^Fms, Gs^Fp, Gs^Fds, Gg^Fet, Wwt, Wwt, Hh, Gs^Fp, Gs^Fp, Gs^Fms, Gg^Fp, Hh, Gs^Fp, Gs^Fp, Gs^Fp, Hh, Hh
Gg^Fp, Gg^Fp, Gg^Fp, Gg^Fet, Gs^Fp, Hh, Gg^Fms, Gg^Fms, Gg^Efm, Gg^Fp, Gg^Fet, Wwt, Wwt, Gg^Fp, Gg^Fp, Gg^Efm, Gs^Fp, Gs^Fp, Gs^Fp, Gs^Fp, Gs^Fp, Gg^Fet, Gs^Fp
Gg^Fp, Gs^Fms, Gs^Fds, Gs^Fp, Gs^Fp, Gs^Fp, Gg^Fp, Gs^Fds, Gg^Fet, Gg^Fp, Cv, Cv, Rrc, Wwt, Gg^Fp, Gg^Fp, Gs^Fms, Gg^Fet, Gs^Fp, Gg^Efm, Gs^Fms, Gs^Fp, Gs^Fp
Gs^Fp, Gg^Fp, Hh, Gs^Fp, Gg^Fet, Gg^Efm, Gg^Fp, Gg^Fp, Cv, Cv, Cv, Cv, Rrc, Wwt, Gg^Fet, Gg^Fp, Gs^Fp, Gs^Fp, Gs^Fp, Hh, Gs^Fp, Gs^Fp, Gs^Fp
Gs^Fp, Gs^Fp, Gs^Fms, Gg^Fp, Gg^Fp, Gg^Fp, Hh, Gg^Fet, Cv, Cv, Cv^Fet, Cv^Ve, Rrc, Wwt^Bsb\, Rrc, Gg^Efm, Gg^Fet, Gs^Fp, Gs^Fp, Gs^Fp, Gg^Efm, Gs^Fms, Gs^Fp
Gs^Fp, Gg^Fet, Gg^Fp, Gg^Fp, Gs^Fp, Gg^Fet, Cv, Cv, Cv, Cv^Ve, Cv, Kv, Rrc, Wwt, Rrc, Cv, Cv, Gg^Efm, Gg^Fet, Gs^Fp, Gs^Fp, Gs^Fp, Gs^Fp
Gg^Fp, Gg^Fp, Gs^Fp, Gg^Fp, Hh, Gg, Cv, Cv, Cv^Ve, Cv^Fet, Kv, 3 Kv, Rrc, Wwt, Rrc, Cv^Ve, Cv^Fet, Cv, Cv, Gs^Fp, Gg^Fet, Gs^Fp, Gs^Fp
Hh, Hh, Gg^Fet, Gs^Fp, Gg^Fet, Cv, Cv^Ve, Cv, Cv^Efm, Cv, Rrc, Rrc, Wwt, Wwt^Bsb\, Rrc, Kv, Cv, Cv, Cv, Gs^Fp, Gs^Fp, Gs^Fds, Gs^Fp
Gs^Fms, Gg^Fp, Gs^Fds, Gg^Efm, Gg^Efm, Cv, Cv, Gg^Fet, Rrc, Rrc, Wwt, Wwt^Bsb|, Wwt, Wwt, Rrc, 2 Kv, Cv, Cv, Cv, Gg^Fet, Hh, Gg^Efm, Gg^Efm
Gg^Fp, Gg^Fp, Gs^Fms, Gg^Fp, Wwt, Rrc, Wwt, Rrc, Wwt, Wwt, Rrc, Rrc, Rrc, Wwt^Bsb/, Rrc, Kv, Cv, Cv^Fet, Cv, Gs^Fp, Gs^Fp, Hh, Hh
Gg^Fp, Gg^Fp, Wwt, Wwt, Gg^Fet, Wwt^Bsb|, Wwt, Wwt, Cv, Rrc, Kv, 1 Kv, Rrc, Wwt, Rrc, Cv, Cv^Ve, Cv, Cv, Gg^Fet, Gs^Fp, Gg^Efm, Gg^Efm
Wwt, Wwt, Gs^Fms, Gg^Fp, Gg^Efm, Rrc, Cv^Ve, Cv, Cv^Efm, Cv, Cv, Kv, Rrc, Wwt, Rrc, Cv, Cv, Cv, Cv, Gg^Efm, Gs^Fp, Gg^Fet, Gs^Fp
Gg^Fp, Gg^Fp, Gg^Efm, Gg^Fp, Gg^Fet, Cv, Cv, Cv^Fet, Cv, Cv^Ve, Cv, Gg^Fet, Rrc, Wwt, Rrc, Cv^Fet, Cv^Ve, Cv, Gg^Efm, Gg^Fet, Gg^Fp, Gg^Fp, Gs^Fp
Gs^Fp, Gg^Fp, Gg^Fp, Gg^Fp, Hh, Gg^Efm, Cv, Cv^Ve, Cv^Fet, Cv, Cv, Cv^Ve, Rrc, Wwt^Bsb/, Wwt, Cv, Gg^Efm, Gg^Fet, Gg^Fp, Gs^Fms, Gs^Fp, Gg^Efm, Gg^Efm
Hh, Hh, Gg^Efm, Gs^Fp, Gg^Fp, Gg^Fet, Gg^Efm, Cv, Cv, Cv, Gg^Efm, Cv, Gg^Efm, Wwt, Wwt, Gg^Fet, Gg^Fp, Gg^Fp, Gs^Fp, Hh, Gg^Efm, Gg^Fp, Gg^Fp
Gg^Fp, Gg^Fet, Gg^Fp, Gg^Fp, Gg^Fp, Gs^Fp, Gg^Efm, Gg^Fet, Gg^Efm, Gg^Fet, Hh, Gg^Fet, Gg^Fp, Wwt, Wwt, Wwt, Wwt, Gs^Fms, Gg^Fp, Gg^Fet, Gg^Fp, Gg^Fp, Gs^Fp
Gg^Fp, Gg^Fp, Gg^Fp, Gg^Fp, Gg^Efm, Gs^Fp, Gg^Fp, Gs^Fp, Gg^Fms, Gs^Fp, Gs^Fp, Gg^Fp, Gg, Gg^Fp, Wwt, Wwt, Wwt, Wwt, Wwt, Gs^Fms, Gg^Fp, Gg^Fet, Gs^Fp
Gg^Efm, Gg^Efm, Hh, Gg^Fp, Gg^Fet, Hh, Gg^Fp, Gg^Fms, Gg^Fms, Gg^Fet, Hh, Gg, Gg^Fp, Gs^Fms, Wwt, Wwt, Hh, Wwt, Wwt, Wwt, Wwt, Gg^Fp, Gs^Fp
Gg^Fp, Gg^Fms, Gg^Fp, Hh, Gg^Fp, Gs^Fms, Gs^Fp, Gs^Fp, Gs^Fp, Gg^Fp, Gg^Fp, Gs^Fp, Gg^Fp, Wwt, Hh, Gg^Fp, Gg^Fp, Gg, Gg^Fp, Wwt, Wwt, Hh, Hh
Gs^Fp, Gg^Fp, Gg^Fp, Gg^Fp, Gg^Efm, Gg^Fp, Gg^Efm, Hh, Gs^Fp, Gg^Fp, Gg^Fp, Gs^Fms, Wwt, Wwt, Gg^Fp, Gg^Fp, Gs^Fms, Gg^Fet, Gg^Fp, Wwt, Wwt, Wwt, Wwt
Hh, Hh, Gg^Efm, Gs^Fp, Gs^Fp, Gs^Fp, Gg^Fp, Gg^Fp, Gs^Fp, Gg^Fet, Wwt, Wwt, Gg^Fp, Gg^Fet, Gs^Fp, Gg^Efm, Hh, Hh, Gg^Efm, Gg^Fp, Gg^Fp, Wwt, Wwt
Hh, Hh, Gg, Gs^Fp, Gs^Fp, Gg^Fp, Gs^Fp, Gg^Fp, Gg^Fp, Gg^Fp, Wwt, Wwt, Gg^Fp, Gs^Fp, Gs^Fp, Gg^Efm, Hh, Hh, Gg, Gg^Fp, Gg^Fp, Wwt, Wwt
