Ww, Ww, Ww, Ds, Ds, Gg, Gg, Gg, Gg, Gg, Gg, Gg, Gg, Gg, Gg, Gg, Gg, Gg, Gg, Gg, Gg, Gg, Gg, Gg, Gg, Gg, Gg, Gg, Gg, Gg, Gg, Gg, Gg, Gg, Gg, Gg, Gg, Gg, Gg, Gg, Gg, Gg, Gg, Gg, Ww, Ww, Ww
Ww, Ww, Ww, Ds, Ds, Gg, Gg, Gg, Gg, Gg, Gg, Gg, Gg, Gg, Gg, Gg, Gg, Gg, Gg, Gg, Gg, Gs^Fmw, Gs^Fmw, Gg, Gg, Gg, Gg, Gg, Gg, Gg, Gg, Gg, Gg, Gg, Gg, Gg, Gg, Gg, Gg, Gg, Gg, Gg, Gg, Gg, Ww, Ww, Ww
Ww, Ww, Ww, Ww, Ds, Gg, Gg, Gg, Gg, Gg, Gg, Gg, Gg, Gg, Gg, Gg, Gg, Gg, Gg, Gs^Fmw, Gs^Fmw, Gs^Fmw, Gs^Fmw, Gg, Gs^Fmw, Gg, Gs^Fp, Gg, Gg, Gg, Gg, Gg, Gg, Gg, Gg, Gg, Gg, Gg, Gg, Gg, Ce, Ce, Ce, Ww, Rp, Rp, Rp
Ds, Ds, Ds, Ww, Ww, Ds, Gg, Gg, Gg, Gg, Gg^Vl, Gg, Gg, Gg, Gg, Gg, Gg, Gg, Gg, Gg, Gg, Gs^Fmw, Gs^Fmw, Gs^Fmw, Gs^Fmw, Gs^Fp, Gs^Fp, Gs^Fp, Gg, Gg, Gg, Gs^Fmw, Gs^Fmw, Gg, Gg, Gg, Gg, Gg, Gg, Gg, Ce, 1 Ke, Ce, Ww^Bw\, Rp, Gg, Gg
Gg, Gg, Gg, Ds, Ww, Ds, Ds, Gg, Gg, Gg, Re^Gvs, Re^Gvs, Re^Gvs, Gg, Re^Gvs, Gg, Gg, Gg, Gs^Fmw, Gs^Fmw, Gll^Fmw, Gs^Fmw, Gll^Fms, Gs^Fmw, Gs^Fp, Gll^Fp, Gll^Fp, Gs^Fp, Gs^Fp, Gs^Fmw, Gs^Fmw, Gs^Fmw, Gs^Fmw, Gs^Fmw, Gg, Gg, Gg, Gg, Gg, Gg, Gg, Ce, Ww^Bw\, Ww^Bw\, Rp, Gg, Gg
Gg, Gg, Gg, Ds, Ww, Ww, Ds, Gg, Gg, Re^Gvs, Re^Gvs, Re^Gvs, Re^Gvs, Re^Gvs, Re^Gvs, Re^Gvs, Gg, Gs^Fms, Gs^Fms, Gll^Fms, Gll^Fms, Gll^Fms, Gll^Fmw, Gll^Fmw, Gll^Fp, Gll^Fp, Gll^Fmw, Gll^Fmw, Gs^Fmw, Gs^Fmw, Gs^Fmw, Gg^Vh, Gg, Gg, Gg, Gg, Gg, Gg, Ww, Gg, Ww, Ww, Gg, Rp, Gg, Gg, Gg
Gg, Gg, Re^Gvs, Ds, Ds, Ww, Ds, Gg, Gg, Re^Gvs, Re^Gvs, Re^Gvs, Re^Gvs, Re^Gvs, Re^Gvs, Gg, Gs^Fms, Gs^Fms, Gs^Fms, Gs^Fms, Gs^Fms, Gll^Fms, Gll^Fms, Gll^Fp, Gs^Fp, Gll^Fp, Gll^Fmw, Gll^Fms, Gg, Gs^Fmw, Gs^Fmw, Gs^Fmw, Gs^Fmw, Gg, Gg, Gg, Ww, Ww, Gs, Ww, Gg, Gg, Rp, Rp, Re^Gvs, Re^Gvs, Re^Gvs
Re^Gvs, Re^Gvs, Re^Gvs, Re^Gvs, Ds, Ww, Ww, Ds, Gg, Re^Gvs, Re^Gvs, Re^Gvs, Re^Gvs, Re^Gvs, Gg, Gg, Gg, Gs^Fms, Gs^Fms, Gg, Gs^Fms, Gll^Fms, Gll^Fp, Gll^Fp, Gll^Fp, Gll^Fp, Gll^Fp, Gs^Fmw, Gs^Fmw, Gs^Fms, Gs^Fmw, Gs^Fmw, Gs^Fmw, Gs^Fmw, Ww, Wwf, Gs, Gs, Rp, Gg, Rp, Rp, Gg, Re^Gvs, Re^Gvs, Re^Gvs, Re^Gvs
Re^Gvs, Re^Gvs, Re^Gvs, Re^Gvs, Gg, Ds, Ww, Ds, Ds, Gg, Gg, Re^Gvs, Gg^Vl, Gg, Gg, Gg, Gs^Fms, Gs^Fms, Gll^Fms, Gll^Fms, Gll^Fms, Gll^Fms, Gll^Fp, Gll^Fp, Gll^Fms, Gll^Fp, Gll^Fp, Gll^Fp, Gs^Fp, Gs^Fp, Gs^Fms, Gs^Fmw, Ww, Ww, Gs, Gs, Rp, Rp, Gg, Rp, Gg, Gg, Gg, Re^Gvs, Re^Gvs, Re^Gvs, Re^Gvs
Gg, Gg, Re^Gvs, Re^Gvs, Re^Gvs, Ds, Ww, Ww, Ds, Gg, Gg, Gg, Gg, Gg, Gg, Gg, Gg, Gs^Fms, Gs^Fms, Gll^Fms, Gll^Fms, Gll^Fp, Gll^Fms, Gll^Fms, Gg, Gs^Fms, Gll^Fms, Gs^Fp, Gs^Fp, Gs^Fp, Ww, Ww, Gs, Gs, Rp, Rp, Gg, Gg, Gg, Gg, Gg, Gg, Gg^Vl, Re^Gvs, Re^Gvs, Re^Gvs, Re^Gvs
Gg, Gg, Re^Gvs, Re^Gvs, Re^Gvs, Ds, Ds, Ww, Ww, Ds, Ds, Gg, Gg, Gg, Gg, Gg, Gs^Fms, Gs^Fms, Gg, Gs^Fms, Gs^Fms, Gll^Fms, Gll^Fms, Gll^Fms, Gs^Fms, Gs^Fms, Gs^Fms, Gs^Fp, Ww, Ww, Gg, Gg, Rp, Rp, Gg, Gg, Gg, Gg, Gg, Gg, Gg, Gg, Re^Gvs, Re^Gvs, Re^Gvs, Re^Gvs, Re^Gvs
Gg, Gg, Re^Gvs, Re^Gvs, Gg, Gg, Ds, Ww, Ww, Ww, Ds, Gg, Gg, Gg, Gg, Gg, Gg, Gg, Gg, Gs^Fms, Gll^Fms, Gll^Fms, Gll^Fms, Gll^Fms, Gll^Fms, Gs^Fms, Gs^Fms, Gs^Fms, Ww, Gg, Rp, Rp, Gg, Gg, Gg, Gg, Gg, Gg, Gg, Gg, Gg, Gg, Re^Gvs, Re^Gvs, Re^Gvs, Re^Gvs, Re^Gvs
Re^Gvs, Re^Gvs, Re^Gvs, Re^Gvs, Gg, Gg, Gg, Ds, Ds, Ww, Ww, Ds, Ds, Ds, Ds, Gg, Gg, Gg, Gs^Fms, Gs^Fms, Gs, Gg, Gs^Fms, Gs^Fms, Gs^Fms, Gs^Fms, Ww, Ww, Gg, Gg, Rp, Gg^Vh, Gg, Gg, Gg, Gg, Gg, Gg, Gg, Gg, Gg, Gg, Re^Gvs, Re^Gvs, Re^Gvs, Re^Gvs, Re^Gvs
Re^Gvs, Re^Gvs, Re^Gvs, Re^Gvs, Gg, Gg, Gg, Gg, Gg, Ds, Ww, Ww, Ww, Ww, Ds, Gg, Gg, Gg, Gs, Gs, Gs, Gs, Gs, Gs, Wwf, Ww, Gg, Gg, Rp, Rp, Gg, Gg, Gg, Gg, Gg, Gg, Gg, Gg, Ch, Gg, Gg, Gg^Vl, Gg, Re^Gvs, Re^Gvs, Re^Gvs, Re^Gvs
Gg, Gg, Gg, Gg^Vl, Gg, Gg, Gg, Gg, Gg, Ds, Ds, Ds, Ds, Ww, Ww, Ds, Ds, Ds, Ds, Gs, Gs, Gs, Ww, Ww, Gg, Gg, Rp, Rp, Gg, Gg, Gg, Gg, Gg, Gg, Gg, Gg, Gg, Ch, 2 Kh, Ch, Gg, Gg, Re^Gvs, Gg, Gg, Gg, Gg
Gg, Gg, Gg, Gg, Gg, Gg, Gg, Gg, Gg, Gg, Gg, Gg, Gg, Ds, Ds, Ww, Ww, Ww, Ww, Ds, Ww, Ww, Gg, Gg, Rp, Rp, Gg, Gg, Gg, Gg, Gg, Gg, Gg, Gg, Gg, Gg, Gg, Ch, Ch, Ch, Re^Gvs, Re^Gvs, Re^Gvs, Re^Gvs, Re^Gvs, Gg, Gg
Gg, Gg, Gg, Gg, Gg, Gg, Gg, Gg, Gg, Gg, Gg, Gg, Gg, Gg, Gg, Ds, Ds, Ww, Ww, Ww, Ds, Gg, Rp, Rp, Gg, Gg, Gg, Gg, Ds, Ds, Ds, Ds, Ds, Ds, Ds, Gg, Gg, Gg, Gg, Gg, Re^Gvs, Re^Gvs, Re^Gvs, Re^Gvs, Re^Gvs, Re^Gvs, Re^Gvs
Gg, Gg, Gg, Gg, Gg, Gg, Gg, Gg, Ch, Gg, Gg, Gg, Gg, Gg, Gg, Gg, Gg, Ds, Ds, Ww, Ww, Ds, Rp, Ds, Ds, Gg, Ds, Ds, Ww, Ww, Ww, Ww, Ww, Ww, Ds, Gg, Gg, Gg, Gg, Gg^Vh, Re^Gvs, Re^Gvs, Re^Gvs, Re^Gvs, Re^Gvs, Gg, Gg
Gg, Gg, Gg, Gg, Gg, Gg, Gg, Ch, 3 Kh, Ch, Gg, Gg, Gg, Gg, Gg, Gg, Gg, Gg, Gg, Ds, Ww, Ww, Ww^Bw|, Ww, Ww, Ds, Ww, Ww, Ww, Ww, Ds, Ds, Ds, Ww, Ww, Ds, Ds, Gg, Gg, Gg, Gg, Re^Gvs, Re^Gvs, Re^Gvs, Gg, Gg, Gg
Gg, Gg, Gg, Gg, Gg, Gg, Gg, Ch, Ch, Ch, Gg, Gg, Gg, Gg^Vh, Gg, Gg, Gg, Gg, Gg, Ds, Ds, Ds, Rr, Ds, Ww, Ww, Ww, Ww, Ds, Ds, Re^Gvs, Re^Gvs, Re^Gvs, Ds, Ww, Ww, Ds, Gg, Gg, Gg, Gg, Gg, Gg, Gg, Gg, Gg, Gg
Hh, Hh, Hh, Gg, Gg, Gg, Gg, Gg, Gg, Gg, Gg, Gg, Re^Gvs, Re^Gvs, Re^Gvs, Gg, Gg, Gg, Gg, Gg, Gg, Gg^Vh, Rr, Ds, Ds, Ds, Ds, Ds, Re^Gvs, Re^Gvs, Re^Gvs, Re^Gvs, Re^Gvs, Ds, Ds, Ww, Ww, Ds, Ds, Gg, Gg, Gg, Gg, Gg, Gg, Gg, Gg
Mm, Mm, Mm, Hh, Gg, Gg, Gg, Gg, Gg, Gg, Gg, Gg, Re^Gvs, Re^Gvs, Re^Gvs, Re^Gvs, Gg, Gg, Gg, Gg, Re, Rr, Rr, Gg, Re^Gvs, Re^Gvs, Re^Gvs, Gg, Re^Gvs, Re^Gvs, Re^Gvs, Re^Gvs, Gg, Gg, Ds, Ww, Ww, Ww, Ww, Ds, Ds, Gg, Ds, Gg, Gg, Gg, Gg
Mm, Mm, Hh, Gg, Gg, Gg, Gg, Gg, Re^Gvs, Re^Gvs, Re^Gvs, Re^Gvs, Re^Gvs, Re^Gvs, Re^Gvs, Re^Gvs, Gg, Gg, Gg, Re, Rr, Re, Gg, Gg, Re^Gvs, Re^Gvs, Re^Gvs, Gg, Gg, Re^Gvs, Gg^Vl, Gg, Re^Gvs, Re^Gvs, Re^Gvs, Ds, Ds, Ww, Ww, Ww, Ww, Ds, Ww, Ds, Ds, Gg, Gg
Mm, Mm, Mm, Hh, Gg, Gg, Gg, Gg, Re^Gvs, Re^Gvs, Re^Gvs, Re^Gvs, Re^Gvs, Gg, Gg, Gg^Vh, Gg, Gg, Rr, Re, Re, Gg, Gg, Gg, Gg^Vl, Re^Gvs, Gg, Gg, Gg, Gg, Gg, Gg, Re^Gvs, Re^Gvs, Re^Gvs, Gg, Re^Gvs, Ds, Ds, Ds, Ds, Ww, Ww, Ww, Ww, Ds, Ds
Mm, Mm, Mm, Mm, Hh, Gg, Gg, Gg, Gg^Vh, Re^Gvs, Gg, Re^Gvs, Gg, Gg, Gg, Gg, Re, Re, Re, Re, Gg, Gg, Gg, Gg, Gg, Gg, Gg, Gg, Gg, Gg, Gs^Fms, Gs^Fms, Gg, Re^Gvs, Re^Gvs, Re^Gvs, Re^Gvs, Re^Gvs, Gg, Gg, Gg, Ds, Ds, Ww, Ww, Ww, Ww
Mm, Mm, Mm, Hh, Gg, Gg, Gg, Gg, Gg, Gg, Gg, Gg, Gg, Gg, Re, Re, Re, Re, Gg, Gg, Gg, Gg, Gg, Gg, Re^Gvs, Re^Gvs, Re^Gvs, Gg, Gs^Fms, Gs^Fms, Gs^Fms, Gs^Fms, Gs^Fp, Re^Gvs, Re^Gvs, Re^Gvs, Re^Gvs, Re^Gvs, Gg, Gg, Gg, Gg, Gg, Ds, Ds, Ww, Ww
Mm, Mm, Mm, Mm, Hh, Hh, Gg, Gg, Gg, Gg, Gg, Gg, Re, Re, Re, Re, Gg, Re, Re, Gg, Gg, Gg, Gg, Gg^Vl, Re^Gvs, Re^Gvs, Re^Gvs, Re^Gvs, Gs^Fms, Gs^Fms, Gs^Fms, Gs^Fms, Gs^Fp, Gs^Fp, Gg, Gg, Gs^Fp, Gs^Fp, Gg, Gg, Gg, Gg, Gg, Gg, Gg, Ds, Ds
Mm, Mm, Mm, Hh, Hh, Gg, Gg, Gg, Gg, Gg, Gg, Gg, Re, Re, Gg, Gg, Gg, Gg, Gg^Vh, Re, Re, Gg, Gg, Gg, Gg, Re^Gvs, Gs^Fms, Gs^Fms, Gs^Fms, Gs^Fms, Gs^Fms, Gs^Fms, Gs^Fp, Gs^Fp, Gs^Fms, Gs^Fms, Gs^Fp, Gs^Fp, Gg, Gg, Gg, Gg, Gg, Gg, Gg, Gg, Gg
Hh, Hh, Hh, Gg, Gg, Gg, Gg, Gg, Gg, Gg, Gg, Re, Re, Re, Gg, Gg, Gg, Gg, Gg, Gg, Gg, Re, Re, Gg, Gg, Gs^Fms, Gs^Fms, Gg^Vl, Gs^Fms, Gs^Fms, Gll^Fms, Gs^Fms, Gs^Fp, Gs^Fp, Gs^Fp, Gs^Fms, Gs^Fms, Gs^Fp, Gs^Fp, Gg, Gg, Gg, Gg, Gg, Gg, Gg, Gg
Hh, Hh, Gg, Gg, Gg, Gg, Gg, Gg^Vh, Gg, Gg, Re, Re, Re, Gg, Gg, Gg, Gg, Gg, Gg, Gg, Gg, Gg, Re, Gg, Re^Gvs, Gg, Gs^Fms, Gs^Fms, Gs^Fms, Gs^Fms, Gll^Fms, Gs^Fms, Gs^Fms, Gs^Fms, Gg^Vh, Gs^Fms, Gs^Fms, Gs^Fp, Gs^Fms, Gs^Fp, Gs^Fp, Gg, Gg, Gg, Gg, Gg, Gg
Gg, Gg, Gg, Gg, Gg, Gg, Gg, Gg, Gg, Gg, Re, Re, Gg, Gg, Gs^Fms, Gg, Gg, Gg, Gg, Gs^Fms, Gs^Fms, Gg, Re, Gg^Vh, Re^Gvs, Re^Gvs, Gs^Fms, Gs^Fms, Gll^Fms, Gll^Fms, Gs^Fms, Gll^Fms, Gs^Fms, Gs^Fms, Gs^Fms, Gs^Fms, Gs^Fp, Gs^Fp, Gs^Fp, Gs^Fms, Gs^Fp, Gg, Gg, Gg, Gg, Hh, Hh
Gg, Gg, Gg, Gg, Gg, Gg, Gg, Gg, Gg, Re, Re, Re, Gg, Gg, Gs^Fds, Gs^Fms, Gs^Fds, Gs^Fms, Gs^Fds, Gs^Fms, Gg, Gg, Gg, Re, Gg, Gs^Fms, Gs^Fms, Gs^Fms, Gs^Fms, Gll^Fms, Gll^Fms, Gll^Fms, Gll^Fms, Gs^Fms, Gll^Fms, Gs^Fms, Gs^Fms, Gs^Fms, Hh^Fms, Gs^Fp, Hh^Fp, Gs^Fp, Hh^Fp, Hh^Fp, Hh, Mm, Mm
Gg, Gg, Gg, Gg, Gg, Gg, Ch, Gg, Re, Re, Re, Gg, Gs^Fds, Gs^Fds, Gs^Fds, Gs^Fds, Gs^Fds, Gs^Fds, Gs^Fms, Gs^Fms, Gs^Fms, Gs^Fms, Gg, Re, Re, Gg, Gs^Fms, Gs^Fms, Gs^Fms, Gs^Fms, Gs^Fms, Gs^Fms, Gs^Fms, Gll^Fms, Gs^Fms, Gll^Fms, Gs^Fms, Gs^Fp, Hh^Fms, Hh^Fp, Hh^Fp, Gs^Fms, Gg, Hh, Mm, Mm, Mm
Gg, Gg^Vh, Gg, Gg, Gg, Ch, 4 Kh, Ch, Re, Re, Gg, Gg, Gg, Gs^Fds, Gs^Fds, Gs^Fds, Gs^Fms, Gs^Fms, Gs^Fms, Gs^Fms, Gs^Fms, Gs^Fms, Gg, Gg, Re, Gg, Gs^Fds, Gs^Fms, Gs^Fds, Gs^Fms, Gs^Fms, Gs^Fms, Gg^Vh, Gs^Fms, Gs^Fms, Gs^Fms, Gs^Fms, Gs^Fms, Gs^Fms, Gs^Fms, Hh^Fms, Hh, Hh, Mm, Mm, Mm, Mm
Gg, Gg, Gg, Gg, Gg, Ch, Ch, Ch, Re, Re, Gg, Gg, Gs^Fds, Gs^Fds, Gs^Fds, Gs^Fms, Gg^Ve, Gs^Fms, Gs^Fms, Gs^Fms, Gll^Fms, Gs^Fms, Gs^Fms, Gs^Fms, Gg, Re, Re, Gs^Fds, Gs^Fds, Gs^Fds, Gs^Fds, Gs^Fds, Gs^Fds, Gs^Fms, Gs^Fms, Gs^Fms, Gs^Fms, Hh^Fp, Hh^Fp, Hh, Hh, Mm, Mm, Mm, Mm, Mm, Mm
Gg, Gg, Gg, Gg, Gg, Gg, Re, Re, Re, Gg, Gg, Gs^Fds, Gs^Fds, Gs^Fds, Gs^Fds, Gs^Fms, Gs^Fds, Gs^Fds, Gs^Fms, Gll^Fms, Gll^Fms, Gll^Fms, Gll^Fms, Gs^Fms, Gs^Fms, Gs^Fms, Gs^Vht, Re, Re, Gs^Fds, Gs^Fds, Gs^Fds, Gs^Fds, Gs^Fds, Gs^Fds, Gg, Gg, Gg, Hh, Mm, Mm, Mm, Mm, Mm, Mm, Mm, Mm
Gg, Gg, Gg, Gg, Re, Re, Re, Re, Gg^Vh, Gg, Gg, Gg, Gs^Fds, Gs^Fds, Gs^Fds, Gs^Fds, Gs^Fds, Gs^Fms, Gs^Fms, Gs^Fms, Gs^Fms, Gll^Fms, Gs^Fms, Gs^Fms, Gll^Fms, Gs^Fms, Gs^Fms, Gs^Fms, Gs^Fms, Re, Re, Re, Re, Gs^Fds, Gg, Gg, Gg, Gg, Gg, Hh, Mm, Mm, Mm, Mm, Mm, Mm, Mm
Gg, Gg, Gg, Gg, Re, Re, Gg, Gg, Gg, Gg, Gg, Gs^Fds, Gs^Fds, Gg, Gs^Fds, Gs^Fds, Gs^Fms, Hh^Fms, Hh^Fms, Hh^Fms, Hh^Fms, Gll^Fms, Gs^Fms, Gll^Fms, Gll^Fms, Gs^Fms, Gs^Fms, Gs^Fms, Gs^Fms, Gs^Fms, Gg, Gg, Re, Re, Re, Gg, Gg, Gg, Hh, Mm, Mm, Mm, Mm, Mm, Mm, Mm, Mm
Gg, Gg, Gg, Gg, Re, Re, Gg, Gg, Gg, Gg, Gg, Gs^Fds, Gs^Fds, Gg, Gs^Fds, Gs^Fds, Gs^Fms, Hh^Fms, Hh^Fms, Hh^Fms, Hh^Fms, Hh^Fms, Gs^Fms, Gs^Fms, Gs^Fms, Gs^Fms, Gs^Fms, Gs^Fms, Gs^Fms, Gs^Fms, Gg, Gg, Re, Re, Re, Gg, Gg, Gg, Hh, Mm, Mm, Mm, Mm, Mm, Mm, Mm, Mm
