Mm, Mm, Mm, Hh, Gs^Fds, Gs^Fds, Gs^Fds, Gs^Fds, Gs^Fds, Gs^Fds, Gs^Fds, Rd, Rd, Gs^Fds, Gs^Fds, Gs^Fds, Gs^Fds, Gs^Fds, Gs^Fds, Gs^Fds, Gg, Ds, Ds, Ds, Ww, Ww, Ww, Ww, Ww
Mm, Mm, Mm, Hh, Gs^Fms, Gs^Fds, Gs^Fds, Gs^Fds, Gs^Fds, Gg^Fet, Gs^Fds, Gs^Fds, Rd, Gs^Fds, Gs^Fds, Gs^Fms, Gs^Fms, Gs^Fds, Gs^Fds, Gs^Fds, Gg, Ds, Ds, Ds, Ds, Ww, Ww, Ww, Ww
Mm, Mm, Mm, Mm, Mm, Gs^Fms, Gs^Fms, Gs^Fds, Gs^Fds, Gs^Fms, Gs^Fds, Gs^Fds, Rd, Gs^Fds, Gs^Fds, Gs^Fms, Gs^Fms, Gs^Fds, Gs^Es, Gs^Fds, Gs^Fds, Ds, Ds, Ds^Es, Ds, Ds, Ww, Ww, Ww
Mm, Mm, Mm, Mm, Hh, Hh^Fp, Gs^Fds, Gs^Fds, Gs^Fds, Gs^Fds, Gs^Fds, Gs^Fds, Rd, Gs^Fds, Gs^Fds, Gs^Fds, Gs^Fds, Gs^Vht, Gs, Gg, Gs^Fds, Gs^Fds, Ds, Ds, Ds, Ds, Ww, Ww, Wo
Mm, Mm, Mm, Hh^Vhh, Hh^Es, Hh^Fp, Gg^Es, Gs^Fds, Gg, Gs^Vh, Rd, Gs, Rd, Rd, Gs^Fds, Gs^Fds, Gs^Fds, Gs, Gs^Fds, Gs^Fds, Gg^Fet, Ds, Ds, Ds, Ds, Ww, Ww, Ww, Wo
Mm, Mm, Mm, Hh, Hh^Es, Hh^Es, Gg^Es, Gg, Rd, Gg, Rd, Rd, Rd, Rd, Rd, Gs^Fds, Gs^Fds, Gg, Gg, Gs^Fds, Ds^Esd, Ds^Es, Ds, Ds, Ww, Ww, Ww, Ww, Wo
Mm, Mm, Mm, Hh, Ce, Gg, Rd, Rd, Gg, Rd, Gs^Fds, Gs^Fds, Gs^Fds, Gs^Fds, Rd, Gs^Fds, Gs^Fds, Gs^Fds, Gg^Es, Gg^Es, Ds^Esd, Ds^Es, Ds^Es, Ww, Wwr, Ww, Wo, Ww, Ww
Mm, Mm, Mm, Ce, 2 Ket, Ce, Gg, Gg, Gg^Es, Gs^Fms, Gs^Fds, Gs^Fds, Gs^Fds, Rd, Gs^Fds, Gs^Fds, Gs^Fms, Gs^Fds, Gg^Es, Gg^Es, Gg^Es, Ds^Esd, Ds, Ww, Ww, Ww^Vm, Ww, Ww, Ww
Mm, Mm, Mm, Ce, Ce, Ce, Mm, Gg, Hh^Vhh, Gs^Fds, Gs^Fds, Gs^Fds, Gs^Fds, Rd, Gs^Fds, Gs^Fms, Gs^Fms, Gs^Fds, Gs^Fms, Gg^Es, Gg, Ds, Ds, Ds, Ds, Ww, Ww, Ww, Wo
Mm, Mm, Mm, Mm, Mm, Mm, Hh, Hh, Hh^Fp, Gs^Fds, Gs^Fds, Gs^Fds, Gs^Fds, Rd, Gs^Esd, Gs^Fds, Gs^Fds, Gs^Fds, Gs^Fds, Gs^Fds, Gs^Fds, Gg^Es, Gg, Ds, Ds, Ds, Ww, Ww, Ww
Mm, Mm, Mm, Mm, Mm, Mm, Hh, Hh^Fet, Hh^Fp, Gs^Fds, Gs^Fms, Gs^Fds, Gs^Fds, Rd, Gs^Fds, Gs^Fds, Gs^Fms, Gs^Fds, Gs^Fds, Gs^Fds, Gs^Fds, Gs^Fms, Gg, Ds, Ds, Ds, Ww, Ww, Ww
Mm, Mm, Mm, Mm, Mm, Mm, Hh, Hh^Fp, Hh^Fms, Gs^Fds, Gs^Fms, Gs^Fds, Gs^Fds, Rd, Gs^Fds, Gs^Fds, Gs^Fds, Gs^Fds, Gs^Vl, Gs^Fds, Gs^Fds, Gs^Fms, Gg, Ds, Ds, Ds, Ww, Ww, Ww
Mm, Mm, Mm, Mm, Mm, Mm, Hh, Hh, Hh, Gs^Fds, Gs^Fds, Gs^Fds, Gs^Fds, Rd, Rd^Es, Gs^Fds, Gs^Fds, Rb^Gvs, Rb^Gvs, Rb^Gvs, Gs^Fds, Gs^Fds, Gs^Fds, Ds, Ds, Ds, Ds, Ww, Ww
Mm, Mm, Mm, Mm, Mm, Mm, Hh, Hh, Hh, Hh^Fp, Hh, Gs^Fds, Gs^Fds, Gs^Fms, Rd^Es, Gs^Fds, Gs^Fds, Gs^Fds, Gs^Fds, Gs^Fms, Gg^Fet, Gs^Fms, Gs^Fds, Gg, Ds, Ds, Ds, Ww, Ww
Mm, Mm, Mm, Mm, Mm, Mm, Mm, Hh, Hh, Hh, Hh, Gs^Fds, Gs^Fds, Gs^Fds, Gs^Fds, Rd, Rd, Gs^Fds, Gs^Fds, Gs^Fds, Gs^Fds, Gs^Fds, Gs^Fds, Gs^Fds, Gs^Fds, Ds, Gg, Ww, Ww
Mm, Mm, Mm, Mm, Mm, Mm, Mm, Mm, Wwf, Hh, Hh^Fp, Hh^Fms, Gs^Fds, Gs^Fds, Gs^Fds, Gs^Fds, Gs^Fds, Rd, Rd, Gs^Fds, Gs^Fds, Gs^Fds, Gs^Fds, Gs^Fds, Gs^Fds, Gs^Vh, Gs^Vh, Ww, Ww
Mm, Mm, Mm, Mm, Mm, Mm, Mm, Mm, Hh, Mm, Hh, Gs^Fds, Gs^Fds, Gs^Fds, Gs^Fds, Gs^Fds, Gs^Fds, Gs^Fds, Rd, Rd, Rd, Gs^Fds, Rd, Gs^Fds, Rd, Rd, Ds, Ds, Ds
Mm, Mm, Mm, Mm, Mm, Mm, Hh, Hh, Hh^Fms, Hh^Fp, Hh^Fms, Gs^Fds, Gs^Fds, Gs^Fds, Gs^Vl, Gs^Fds, Gs^Fds, Gg, Gg^Es, Rd, Rd, Rd, Gg, Rd, Gg, Gg, Gg, Ds, Ds
Mm, Mm, Mm, Mm, Mm, Mm, Hh, Hh, Hh, Hh, Gs^Fds, Gs^Fds, Gs^Fds, Gs^Fms, Gs^Fds, Gs^Fds, Gs^Fds, Gg, Rd, Rd^Es, Rd, Gs^Fds, Gs^Fds, Gs^Fds, Gs^Fds, Gg, Gg, Ds, Ds
Mm, Mm, Mm, Mm, Mm, Mm, Hh, Hh^Fet, Hh, Gg, Gs^Fds, Gs^Fds, Gs^Fds, Gs^Fds, Gs^Fds, Gs^Fds, Gs^Fds, Gs^Fds, Rd, Rd^Es, Gs^Fds, Gs^Fds, Gs^Fms, Gs^Fds, Gs^Fds, Gs^Vht, Ds, Ds, Ds
Mm, Mm, Mm, Mm, Mm, Mm, Gg, Gg^Fms, Gs^Fds, Gg^Es, Gg, Gs^Fds, Gs^Fds, Gs^Fds, Rd, Gs^Fds, Rd, Gg, Rd, Rd, Gs^Fds, Gs^Fds, Gs^Fds, Gs^Fds, Gg, Gs^Vl, Ds, Ds, Ds
Mm, Mm, Mm, Mm, Hh^Fp, Hh^Fp, Gs^Fds, Gs^Fds, Gs^Fds, Gs^Fds, Gs^Fds, Gs^Fds, Rd, Rd, Gs^Vl, Rd, Gs^Fds, Rd, Rd, Rd, Gs^Fds, Gs^Fds, Gg^Fet, Gs^Fds, Ds, Gg, Ds, Ds, Ww
Mm, Mm, Mm, Mm, Gs^Vh, Gs^Fds, Gs^Fds, Gs^Fds, Gs^Fds, Gs^Fds, Rd, Rd, Gs^Fds, Gs^Fds, Gs^Fds, Gs^Fds, Gs^Fds, Gs^Fds, Gs^Fds, Rd, Rd, Gg, Gg^Es, Ds^Es, Ds, Ds, Ds, Ds, Ww
Mm, Mm, Mm, Hh, Gs^Fds, Rb^Gvs, Rb^Gvs, Gs^Fds, Gs^Fds, Rd, Gg, Gs^Fds, Gs^Fds, Gs^Fds, Gs^Fds, Gs^Fds, Gs^Fds, Gs^Fds, Gs^Fds, Gs^Fds, Rd, Rd, Rd, Ds, Ds, Ds, Ds, Ds, Ww
Mm, Mm, Mm, Hh, Gs^Fds, Gs^Fds, Gs^Fds, Gs^Fds, Rd, Rd, Gs^Fds, Gs^Fds, Gs^Fds, Gs^Fds, Gs^Fds, Gs^Fds, Gs^Fds, Gs^Fds, Gs^Fds, Gs^Fds, Gg, Rd, Rd, Rd, Ww, Ds, Ds, Ds, Ww
Mm, Mm, Mm, Gs^Vl, Gs^Fds, Gs^Fds, Gs^Fds, Gs^Fds, Rd, Gs^Fms, Gs^Fds, Gs^Fds, Rb^Gvs, Rb^Gvs, Rb^Gvs, Gs^Fds, Gs^Fds, Gs^Fds, Gs^Fms, Gg, Gg, Rd, Rd, Ww, Ww, Ww, Ww, Ww, Ww
Mm, Mm, Mm, Gs, Gs^Fds, Gs^Fds, Gs^Fds, Gs^Fds, Rd, Gs^Fms, Gs^Fds, Gs^Fds, Gs^Fds, Rb^Gvs, Gs^Vht, Rb^Gvs, Gs^Fds, Gg, Gs^Fms, Gg, Gg, Rd, Ds, Ds, Ww, Ww, Ww, Ww, Wo
Hh, Hh, Hh^Es, Gs, Gs^Fds, Gs^Fds, Gs^Fds, Rd, Gs^Fds, Gs^Fds, Gs^Fds, Gs^Fds, Gs^Fds, Rb^Gvs, Gs^Fds, Rb^Gvs, Gs^Fds, Gg, Gg^Fet, Gg, Gs^Fds, Ds, Ds, Ds, Ww, Ww, Ww, Ww^Vm, Wo
Hh, Hh, Hh^Es, Gs^Fds, Gs^Fds, Gs^Fds, Rd^Es, Rd, Gs^Fds, Gs^Fds, Gs, Gs, Gg, Gs^Fds, Gs, Gs^Fds, Gs^Es, Gs^Fds, Gg, Gg, Ds, Ds, Ds, Ds, Ww, Ww, Wo, Wo, Wo
Hh, Hh, Gs, Gs^Fds, Gs^Fds, Gs^Fds, Rd^Es, Gs, Gs^Es, Gs, Gs^Fms, Gs^Fds, Gs^Fds, Gs^Fds, Gs^Fds, Gs^Es, Gs^Fds, Gs^Fds, Gg, Gg^Es, Ds, Ds, Ds, Ww, Ww, Ww, Wo, Wo, Wo
Gs, Gs, Gs^Fds, Gs^Fds, Rd, Gs^Fds, Rd^Es, Gs^Es, Hh^Es, Hh^Fms, Hh^Fms, Gs^Es, Gg^Es, Gs^Fds, Gs^Fds, Gs^Fds, Gs^Fds, Gg, Gg, Ds, Ds, Ds, Ww, Ww, Wwr, Wwr, Wo, Wo, Wo
Gs^Es, Gs, Gs^Fds, Ce, Ce, Ce, Gs^Fms, Gs, Hh^Es, Hh^Es, Gs^Es, Gs^Vht, Gs^Fds, Gs^Fds, Gs^Fds, Gs^Fds, Gs, Gs, Gg, Ds, Ds, Ds, Ww, Ww, Ww, Ww^Vm, Wo, Wo, Wo
Gs^Fds, Gs^Es, Gs, 1 Ke, Ce, Ce, Gs, Gg^Es, Gg^Es, Hh^Es, Gg^Es, Gg^Es, Gg^Es, Gs^Fds, Gs^Fds, Gs, Gg, Gs^Fds, Gg, Ds, Ds, Ds, Ww, Ww, Wo, Wo, Wo, Wo, Wo
Gs^Fds, Gg, Gs^Fds, Rd, Gg, Gg, Gg, Gs^Fds, Gs^Fds, Gg, Gg, Gg^Es, Gg^Es, Gg, Gg, Gs^Fds, Gg, Gg, Gg, Ds, Ds, Ds, Ww, Ww, Wo, Wo, Wo, Wo, Wo
