Wot, Wot, Wot, Wot, Wot, Wot, Wot, Wot, Wot, Wot, Wot, Wot, Wot, Wot, Wot, Wot, Wot, Wot, Wot, Wot, Wot, Wot, Wot, Wot, Wwt, Wwt, Wwt, Wwt, Gg, Gg, Gg, Gg, Gs^Fds, Gs^Fds, Gll^Fp, Gs^Fds
Wot, Wot, Wot, Wot, Wot, Wot, Wot, Wot, Wot, Wot, Wot, Wot, Wot, Wot, Wot, Wot, Wot, Wot, Wot, Wot, Wot, Wot, Wwt, Wwt, Wwt^Vm, Wwt, Wwt, Wwt, Gg, Gg, Gg, Gs^Fds, Gs^Fds, Gs^Fms, Gs^Fms, Gll^Fp
Wot, Wot, Wot, Wot, Wot, Wot, Wot, Wot, Wot, Wot, Wot, Wot, Wot, Wot, Wot, Wot, Wot, Wot, Wot, Wot, Wwt, Wwt, Wwt, Wwt, Wwt, Wwt, Wwt, Wwt, Gg, Gg, Gg, Gg, Gg, Gs^Fds, Gs^Fms, Gs^Fds
Wot, Wot, Wot, Wot, Wot, Wot, Wot, Wot, Wot, Wot, Wot, Wot, Wot, Wot, Wot, Wot, Wot, Wot, Wot, Wwt, Wwt, Wwt, Gs^Fms, Wwt, Wwt, Wwt, Wwf, Wwf, Gg, Gg, Gg, Gs^Vl, Gs^Fms, Gg, Gs^Fms, Gs^Fms
Wot, Wot, Wot, Wot, Wot, Wot, Wot, Wot, Wot, Wot, Wot, Wot, Wot, Wot, Wot, Wot, Wot, Wot, Ww^Vm, Wwt, Wwt, Gs^Fds, Gll^Fp, Gs^Fds, Gs^Fds, Wwt, Gg, Ss, Ss, Gg, Gg, Gg, Gg, Gg, Gs^Fds, Gs^Fms
Wot, Wot, Wot, Wot, Wot, Wot, Wot, Wot, Wot, Wot, Wot, Wot, Wot, Wot, Wot, Wot, Wot, Wot, Wwt, Wwt, Wwt, Gs^Fms, Gs^Fds, Gs^Fms, Gs^Fds, Gg, Gg, Ss^Vhs, Ss, Gg, Gg, Gg, Gg, Gs^Fds, Gs^Fms, Gs^Fds
Wot, Wot, Wot, Wot, Wot, Wot, Wot, Wot, Wot, Wot, Wot, Wot, Wot, Wot, Wot, Wot, Wot, Wot, Wwt, Wwt, Wwt, Ds, Gg, Gs^Fms, Gg, Gg, Gg, Gg, Gg, Gg, Gg, Gg, Rb^Gvs, Gs^Fds, Gs^Fds, Gs^Fds
Wot, Wot, Wot, Wot, Wot, Wot, Wot, Wot, Wot, Wot, Wot, Wot, Wot, Wot, Wwt^Zpoo, Wwt^Zpoo, Wwt^Zpoo, Wot, Wwt, Wwt, Wwt^Bw\, Ds, Ds, Gg, Gg, Gg, Gg, Gg, Gg, Gg, Rb^Gvs, Rb^Gvs, Rb^Gvs, Rb^Gvs, Rb^Gvs, Gg
Wot, Wot, Wot, Wot, Wot, Wot, Wot, Wot, Wot, Wot, Wot, Wot, Wwt^Zdek, Wwt^Zdek, Wwt^Zdek, Wwt^Zpoo, Wwt^Zpoo, Wwt^Zpoo, Wwt, Wwt, Ds, Ds^Bw\, Ds, Gg, Gg, Gg, Gg, Gg, Rb^Gvs, Rb^Gvs, Rb^Gvs, Rb^Gvs, Rb^Gvs, Rb^Gvs, Gg, Gg
Wot, Wot, Wot, Wot, Wwt, Wot, Wot, Wot, Wot, Wot, Wwt^Zdek, Wwt^Zdek, Wwt^Zdek, Wwt^Zdek, Wwt^Zdek, Wwt^Zdek, Wwt^Bw\, Wwt, Wwt, Wwt, Ds, Ds, Gg, Gg^Vh, Gg, Gg^Vh, Gg, Gg, Gg, Rb^Gvs, Gg, Gg, Gg, Gg, Gg, Gg
Wot, Wot, Wot, Wwt, Wwt^Vm, Wwt, Wot, Wot, Wwt^Zfoc, Wwt^Zdek, Wwt^Zdek, Wwt^Zdek, Wwt^Zdek, Wwt^Zdek, Wot^Zpie, Wot, Wwt, Wwt^Bw\, Wwt^Bw\, Ds, Ds, Ds, Gg, Gg, Gg, Gg, Gg, Gg, Gg^Vhh, Gg, Gg, Gg, Gg, Gg, Gg, Gg
Wot, Wot, Wot, Wwt, Wot, Wot, Wot, Wwt^Zfoc, Wwt^Zfoc, 1 Wwt^Zfoc, Wwt^Zfoc, Wwt^Zdek, Wwt^Bw\, Wot, Wwt, Wwt, Wwt, Wwt, Ds, Ds, Ds, Gg, Gg, Gg, Ch, Gg, Gg, Gg, Gg, Gg, Gg, Gg, Ce, Gg, Gg, Gg
Wot, Wot, Wot, Wot, Wot, Wot^Zrig, Wot^Zral, Wwt^Zfoc, Wot^Zhul, Wwt^Zfoc, Wot, Wot, Wot, Wwt^Bw\, Wwt^Bw\, Wwt, Ds, Ds, Ds, Ds, Gg, Gg, Gg, Gg, Ch, Ch, Gg, Gg, Wwt, Gg, Gg, Gg, Ce, Ce, Gg, Gg
Wot, Wot, Wot, Wot, Wot, Wot, Wot, Wot, Wot, Wot, Wot, Wot, Wwt, Wwt^Vm, Wwt, Wwt^Bw\, Ds, Ds, Gg, Gg, Gg, Gg, Ch, Gg, Kh, Gg, Gg, Wwt, Wwt, Gg^Vh, Gg, Gg, Rrc, Gg, Rrc, Gg
Wot, Wot, Wot, Wot, Wot, Wot, Wot, Wot, Wot, Wot, Wwt, Wwt, Wwt^Bw\, Wwt, Wwt, Ds, Ds, Ds, Gg, Gg, Gg, Ch, Ch, 2 Kh, Kh, Gg, Gg, Gg, Gg, Gg^Vh, Rrc, Rrc, Rrc, Rrc, Gg, Rrc
Wot, Wot, Wot, Wot, Wot, Wot, Wot, Wot, Wot, Wot, Wwt, Wwt, Wwt, Wwt^Bw\, Ds, Ds, Ds, Gg, Gg, Gg, Gg, Gg, Gg, Gg, Ch, Gg, Gg, Gg, Gg, Rrc, Gg, Gg, Ce, Gg, Gg, Gg
Wot, Wot, Wot, Wot, Wot, Wot, Wot, Wot, Wwt, Wwt, Gg, Ds, Ds, Ds, Ds, Ds, Gg, Gg, Gg, Gg, Gg, Gg, Gg, Gg, Ch, Ch, Gg, Gg, Rrc, Rrc, Gg, Gg, Ce, Ce, Gg, Gg
Wot, Wot, Wot, Wot, Wot, Wot, Wwt, Wwt, Wwt, Gg, Gs^Vht, Gg, Gg, Ds, Gg, Gg, Gg, Gg, Gg^Vh, Gg, Gg, Gg, Gg, Gg, Gg, Rrc, Rrc, Rrc, Gg, Gg, Gg, Gg, Gg, Gg, Gg, Gg
Wot, Wot, Wwt^Vm, Wwt, Wwt, Wwt, Wwt, Wwt, Wwt, Gg, Gg, Gg, Gg, Gg, Gg, Gg, Gg, Gg, Gg, Gg^Vh, Gg, Gg, Gg^Vhh, Gg, Rrc, Rrc, Gg^Vh, Gg^Vh, Gg, Gg, Gg, Gg, Rb^Gvs, Gg, Gg, Gg
Wwt, Wwt, Wwt, Wwrt, Wwt, Wwt, Wwt, Wwt, Wwt, Gg, Gg, Gg, Gg, Gg, Gg, Ce, Ce, Gg, Rrc, Rrc, Rrc, Gg, Gg, Gg, Rrc, Gg, Gg, Gg, Rb^Gvs, Gg, Rb^Gvs, Rb^Gvs, Rb^Gvs, Rb^Gvs, Gg, Gg
Wwt, Wwt, Wwt, Wwt, Wwt, Wwt, Ds, Wwt, Gg, Gg, Gg, Gg, Gg, Gg, Gg, Ce, Gg, Rrc, Rrc, Gg, Gg, Rrc, Rrc, Rrc, Gg, Gg, Gg, Rb^Gvs, Rb^Gvs, Rb^Gvs, Rb^Gvs, Rb^Gvs, Rb^Gvs, Rb^Gvs, Gg, Gg
Wwt, Wwt, Wwt, Wwt, Ds, Ds, Gg, Gg, Gg, Gg, Gg, Gg, Gg, Gg, Gg, Gg, Re, Rrc, Gg, Ce, Ce, Gg, Gg, Gg, Gg, Gg, Gg, Gg, Gg, Rb^Gvs, Rb^Gvs, Rb^Gvs, Gg, Gg, Gg, Gg
Wwt, Wwt, Wwt, Ds, Ds, Ds, Gg, Gg, Gg, Gg, Gg, Gg, Gg, Gg, Gg, Gg, Re, Gg, Gg, Ce, Gg, Gg, Gg, Gg, Gg, Gg, Rb^Gvs, Gg, Gg, Gg, Gg, Gg, Gg, Gs^Vl, Gs^Fds, Gs^Fms
Wwt, Wwt, Ds, Ds, Ds, Gg, Gg, Gg, Gg, Gg, Gg, Gg, Gg, Gg, Gg, Gg, Re, Gg, Gg, Gg, Gg, Gg, Gg, Gg, Rb^Gvs, Rb^Gvs, Rb^Gvs, Rb^Gvs, Gg, Gg, Gs^Fms, Gg, Gs^Fms, Gs^Fds, Gll^Fp, Gll^Fp
Wwt, Wwt, Ds, Ds, Ds, Ds^Vht, Gg, Gg, Gg, Gg, Gg, Gg, Gg, Gg, Gg, Gg, Re, Gg, Gg, Gg, Gg, Gg, Gg, Rb^Gvs, Rb^Gvs, Rb^Gvs, Rb^Gvs, Rb^Gvs, Gg, Gs^Fds, Gs^Fms, Gs^Fms, Gs^Fms, Gs^Fds, Gll^Fp, Gll^Fp
Wwt, Wwt, Ds, Ds, Ds, Gg, Gg, Gg, Gg, Gg, Gg, Gg, Gg^Vc, Gg, Re, Re, Gg, Re, Rb^Gvs, Rb^Gvs, Rb^Gvs, Gg, Gg, Rb^Gvs, Gs^Fds, Gs^Fds, Gs^Fms, Gg, Gg, Gg, Gg, Gs^Fms, Gll^Fp, Gs^Fms, Gll^Fp, Gll^Fp
Wwt, Ds, Ds, Ds, Ds, Gg, Gg, Gg, Gg, Gg, Gg, Gg, Gg, Re, Gg, Gg, Gg, Rb^Gvs, Rb^Gvs, Rb^Gvs, Rb^Gvs, Rb^Gvs, Gg, Gg, Gs^Fms, Gs^Fds, Gs^Fds, Gs^Fms, Gs^Fds, Gs^Vl, Gg, Gs^Fds, Gs^Fms, Gll^Fp, Gll^Fp, Gll^Fp
Ds, Ds, Ds, Ds, Ds, Gg, Gg, Gg, Gg, Gg, Gg, Gg, Re, Re, Gg, Gg, Gg, Gg, Gg, Rb^Gvs, Gg, Rb^Gvs, Gg, Gs^Fds, Gs^Fds, Gg, Gg, Gs^Fms, Gs^Fds, Gg, Gg, Gg, Gs^Fds, Gs^Fms, Gll^Fp, Gll^Fp
