Gs^Fds, Gs^Fds, Gs^Fds, Gs^Fds, Gs^Fds, Gs^Fds, Gs^Fds, Gs^Fds, Gs^Fds, Gs^Fds, Gs^Fds, Gs^Fds, Gs^Fms, Gs^Fms, Gs^Fds, Gs^Fds, Gs^Fms, Gs^Fms, Gs^Fms, Gs^Fds, Gs^Fds, Gs^Fds, Gs^Fms, Gs^Fds, Gs^Fds, Gs^Fds, Gg, Gg, Gg, Gg, Gg, Gg, Gg, Gg, Gg, Gg, Gg, Gg, Gg, Gg, Gg, Gg, Gg, Gg, Gg, Wwt, Gg, Gg, Gg, Gg, Gg, Gg, Gg, Gg, Gg
Gs^Fds, Gs^Fds, Gs^Fds, Gs^Fds, Gs^Fds, Gs^Fds, Gg^Ve, Gs^Fds, Gs^Fds, Gs^Fds, Gs^Fds, Gs^Fds, Gs^Fms, Gs^Fms, Gs^Fds, Gs^Fds, Gs^Fms, Gs^Fms, Gs^Fms, Gs^Fds, Gs^Fds, Gs^Fms, Gs^Fms, Gs^Fms, Gg^Efm, Gs^Fds, Gg, Gg, Gg, Gg, Gg, Gg^Efm, Gg^Efm, Gg^Efm, Gs^Fds, Gs^Fds, Gg, Gg, Gg, Gg, Gs, Gg, Gg, Gg, Wwt, Wwt, Gg, Gg, Gg, Gg, Gs, Gg, Gs, Gg, Gg
Gs^Fds, Gs^Fds, Gs^Fds, Gs^Fds, Gs^Fds, Gs^Fds, Gs^Fds, Gs^Fds, Gs^Fds, Gs^Fds, Gs^Fds, Gs^Fds, Gs^Fms, Gs^Fms, Gs^Fds, Gs^Fds, Gs^Fms, Gs^Fms, Gs^Fms, Gs^Fds, Gg^Ve, Gs^Fds, Gs^Fds, Gs^Fds, Gg^Efm, Gg, Gg, Gg, Gg, Gg, Gg, Gg, Gs^Fds, Gs^Fds, Gs^Fds, Gg^Efm, Gg, Gs, Gs, Gg, Gs^Vh, Gg, Wwt, Wwt, Gg, Gg, Ce, Gg, Ce, Gg, Gs, Gs, Hh, Gg, Hh
Gs^Fds, Gs^Fds, Gs^Fds, Gs^Fds, Gs^Fds, Gs^Fds, Gs^Fds, Gs^Fds, Gs^Fds, Gs^Fds, Gs^Fds, Gs^Fds, Gs^Fms, Gs^Fms, Gs^Fds, Gs^Fds, Gs^Fms, Gs^Fms, Gs^Fms, Gs^Fds, Gs^Fds, Gs^Fds, Gs^Fds, Gg, Gg, Gg, Gg, Gg, Gg, Gg, Gg, Gg, Gg, Gg^Ve, Gg, Gg, Gg, Gs, Gg, Gg, Gg, Gg, Wwt, Gg, Gg, Ce, Ce, 2 Ke, Ce, Gg, Gg, Hh, Hh, Hh, Hh
Gs^Fds, Gs^Fds, Gg^Efm, Gs^Fds, Gs^Fms, Gs^Fds, Gs^Fms, Gs^Fds, Gg^Efm, Gg^Ve, Gs^Fms, Gll^Fp, Gll^Fp, Gs^Fms, Gs^Fds, Gs^Fds, Gs^Fms, Gll^Fp, Gs^Fms, Gs^Fds, Gs^Fds, Gs^Fds, Gs^Fds, Gg, Gg^Efm, Gg, Gg, Gg, Gg, Gg, Gg, Gg, Gg, Gg, Gg, Gg, Gg, Gg, Gg, Gg, Gg, Gg, Wwt^Bw/, Gg, Gg, Ce, Gs, Gs, Gs, Gg, Gs, Gg, Gg, Gg, Gg
Gs^Fds, Gs^Fds, Gs^Fms, Gs^Fds, Gll^Fp, Gs^Fms, Gs^Fms, Gs^Fms, Gs^Fds, Gs^Fds, Gs^Fms, Gll^Fp, Gs^Fms, Gs^Fms, Gs^Fds, Gs^Fds, Gs^Fds, Gs^Fds, Gs^Fds, Gs^Fds, Gs^Fds, Gs^Fds, Gg, Gg, Gg, Gg, Gg, Gg, Gg, Gg, Gg, Gg, Gg, Gg, Gg, Gg, Gg, Gg, Gg, Gg, Gg, Gg, Gg, Wwt, Wwt, Gg, Gg, Gs, Gg, Gs, Hh, Gs, Hh, Gg, Gg
Gs^Fds, Gs^Fds, Gs^Fms, Gll^Fp, Gll^Fp, Gll^Fp, Gs^Fms, Gs^Fms, Gs^Fds, Gs^Fds, Gs^Fds, Gs^Fds, Gs^Fds, Gs^Fds, Gg^Efm, Gs^Fds, Gg^Efm, Gg^Efm, Gg^Efm, Gg^Efm, Gg, Gg, Gg, Gg, Gg, Gg, Gg, Gg, Gs, Gs, Gg, Gg, Gg, Gg, Gg, Gg, Hh, Gg, Gg, Hh, Gg, Gg, Hh, Gg, Ww, Hh, Hh, Gg, Hh, Hh, Hh, Hh^Vhh, Mm, Hh, Hh
Gs^Fds, Gs^Fds, Gs^Fms, Gs^Fms, Gs^Fms, Gs^Fms, Gs^Fms, Gs^Fms, Gs^Fds, Gs^Fds, Gg^Efm, Gs^Fds, Gg, Gg, Gg^Efm, Gg, Gg, Gg, Gg, Gg, Gg, Gg, Gg, Gg, Gg, Gs, Gs, Gs, Gg, Gg, Gs^Fds, Gs^Fds, Gg, Gg, Gg, Gg, Hh, Hh, Hh, Gg, Hh, Hh, Hh, Hh, Ww, Xue, Xue, Hh, Xue, Xue, Xue, Hh, Hh, Mm, Hh
Gs^Fds, Gs^Fds, Gs^Fds, Gs^Fds, Gs^Fms, Gs^Fms, Gs^Fds, Gs^Fds, Gg^Efm, Gg^Efm, Gg, Gg, Gg^Efm, Gg, Gs^Fds, Gg, Gg, Gg, Gg^Efm, Gg, Gs^Fds, Gs^Fds, Gg, Gg, Gg, Gg, Gg, Gg, Gg, Gg, Gg, Gg, Gg, Gg, Gg, Gg, Gg, Gg, Hh, Hh, Hh, Hh, Xue, Xue, Uh, Wwg, Xue, Xue, Xue, Xue, Xue, Xue, Xue, Hh, Hh
Gg^Efm, Gs^Fds, Gs^Fds, Gs^Fds, Gs^Fds, Gs^Fds, Gs^Fds, Gs^Fds, Gg, Gg, Gg, Gg, Gg, Gs^Fds, Gg^Efm, Gs^Fds, Gg^Efm, Gg, Gg, Gs^Fds, Gs^Fds, Gs^Fms, Gg^Efm, Gs^Vl, Gg, Gg, Gg, Gg, Gg, Gg, Gg, Gg, Gg, Gg, Gg, Gg, Gg, Hh, Xue, Hh, Xue, Xue, Uh^Emf, Uu^Uf, Rb, Wwg, Wwf, Uue^Dr, Uue^Dr, Uh^Dr, Xue, Xue, Xue, Hh, Hh
Gg, Gg^Efm, Gg^Efm, Gg^Efm, Gg, Gg, Gg, Gg, Gs^Vl, Gg, Gg, Gg, Gg, Gg, Gg, Gg^Efm, Gg, Gg^Efm, Gg, Gg^Efm, Gg, Gs^Fds, Gg, Gg, Gg, Gg, Gg, Gg, Gg, Gg, Gg, Gg, Gg, Gg, Gg, Gg, Gg, Xue, Uh, Xue, Uue^Vu, Xue, Uu^Uf, Rb^Emf, Uh, Rb, Wwf^Dr, Wwf^Dr, Uu, Uh^Dr, Xue, Xue, Xue, Xue, Xue
Gg, Gg^Efm, Gg, Gg, Gg, Gg, Gg, Gg, Gs, Gg, Gg, Gg, Gg, Gg, Gg, Gg, Gg, Gg, Gg, Gg, Gg, Gg, Gg^Efm, Gg, Gs^Fms, Gs^Fds, Gg^Efm, Gs^Fds, Gg, Gg, Gg, Re^Vct, Gg, Gs, Gg, Gg, Rb, Rb, Uue, Uue, Uue, Uu^Uf, Uh, Uh, Uu^Uf, Uh^Dr, Rb^Emf, Wwf, Uu^Uf, Uh, Uh, Xue, Xue, Xue, Xue
Gg, Gg, Gg, Gg, Gg, Gg, Gg, Gg, Gs, Gs, Gg, Gg, Gg, Gg, Gg, Gg, Gg, Gs, Gs, Gs, Gs, Gg, Gs^Fds, Gg^Efm, Gs^Fds, Gs^Fds, Gs^Fds, Gg^Efm, Gg, Gg, Gg, Gg, Gg, Gs, Gg, Xue, Xue, Uue, Rb, Rb, Rb, Uue, Rb, Uh, Uue, Uu^Uf, Rb^Emf, Wwg, Uu^Uf, Uu^Vu, Uh^Emf, Uh, Xue, Xue, Xue
Gg, Gg, Gg, Gg, Gg, Gg, Gg, Gg, Gg, Gs, Gg, Gg, Gg, Gg, Gg, Gg, Gg, Gs, Gs, Gg, Gg, Gg, Gg, Gg, Gg, Gg^Efm, Gg, Gs^Fds, Gs^Fds, Gg, Gs, Gg, Gg, Gg, Gg, Xue, Xue, Xue, Xue, Xue, Xue, Uue^Dr, Uue^Dr, Uh, Uue, Uue, Rb, Qxe, Uue, Uu, Uu, Xue, Xue, Xue, Xue
Gg, Gg^Efm, Gg^Efm, Gg, Gg, Gg, Gg, Gg, Gg, Gg, Gg, Gg, Gg, Gg, Gg, Gg, Gg, Gg, Gs, Gs, Gg, Gg, Gg, Gg, Gg, Gg, Gg, Gs^Fds, Gg, Gs, Gs, Gg, Gg, Gg, Hh, Xue, Xue, Xue, Hh, Xue, Xue, Xue, Uh, Xue, Xue, Uh, Uue, Uue, Uu^Uf, Uue, Uh, Xue, Xue, Xue, Xue
Gg, Gg^Efm, Gs^Fds, Gg, Gg, Gg, Gg, Gg, Gg, Gg, Gg, Gg, Gg, Gg, Gg, Gs, Gg, Gg, Gg, Gg, Hh, Gg, Gg, Gg, Gg, Gg, Gg, Gg, Gg, Gs, Gs, Gg, Gg, Gg, Hh, Hh, Hh, Hh, Hh, Xue, Xue, Xue, Xue, Uue, Xue, Uue^Vud, Uue, Rb, Uu^Uf, Uh, Uh, Xue, Xue, Xue, Xue
Gs^Fds, Gs^Fds, Gs^Fds, Gg, Gs^Vh, Gg, Gg, Gg, Gg, Gg, Gg, Gg, Gg, Gg, Gg, Gg, Gg, Gg, Gg, Gg, Gg, Hh, Gg, Gg, Gg, Gg, Gs, Gs, Gs, Gs, Gs, Gg, Gg, Gg, Hh, Hh, Hh, Gs, Gs, Xue, Xue, Xue, Mm, Mm, Mm, Xue, Xue, Uue, Rb, Uh, Uue, Xue, Xue, Xue, Xue
Gg, Gg, Gg, Gg, Gs, Gs, Gs, Gg, Gg, Hh, Hh, Gg, Hh, Gg, Hh, Hh, Hh, Gg, Gg, Gg, Gg, Gg, Gg, Gg, Gg, Gg, Gg, Gg, Gg, Gg, Gg, Gg, Gg, Hh, Hh, Mm, Hh, Hh, Hh, Hh, Hh, Hh, Mm, Mm, Mm, Mm, Xue, Uh, Uue, Rb, Rb, Xue, Xue, Xue, Xue
Gg, Gg, Gg, Gg, Gs, Gs, Gg, Gg, Gg, Hh, Hh, Gg, Gg, Hh, Gg, Hh, Gg, Gg, Gs, Gs, Gg, Gg, Hh, Hh, Hh, Gg, Hh, Gg, Gg, Hh, Hh, Gg, Hh, Hh, Hh, Mm, Mm, Mm, Mm, Hh, Hh, Hh, Hh, Mm, Mm, Mm, Xue, Xue, Uh, Uue, Rb, Uue, Rb, Xue, Xue
Gg, Gg, Gg, Gs, Gg, Gs, Gg, Gg, Gg, Gg, Gg, Gg, Gg, Gg, Gg, Gg, Gs, Gg, Gs^Vh, Hh, Hh, Hh, Hh, Mm, Mm, Hh, Hh, Gg, Gg, Gg, Gg, Gg, Hh, Hh, Hh, Mm, Mm, Mm, Mm, Mm, Hh, Hh, Hh, Hh, Hh, Mm, Mm, Xue, Xue, Uh, Uh, Uh, Rb, Xue, Uue
Gg, Gg, Gg, Gg, Gg, Gg, Gg, Gg, Gg, Gg, Gg, Gg, Gg, Gg, Gg, Gs, Gs, Gs, Gg, Hh, Gg, Hh, Hh, Hh, Hh, Hh, Gg, Hh, Gg, Gg, Hh, Hh, Hh, Hh, Hh, Mm, Mm, Mm, Hh, Mm, Mm, Hh, Hh, Hh, Hh, Mm, Mm, Mm, Xue, Xue, Xue, Xue, Xue, Uue, Xue
Gg, Gg, Gg, Gg, Gg, Gg, Gg, Gg, Gg, Gg, Gs, Gs, Gs, Gs, Gs, Gs, Gg, Gg, Gg, Gg, Gg, Gg, Gg, Gg, Gg, Gg, Gg, Gg, Hh, Hh, Gg, Gg, Gs, Hh, Hh, Mm, Mm, Mm, Hh, Mm, Mm, Hh^Vhh, Mm, Hh, Hh, Hh, Hh, Hh, Hh, Xue, Xue, Xue, Xue, Xue, Xue
Gg, Gg, Gg, Gg, Ce, Ce, Ce, Gg, Gg, Gg, Gg, Gs, Gg, Gg, Hh, Gg, Gg, Gg, Gg, Gg, Gg, Gg, Gg, Gg, Gg, Gg, Hh, Hh, Hh, Hh, Hh, Gs, Mm, Gs, Hh, Mm, Mm, Mm, Mm, Mm, Mm, Mm, Mm, Mm, Hh, Hh, Hh, Hh, Hh, Hh, Hh, Hh, Hh, Xue, Hh
Gg, Gg, Gg, Gg, Ce, 1 Ke, Ce, Gg, Gg, Gg, Gg, Gg, Hh, Hh, Gg, Gg, Hh, Gg, Hh, Hh, Hh, Hh, Hh, Hh, Hh, Hh, Hh, Hh, Mm, Hh, Mm, Mm, Mm, Mm, Hh, Mm, Mm, Mm, Mm, Mm, Hh, Hh, Mm, Mm, Mm, Hh, Mm, Hh, Mm^Vhh, Hh, Hh, Hh, Hh, Hh, Hh
Gg, Gg, Gg, Gg, Gg, Ce, Gg, Gg, Gg, Gg, Gg, Gg, Hh, Gg, Hh, Hh, Hh, Hh, Hh, Hh, Gg, Gg, Hh, Hh, Mm, Mm, Mm, Mm, Mm, Mm, Hh, Mm, Mm, Mm, Hh, Mm, Mm, Mm, Mm, Mm, Mm, Mm, Mm, Mm, Mm, Mm, Mm, Mm, Mm, Mm, Hh, Gs, Gs, Hh, Hh
Gg, Gs^Vl, Gs, Gg, Gg, Gg, Gg, Gg, Gg, Gg, Hh, Hh, Hh, Hh, Mm, Hh, Mm, Mm, Mm, Hh, Hh, Hh, Mm, Mm, Mm, Mm, Mm, Mm, Mm, Mm, Hh, Hh, Mm, Mm, Hh, Hh, Mm, Mm, Mm, Mm, Mm, Mm, Mm, Mm, Mm, Mm, Mm, Mm, Mm, Mm, Mm, Hh, Hh, Hh, Mm
Gg, Gg, Gs, Gs, Gs, Gs, Gg, Gg, Hh, Hh, Hh, Hh, Hh, Mm, Hh, Hh, Hh, Mm, Hh, Hh, Hh, Hh, Hh, Mm, Hh, Mm, Hh, Hh^Vhh, Hh, Hh, Hh, Mm, Mm, Mm, Hh, Hh, Hh, Mm, Hh, Mm, Hh, Mm, Mm, Mm, Mm, Mm, Hh, Mm, Hh, Mm, Hh, Hh, Hh, Mm, Mm
Gg, Gg, Hh, Hh, Hh, Gg, Gg, Gg, Hh, Hh, Hh, Hh, Hh, Hh, Hh, Hh, Hh, Hh, Hh, Mm, Mm, Hh, Hh, Hh, Hh, Hh, Hh, Hh, Hh, Hh, Mm, Mm, Mm, Mm, Mm, Hh, Hh, Hh, Hh, Hh, Hh, Hh, Mm, Mm, Mm, Hh, Hh, Hh, Hh, Hh, Hh, Hh, Mm, Mm, Mm
