Xue, Xue, Xue, Xue, Xue, Xue, Xue, Xue, Xue, Xue, Xue, Xue, Xue, Xue, Xue, Xue, Xue, Xue
Xue, Xue, Xue, Xue, Xue, Xue, Xue, Xue, Xue, Xue, Xue, Xue, Xue, Xue, Uue, Xue, Xue, Xue
Xue, Xue, Xue, Xue, Xue, Xue, Xue, Xue, Xue, Xue, Xue, Xue, Xue, Uue, Uue, Xue, Xue, Xue
Uue, Xue, Xue, Xue, Xue, Xue, Xue, Xue, Urb, Urb, Urb, Urb, Urb, Uue, Xue, Xue, Xue, Xue
Xue, 1 Uue, Uue, Xue, Xue, Xue, Xue, Urb, Urb, Urb, Urb, Urb, 2 Urb, Urb, Urb^Ii, Xue, Xue, Xue
Xue, Xue, Xue, Uue, Uue, Uue, Uue, Urb, Urb, Urb, Urb, Urb, Urb, Urb, Urb, Xue, Xue, Xue
Xue, Xue, Xue, Uue, Uue, Xue, Xue, Uue, Uue, Urb, Urb, Urb, Urb, Urb, Xue, Xue, Xue, Xue
Xue, Xue, Xue, Uue, Xue, Xue, Xue, Uue, Uue, Uue, Uue, Urb, Urb, Urb, Xue, Xue, Xue, Xue
Xue, Xue, Xue, Xue, Xue, Xue, Xue, Xue, Xue, Uue, Xue, Urb, Xue, Xue, Xue, Xue, Xue, Xue
Xue, Xue, Xue, Xue, Xue, Xue, Xue, Xue, Xue, Xue, Xue, Xue, Xue, Xue, Xue, Xue, Xue, Xue
