Wot, Wot, Wot, Wot, Wot, Wot, Wwt, Wwt, Wwt, Wwt, Wwt, Wwt, Wwt, Wot, Wot, Wot, Wwt, Wwt, Wwt, Wwt, Wwt, Wwt, Wwt, Wwt, Wwt, Wwt, Wwt, Wot, Wot, Wot, Wot, Wot, Wot, Wot, Wot, Wot, Wot, Wot, Wot, Wot, Wot, Wot, Wot, Wot
Wot, Wot, Wwt, Wot, Wwt, Wwt, Wwt, Wwt, Wwt, Wwt, Wwt, Wwt, Wwt, Wwt, Wwt, Wwt, Wwt, Wwt, Wwt, Wwt, Hh^Fds, Hh^Fms, Wwt, Wwt, Wwt, Wwt, Wwt, Wwt, Wwt, Wwt, Wwt, Wwt, Wwt, Wot, Wwt, Wot, Wot, Wot, Wot, Wot, Wot, Wot, Wwt, Wot
Wwt, Wwt, Wwt, Wwt, Wwt^Bw\, Wwt, Wwt, Wwt, Wwt, Wwt, Wwt, Wwt, Wwt, Wwt, Wwt, Wwt, Wwt, Wwt, Wwt, Wwt, Wwt, Wwt, Wwt^Bw\, Wwt, Hh, Wwt, Wwt, Wwt, Wwt, Wwt, Wwt, Wwt, Wwt, Wwt, Wwt, Wwt, Wwt, Wwt, Wwt, Wwt, Wwt, Wwt, Wwt, Wwt
Wwt, Wwt, Wwt, Wwt, Ds, Ds^Bw\, Ds^Bw\, Wwt, Wwt, Wwt^Bw|, Wwt, Wwt, Wwt, Wwt^Bw|, Wwt, Wwt, Wwt, Wwt, Wwt, Wwt, Wwt, Wwt, Wwt, Hh^Vhh, Hh, Gg, Gg, Gg, Gg, Wwt, Gg, Gg, Gg, Wwt, Wwt, Wwt, Wwt, Wwt, Wwt, Wwt, Wwt, Wwt, Ds, Wwt
Gg, Wwt, Gg, Ds, Gg, Gg, Rrc^Vh, Gg, Gg, Ds^Bw|, Ds, Wwt, Gg, Gg, Gg, Gg, Gg, Gg, Gg, Ds, Ds, Wwt, Gg, Rrc, Gg, Gg, Gg, Gg, Gg, Wwt, Rb^Gvs, Gg^Vh, Rb^Gvs, Gg, Gg, Gg, Gg, Gg, Gs, Ds, Ds, Ds, Gg, Ds
Gg, Gg, Gg, Gg, Gg, Gg, Rrc, Gg, Gg, Gg, Gg, Gg, Gg, Gg, Gg^Vh, Gg, Gg, Gg, Gg^Vh, Gg, Wwt, Wwt, Gg, Rrc, Gg, Gg, Gg, Gg, Re, Rb^Wm, Rb^Gvs, Rb^Gvs, Rb^Gvs, Rb^Gvs, Rb^Wm, Gg, Gg, Gs, Gs, Gs, Gg, Gg, Gg, Gg
Rrc, Gg, Rrc, Ce, Gs, Gg, Gg, Rrc, Rrc, Gg, Gg, Gg, Gg, Gg, Gg, Rrc, Rrc, Rrc, Gg, Wwt, Gg, Gg, Gg, Rrc, Rrc, Gs, Gg, Gg, Re, Rb^Gvs, Rb^Gvs, Rb^Gvs, Rb^Gvs, Rb^Gvs, Rb^Gvs, Rb^Gvs, Rb^Gvs, Gg, Gs, Gs, Gg, Gg, Gg, Gg
Gg, Rrc, Ce, Rrc, Rrc, Gs, Gs, Gg, Rrc, Rrc, Rrc, Gg, Gg, Gg, Gg, Gg, Rrc, Gg, Wwt, Wwt, Rrc, Gg, Rrc, Rrc, Gs^Vh, Rrc, Rrc, Gg, Re, Rb^Gvs, Rb^Gvs, Rb^Gvs, Rb^Gvs, Rb^Gvs, Rb^Gvs, Rb^Gvs, Rb^Gvs, Gg^Vh, Gg, Gs, Gg, Hh^Fp, Hh^Fms, Gg
Gg, Gg, Gg, Gs, Rrc^Vhh, Rrc, Rrc, Rrc, Hh, Hh, Gg, Rrc, Rrc, Gs^Fds, Rrc, Rrc, Ch, Rrc, Wwt^Bsb/, Ch, Ch, Rrc, Gg, Gs, Gs, Rr^Vhc, Re, Re, Re, Rb^Gvs, Rb^Gvs, Rb^Gvs, Rb^Gvs, Rb^Gvs, Rb^Gvs, Rb^Gvs, Gg, Gg, Gs, Gg, Gg, Gg, Gg, Gs
Gg, Gg, Gg, Gs, Gg, Rrc, Gg, Hh, Hh^Fp, Gg, Rr^Vhc, Rrc, Gg, Rrc, Rrc, 2 Kh, Ch, Rrc, Wwt^Bsb\, Rrc, Kh, Rrc, Gs^Fds, Gg, Gg, Re, Gg, Gg, Re, Re, Re, Rb^Gvs, Rb^Gvs, Rb^Gvs, Rb^Gvs, Gg, Gg, Gs, Gg, Gg, Gg, Gg, Gg, Gg
Gg, Gg, Gg, Gg, Hh, Hh, Hh, Hh, Hh, Gs, Gs^Vh, Gs, Gg, Gg, Rrc, Rrc, Wwt, Wwt, Ch, Ch, Rrc, Rrc, Rrc, Gg, Gg, Gg, Re, Re, Gg, Rb^Gvs, Rb^Gvs, Re, Re, Re, Re, Gg, Gg, Gs, Gg, Gg, Gg, Gg, Gs^Fms, Gs^Fds
Gg, Gg, Gg, Hh, Gg, Hh^Fms, Gg, Hh^Fp, Hh, Hh, Rrc, Gg, Rrc, Rrc, Gg, Gg, Wwt, Gg, Gg, Rrc, Gg, Gg, Gg, Rrc, Gs^Vh, Re, Gg, Re, Rb^Gvs, Rb^Gvs, Rb^Gvs, Rb^Gvs, Rb^Gvs, Rb^Gvs, Rb^Gvs, Gg, Gg, Gg, Gg, Gg, Gg, Gg, Gg, Gll^Fp
Gg, Gg, Gs, Gs, Re^Vhh, Gg, Gg, Gg, Hh, Gg, Gg, Rrc, Gg, Rrc, Gg, Gg, Wwt, Gg, Gg, Rrc, Gg, Gg, Gg, Gs, Gs, Gs, Gg, Rb^Wm, Rb^Gvs, Rb^Gvs, Rb^Gvs, Rb^Gvs, Rb^Gvs, Rb^Gvs, Rb^Gvs, Gg, Gg, Gg, Gg, Gg, Gg, Gg, Gg^Efm, Gs^Fms
Gg, Gg, Gs, Re, Re, Re, Gs, Hh^Fms, Gg, Gg, Rrc, Rrc, Gg, Gg^Vh, Gg, Gg, Wwg, Gg, Rr^Vhc, Rrc, Gs^Vh, Gg, Gg, Gs, Gg, Gg, Gg, Rb^Gvs, Rb^Gvs, Rb^Gvs, Rb^Gvs, Rb^Gvs, Rb^Gvs, Rb^Gvs, Rb^Gvs, Gs^Vl, Gs^Fms, Gs^Fds, Gs^Fds, Gg^Efm, Gs^Fds, Gg, Gs^Fds, Gs^Fds
Gg, Gg, Gg^Efm, Gs, Gs, Re, Re, Gg, Gg, Rrc, Gg, Gg, Gs^Fms, Gs^Fms, Gg, Wwf, Wwf, Gg, Gs^Fds, Rrc, Gg, Gg, Gs, Gs, Gs, Gs, Gg, Gg, Rb^Gvs, Rb^Gvs, Rb^Gvs, Rb^Gvs, Rb^Gvs, Rb^Gvs, Gg, Gg, Gs, Gg, Gg, Gs^Fds, Gg, Gg, Gg^Efm, Gs^Fds
Gg, Gg, Gg^Eff, Gg^Eff, Gg^Eff, Gs, Gg, Re, Rrc, Rrc, Gg, Gg, Gg, Gg, Wwt, Wwg, Gg, Gg, Gg, Gg, Gg, Gg, Gg, Gg, Gll^Fp, Gs^Fds, Gg^Eff, Rb^Gvs, Rb^Gvs, Rb^Gvs, Rb^Gvs, Rb^Gvs, Gg, Gg, Gs^Fms, Gg, Ce, Ce, Ce, Gg, Gs^Fds, Gs^Fds, Gs^Fds, Gs^Fms
Gg, Gg^Eff, Gg^Eff, Gg, Gg^Eff, Gg^Eff, Gg, Ce, Rrc, Ce, Gg, Gg, Wwt, Wwt, Gs^Fds, Gs^Fds, Gs^Fms, Gg, Gg, Gs^Fds, Gg, Gg, Gg, Gg, Gg^Eff, Gg^Eff, Rb^Gvs, Gs^Vl, Rb^Gvs, Rb^Gvs, Gg, Gg, Gg, Gg, Gll^Fp, Gg, Ce, 1 Ke, Ce, Gs^Fds, Gs^Fds, Gs^Fds, Gll^Fp, Gs^Fds
Gg, Gg, Gs^Fds, Gg^Eff, Gs^Fds, Gg, Rrc, Rrc, Gg, Gg, Ww^Ewf, Wwt, Gg, Gg, Gg, Gs^Fds, Gg, Gg, Gg, Gg, Gs, Gll^Fp, Gs^Fds, Gs^Fds, Gg, Gg^Eff, Gg^Eff, Rb^Gvs, Gs^Fds, Gs^Fds, Gs^Fds, Gg^Efm, Gs^Fds, Gs^Fms, Gs^Fds, Gs^Fds, Gs^Fds, Ce, Gs^Fds, Gs^Fds, Gs^Fds, Gs^Fms, Gs^Fds, Gs^Fds
Gg, Gg, Gg, Gg^Efm, Rrc, Rrc, Gg, Gg, Gg, Gg, Ww^Ewf, Wwt, Gs^Vl, Gg, Gs^Fds, Gg, Gs^Fds, Gs, Gs, Gg, Gg, Gg, Gg, Gg, Gs^Fds, Gg, Gs^Fds, Gs^Fds, Gs^Fds, Gs^Fds, Gs^Fds, Gs^Fds, Gs^Fds, Gs^Fds, Gs^Fms, Gs^Fds, Gs^Fms, Gs^Fds, Gs^Fds, Gs^Fds, Gs^Fds, Gs^Fds, Gs^Fds, Gs^Fds
Rrc, Rrc, Rrc, Rrc, Gs, Gg, Gs, Gg, Gg, Gs^Fds, Gll^Fp, Gs^Fds, Gs^Fds, Gs^Fds, Gll^Fp, Gs^Fms, Gg, Gg, Gg, Gg, Gs^Fds, Gs^Fds, Gg, Gg, Gs^Fds, Gs^Fds, Gs^Fds, Gs^Fds, Gll^Fp, Gs^Fds, Gs^Fds, Gg^Efm, Gg^Efm, Gs^Fms, Gs^Fms, Gs^Fms, Gs^Fms, Gll^Fp, Gs^Fds, Gs^Fds, Gs^Fds, Gs^Fds, Gs^Fds, Gg^Efm
Gg, Gg, Gg, Gs, Gg, Gs, Gs, Gg, Gs^Fds, Gg, Gg, Gg^Efm, Gg^Efm, Gg^Efm, Gg, Gs^Fds, Gg, Gg, Gs^Fms, Gll^Fp, Gg, Gg, Gs^Fds, Gg^Efm, Gs^Fds, Gs^Fds, Gs^Fds, Gs^Fms, Gg^Efm, Gs^Fds, Gs^Fds, Gs^Fds, Gs^Fds, Gs^Fds, Gs^Fds, Gll^Fp, Gs^Fds, Gs^Fds, Gs^Fds, Gg^Efm, Gs^Fds, Gs^Fds, Gs^Fds, Gs^Fds
