Wot, Wot, Wot, Wot, Wot, Wot, Wot, Wot, Wot, Wot, Wot, Wot, Wot, Wot, Wot, Wot, Wot, Wot, Wot, Wot, Wot, Wot, Wot, Wot, Wot, Wot, Wot, Wot, Wot, Wot, Wot, Wot, Wot, Wot, Wot, Wwt
Wot, Wot, Wot, Wot, Wot, Wot, Wot, Wot, Wot, Wot, Wot, Wot, Wot, Wot, Wot, Wot, Wot, Wot, Wot, Wot, Wot, Wot, Wot, Wot, Wot, Wot, Wot, Wot, Wot, Wot, Wot, Wot^Vm, Wot, Wot, Wot, Wot
Wot, Wot, Wwt, Wwt, Wwt, Wwt, Wwt, Wot, Wwt, Wot, Wot, Wot, Wot, Wot, Wot, Wot, Wot, Wot, Wot, Wot, Wot, Wot, Wot, Wot, Wot, Wot, Wot, Wot, Wot, Wot, Wot, Wot, Wot, Wot, Wot, Wot
Wwt, Wwt, Wwt, Wwt, Wwt, Wwt, Wwt, Wwt, Ww^Vm, Wwt, Wwt, Wwt, Wwt, Wot, Wwt, Wot, Wwt, Wot, Wot, Wot, Wot, Wot, Wwt, Wot, Wwt, Wot, Wot, Wot, Wot, Wot, Cm, Wot, Wot, Wot, Wot, Wot
Wwt, Wwt, Wwt, Wwt, Wwt, Wwt, Wwt, Wwt, Wwt, Wwt, Wwt, Wwt, Wwt, Wwt, Wwt, Ww^Vm, Wwt, Wwt, Wwt, Wwt, Wwt, Wwt, Wwt, Wwt, Wwt, Wwt, Ww^Vm, Wwt, Wwt, Cm, 2 Km, Cm, Wot, Wot, Wot, Wot
Wwt, Wwt, Gg^Vh, Wwt, Gg, Wwt, Gg, Wwt, Wwt, Wwt, Wwt, Wwt, Wwt, Wwt, Wwt, Wwt, Wwt, Wwt, Wwt, Wwt, Wwt, Wwt, Wwt, Wwt, Wwt, Wwt, Wwt, Wwt, Wwt, Cm, Cm, Cm, Wot, Wot, Wot, Wot
Gg, Gg, Gg, Gg, Gg, Gg, Gg, Ds, Ds, Wwt, Ww^Vm, Wwt, Ds, Ds, Gg, Wwt, Wwf, Wwt, Wwf^Es, Wwt, Wwt^Es, Wwt, Wwt^Es, Wwt^Es, Wwt^Es, Wwf, Wwrg, Wwt, Wwt^Es, Wwt, Wwt, Wwt, Wwt, Wot, Wot, Wot
Gg, Gg, Gg, Gg, Gg^Es, Gg, Gg, Gg, Ds, Wwt, Wwt, Ds, Rp, Gg, Gg, Gg, Gg, Ds, Ds^Es, Ds^Es, Ds^Es, Wwf^Es, Ds^Es, Wwf, Wwf^Es, Wwrg, Wwf^Es, Wwrg, Wwrg, Wwt, Wwt, Wwt, Ww^Vm, Wwt, Wot, Wot
Gg, Gs, Gg^Es, Gg, Gg, Gg, Gg, Gg, Wwt, Wwt, Gg, Rp, Gg, Gg, Gg, Gg, Gg^Es, Gg, Gg, Ds, Gg^Es, Ds^Es, Ds, Ds^Es, Ds, Ds^Es, Ds^Es, Wwf^Es, Wwf^Es, Wwf, Wwt, Wwt, Wwt, Wwt, Wwt, Wot
Gs, Gs, Gs, Gg, Gg, Gg, Wwt, Wwt, Gg^Vh, Gg, Gg, Rp, Gg, Gg, Gg, Gg, Gg, Gg, Gg, Gg, Gg, Gg, Gg, Gg, Gg, Ds, Ds, Ds^Es, Ds^Es, Wwt^Es, Wwt^Es, Wwt, Wwt, Wwt, Wwt, Wot
Hh, Hh, Gs, Gg, Gg, Wwt, Gg, Gg, Gg, Gg, Gg, Rp, Gg, Gg, Gg, Gg, Gg, Gg^Vc, Gg, Gg, Gg, Gg, Gg, Gg, Gg, Gg^Es, Gg, Ds, Ds, Wwf^Es, Wwf^Es, Wwrt, Wwt, Wwt, Wwt, Wot
Gs, Hh, Gs, Gg, Gg, Wwt, Gg, Gg^Es, Gg, Gg, Gs, Re, Gg, Gg, Gg, Gg, Gg, Gg, Gg, Gg, Gg, Gg, Gg^Es, Gg, Gg, Gg, Gg, Gg^Es, Gg, Ds^Vht, Wwf^Es, Wwt^Es, Wwt^Es, Wwt, Wwt, Wwt
Gg, Gs, Gg, Gg, Gg, Wwt, Gg, Gg, Gs^Fds, Gg, Rp, Re, Gg, Gg, Gg, Gs, Gs, Gg, Gg, Gg, Gg, Gg, Gs, Gs, Gs, Gg, Gg, Gg, Gg, Ds, Ds, Wwf^Es, Wwf, Wwt^Es, Wwt, Wwt
Gg, Gg, Gg, Gg, Wwt, Wwt, Gg, Gg, Gg, Gs, Rp, Gs, Gs, Gs, Gs, Gs^Vht, Gg, Gs, Gs, Gg, Gg, Gs, Hh, Hh, Hh, Gs, Gs, Gg, Gg, Gg, Ds, Ds, Ds^Es, Wwf^Es, Wwt, Wwt
Gg, Gs^Fds, Gs^Vl, Gg, Wwt^Bw\, Gg, Ce, Ce, Ce, Gg, Rp, Gg, Gg, Gs, Gg, Gg, Gg, Gs, Gg, Gg, Gg, Gs, Gs, Gs, Gs, Hh, Gs, Gg, Gg, Gg, Gg^Es, Ds, Ds, Wwf^Es, Wwt, Wwt
Gg, Gg, Wwt, Wwt, Gs^Fms, Gg, Ce, 1 Ke, Ce, Gg, Rp, Gs, Gs, Gg, Gg, Gs, Gg, Gg, Gs, Gs, Gs, Gs, Gs, Gs^Vc, Gs, Gs, Gg^Es, Gg, Hh, Gg, Gg, Gg, Gg, Ds, Ds, Wwt
Gs^Fds, Wwt, Gs^Fds, Gg, Gg, Gg, Gg, Ce, Rp, Rp, Gs, Gs, Gs^Fms, Gs, Gs, Gg, Gs, Gs, Hh, Gs, Hh, Gs, Gs, Gs, Gg, Gg, Gg, Gs, Gs, Gg, Gg, Gg, Gg, Gg, Ds, Wwt
Wwt, Wwt, Gs^Fds, Gs^Fms, Gs^Fms, Gg, Rp, Rp, Gs^Fds, Gs, Gs^Fds, Gg, Gg, Gg, Gg, Gg, Hh, Hh, Hh, Hh, Hh, Hh, Hh, Gs, Gg, Gg, Gg, Gg, Gg, Gg, Gs, Gg, Gg, Gg, Gg, Gg
