Re^Fms, Gs^Fms, Gs^Fms, Hh^Fp, Hh, Gs^Fms, Gs^Fms, Gll^Fp, Gs^Fms, Gs^Fms, Gs^Fms, Gs^Fms, Gs^Fds, Gs^Fms, Gs^Efm, Gs^Fms, Gs^Fds, Hh^Fms, Hh^Fp, Hh, Gs^Fms, Hh^Fp, Hh^Fp, Gs^Fms, Gs^Fms, Gs^Fds, Gs^Fms, Gs^Fms, Rp
Gs^Efm, Gs^Fms, Hh^Fp, Hh^Fms, Hh, Gs^Fms, Gg^Fp, Gs^Fds, Gs^Fms, Gg^Fet, Gs^Fds, Gs^Fds, Gs^Fms, Gs^Fms, Gs^Fms, Gs^Fms, Gll^Fp, Gs^Fms, Gs^Fms, Gs^Fms, Gs^Efm, Hh^Fp, Gs^Fms, Gs^Fms, Gs^Fms, Gs^Fds, Rr, Rp, Gs^Fms
Gs^Fms, Gs^Fms, Hh^Fp, Hh^Fms, Gs^Fms, Gs^Fms, Gg^Efm, Gs^Fds, Gs^Fms, Gs^Fms, Gs^Fms, Gs^Fms, Hh^Fms, Gs^Fms, Gs^Fms, Gs^Fms, Gs^Fms, Gs^Fms, Gs^Fms, Gs^Fms, Gs^Fms, Gs^Fms, Gs^Fms, Gs^Fms, Kv, Rrc, Gs^Fms, Gs^Fms, Gs^Fms
Gs^Fms, Gs^Fms, Hh, Hh^Fp, Hh, Gs^Fms, Gs^Fms, Gg^Efm, Gs^Fms, Gs^Fms, Hh^Fp, Gs^Vl, Gs^Es, Gs^Fms, Gs^Fms, Gs^Fms, Gs^Fms, Gs^Fms, Gs^Fms, Gs^Fms, Rp, Rp^Efm, Rr, Rr, Rrc, Kv, Gs^Fms, Gs^Fms, Gll^Fp
Gs^Fms, Gs^Fms, Hh, Gs^Fms, Hh, Gs^Fms, Gs^Fms, Gs^Fms, Gs^Fds, Gs^Fms, Gs^Es, Hh^Fp, Gs^Es, Hh, Gs^Fms, Gs^Fms, Gs^Fms, Gs^Fms, Gs^Fms, Rr, Gs^Fms, Gs^Fms, Gs^Fds, Rp^Efm, Gs^Fms, Gs^Fms, Gs^Fms, Gll^Fp, Gs^Fms
Gs^Fms, Gs^Fms, Gs^Fms, Hh, Gs^Fms, Gs^Fds, Gs^Fds, Gs^Fms, Gs^Fds, Gs^Fms, Gs^Fms, Hh^Fp, Hh^Fms, Gs^Fms, Gs^Fms, Gs^Fms, Gs^Fms, Gs^Fms, Gs^Fms, Rr^Es, Gg^Ve, Gll^Fp, Gll^Fp, Gs^Fms, Gs^Fds, Gs^Fds, Gs^Fms, Gs^Fms, Gs^Fms
Gs^Fms, Gll^Fp, Gs^Fms, Gs^Fms, Gs^Fms, Gs^Fms, Gs^Fms, Gs^Fms, Gll^Fp, Gs^Fms, Gs^Fms, Hh^Fms, Hh^Fp, Hh^Fp, Hh^Edp, Hh, Gs^Fms, Gs^Fms, Rp^Efm, Rp^Efm, Gs^Fms, Gs^Fms, Gs^Fms, Gs^Fms, Gs^Fds, Gg, Gs^Fms, Gs^Fms, Gs^Fms
Gs^Fms, Gs^Fms, Gs^Fms, Gs^Fp, Gs^Fms, Gs^Fms, Gs^Fms, Gs^Fds, Gs^Fms, Gs^Fms, Hh, Gs^Es, Gs^Es, Hh, Wwt, Wwt, Wwt^Ewf, Gs^Fms, Rr, Gs^Fms, Gs^Fms, Gs^Fms, Gs^Fds, Gs^Fms, Gs^Fms, Gs, Gs^Fms, Gs^Fms, Gs^Fms
Gs^Fms, Gs^Fms, Gg^Ve, Gs^Fms, Rp^Efm, Gg^Fet, Gs^Fms, Gs^Fms, Gs^Fds, Gs^Fms, Gs^Fms, Hh^Fp, Ww^Ewl, Ww^Bh\, Gs^Vht, Wwt^Ewf, Wwt, Gs^Fms, Rr, Gs^Fms, Gs^Fms, Gg^Fp, Gs^Fms, Gs^Fms, Gs^Fms, Gs^Fms, Gs^Fms, Gs^Fms, Gs^Fms
Gs^Fms, Gs^Fms, Gs^Fms, Rp^Efm, Gs^Fms, Rp^Efm, Gg^Efm, Gs^Fms, Gs^Fds, Gs^Fds, Gs^Fms, Gs^Fms, Wwt^Ewf, Wwt, Ww^Ewl, Wwt, Rp, Ww^Bsb/, Gs^Fms, Gs^Fms, Gs^Fms, Gs^Fms, Gs^Fms, Gg^Fet, Gs^Fds, Gs^Fms, Gs^Fms, Gg^Fet, Gg^Fet
Gs^Fms, Gs^Fds, Gs^Fms, Gs^Fms, Gs^Fms, Rp^Efm, Rp^Efm, Gg^Fms, Gs^Fms, Gs^Fds, Gs^Fds, Gs^Fms, Gs^Fms, Gs^Fms, Wwt^Ewf, Ww^Ewl, Ww^Bsb|, Wwt, Wwt^Ewf, Gs^Fms, Gs^Fms, Gs^Fms, Gs^Fds, Gs^Fms, Gg^Fp, Gs^Fds, Gs^Fms, Gs^Fms, Gs^Fms
Gs^Fms, Gs^Fms, Gs^Fms, Gs^Fms, Gs^Fms, Gs^Fms, Rp, Gs^Fms, Gg, Gs^Fms, Gs^Fms, Gs^Fms, Gs^Fms, Gs^Fms, Gs^Efm, Wwt, Rr, Wwt^Ewf, Wwt^Ewf, Ww^Ewl, Gs^Efm, Gs^Fms, Gs^Fms, Gs^Fms, Gs^Fms, Gs^Fms, Gg^Ve, Gs^Fms, Gs^Fms
Gs^Fms, Gs^Fds, Hh, Gs^Fms, Gg^Fet, Gs^Fms, Rp, Gs^Fms, Gs^Fds, Gg, Gs^Fms, Gs^Fms, Gs^Fms, Gs^Fms, Rp, Rp, Gs^Fms, Gs^Fds, Gg^Fp, Gs^Fms, Gs^Efm, Gg^Efm, Gg, Gg, Gg^Efm, Gs^Fms, Gs^Fms, Gs^Fms, Gs^Fms
Gs^Fms, Gs^Fms, Hh, Gs^Fms, Gs^Fms, Gs^Fms, Rp, Gs^Fms, Gs^Fms, Gs^Fds, Gs^Fms, Gs^Fms, Gg^Fet, Gs^Fms, Rp, Gll^Fp, Gs^Fms, Gs^Fms, Gll^Fp, Gs^Fms, Gs^Fms, Gg^Efm, Gll^Fp, Gg, Gs^Efm, Gs^Fms, Gs^Fms, Gs^Fms, Gs^Fms
Gg^Fet, Gs^Fms, Gs^Fds, Gs^Fms, Gs^Fms, Gs^Fms, Gs^Efm, Rp, Gs^Fms, Gs^Fms, Gs^Fms, Gs^Fms, Rr, Re^Es, Gs^Fms, Gg^Fet, Gs^Fms, Gs^Fms, Gs^Fms, Gs^Fms, Gs^Fms, Gs^Fms, Gll^Fp, Gs^Fms, Gs^Fms, Gs^Fms, Gs^Fms, Gs^Fms, Gs^Efm
Gs^Fms, Gs^Fds, Gs^Fds, Gs^Fds, Gs^Fms, Gs^Fms, Gs^Fms, Rp, Gs^Fms, Gs^Fms, Gs^Fms, Gs^Fms, Rp, Gs^Fms, Gs^Fms, Gs^Fms, Gs^Fms, Gs^Efm, Gs^Efm, Gs^Fms, Gs^Fms, Gs^Fms, Gs^Fms, Gs^Fms, Gs^Fms, Gs^Fms, Gs^Fds, Gs^Fms, Gs^Fds
Gs^Fds, Gs^Fds, Gs^Fds, Gs^Fds, Gs^Fms, Gs^Fds, Gs^Fms, Rp, Rp^Efm, Gs^Fms, Gs^Fms, Gs^Fms, Rp^Efm, Gs^Fms, Gs^Fds, Gs^Fds, Gs^Fds, Gs^Fds, Gs^Fms, Gs^Fms, Gs^Fms, Gs^Fms, Wwt, Gs^Fms, Gs^Fms, Gs^Fds, Gs^Fds, Gs^Fms, Gs^Fms
Gs^Fds, Gs^Fds, Gg^Efm, Gs^Vht, Gs^Fms, Gs^Fms, Gs^Fms, Gs^Efm, Gs^Fms, Rp, Rp, Rp, Gg^Ve, Gs^Fms, Gs^Fms, Gs^Fds, Gs^Fds, Gs^Fds, Gs^Fms, Gs^Fms, Gs^Fms, Ww^Ewf, Wwt, Gs^Efm, Gs^Fms, Gs^Fms, Gs^Fms, Gs^Fms, Gs^Fms
Gg, Gs^Fds, Gs^Fds, Gs^Fms, Gs^Fms, Gs^Fms, Gs^Fms, Gs^Fms, Gs^Efm, Gg^Fp, Gs^Fms, Rp, Gs^Fms, Gs^Fms, Gs^Fms, Gs^Fds, Gs^Fms, Gs^Fds, Gs^Fms, Gs^Fms, Gs^Fms, Gs^Fms, Gs^Fms, Gs^Fms, Gg^Ve, Gs^Fms, Gs^Fds, Gs^Fms, Gs^Fds
Gs^Fds, Gs^Fds, Ce, Ce, Ce, Gs^Efm, Re^Es, Re^Es, Rp, Gs^Fms, Rp^Efm, Rp, Gs^Fms, Gs^Fms, Gs^Fms, Gs^Fms, Gs^Fms, Gs^Fms, Gs^Fms, Ss^Em, Ss^Em, Gs^Fds, Gs^Fms, Gs^Fms, Gs^Fp, Gs^Fms, Gs^Fds, Gs^Fms, Gs^Fms
Gs^Fms, Gs^Fms, Ce, 1 Ke, Ce, Re^Es, Gs^Fms, Gs^Fms, Gs^Fms, Re^Es, Gs^Fms, Gs^Fms, Gs^Fms, Gs^Fds, Gs^Fms, Gs^Fms, Gs^Fms, Gg^Fet, Gs^Fms, Gs^Fms, Gs^Fms, Gs^Fms, Gs^Fms, Gs^Fp, Gs^Fp, Gs^Fds, Gs^Fds, Gs^Fms, Gs^Fms
Gs^Fms, Gs^Fms, Gs^Fms, Gs^Fms, Gs^Fms, Rp, Gs^Fms, Gs^Fms, Gs^Fms, Gs^Fms, Gs^Fms, Gs^Fms, Gs^Fms, Gs^Fms, Gs^Fms, Gs^Fds, Gg^Fp, Gg^Fp, Gll^Fp, Gll^Fp, Gs^Fms, Gs^Fms, Gs^Fms, Gs^Fms, Gs^Fms, Gs^Fms, Gs^Fms, Gs^Fms, Gs^Fms
Gg, Gs^Fms, Gs^Fms, Gs^Fms, Gs^Fms, Rp, Gs^Fms, Gs^Fms, Gs^Fms, Gs^Fms, Gs^Fms, Gs^Fms, Gg, Gg, Gg, Gll^Fp, Gg, Gll^Fp, Gg, Gg^Fet, Gg, Gs^Fms, Gg, Gs^Fms, Gg, Gs^Fms, Gg, Gs^Fms, Gg
