Gg, Gg, Gg, Gg, Gg, Gg, Gg, Gs, Gg, Gg, Gg, Wwt, Gg, Gg, Gs^Fds, Gg, Rp, Gs, Gg, Gg
Gg, Gg, Gs, Gg, Gg, Gg, Gg, Gg, Gg, Gg, Wwt, Wwt, Gg, Gg, Gg, Gs, Rp, Gs, Gs, Gs
Gs^Fms, Gg, Gs, Gs, Gs, Gg, Gg, Gs^Fds, Gs^Vl, Gg, Wwt^Bw\, Gg, Ce, Ce, Ce, Gg, Rp, Gg, Gg, Gs
Gs^Fms, Gs^Fms, Gs^Fms, Gs, Gs, Gs, Gg, Gg, Wwt, Wwt, Gs^Fms, Gg, Ce, Ke, Ce, Gg, Rp, Gs, Gs, Gg
Gg, Gg, Gg, Gg, Gg, Gg, Gs^Fds, Wwt, Gs^Fds, Gg, Gg, Gg, Gg, Ce, Rp, Rp, Gs, Gs, Gs^Fms, Gs
Gg, Gs, Gs, Gg, Gg, Gg, Wwt, Wwt, Gs^Fds, Gs^Fms, Gs^Fms, Gg, Rp, Rp, Gs^Fds, Gs, Gs^Fds, Gg, Gg, Gg
Gg, Gg, Wwt, Gg, Wwt, Wwt, Gs^Fms, Gs^Fds, Gg, Gg, Rp, Rp, Gg, Gg, Gs^Fms, Gg, Gs^Fms, Gg, Gg, Gg
Wwt, Wwt, Gg, Wwt, Gg, Gs, Re, Gs^Fms, Rp, Rp, Gs, Gg, Gs, Gg, Gs, Gs^Fms, Gg, Gg, Gg, Gg
Gg, Gs^Vh, Gg, Gg, 1 Rp, Re, Gs, Rp, Gg, Gg, Gs, Gs, Gs, Gs, Gs, Gg, Gg, Gs^Vl, Gg, Gg
Gg, Gg, Rp, Rp, Gg, Gg, Gs, Gs, Gg, Gs, Gs, Gs, Gs, Gs, Gs, Gs, Gg, Gg, Gs^Fms, Gs^Fms
