Xu, Xu, Xu, Xu, Xu, Xu, Xu, Xu, Xu, Xu, Xu, Xu, Xu, Xu, Xu, Xu, Xu, Xu, Xu, Xu, Xu, Xu, Xu, Xu, Xu, Xu, Xu, Xu, Xu, Xu, Xu, Xu, Xu, Xu, Xu, Xu, Xu, Xu, Xu, Xu, Xu, Xu
Xu, Xu, Xu, Xu, Xu, Xu, Xu, Xu, Xu, Xu, Xu, Xu, Uh^Vud, Xu, Xu, Xu, Xu, Xu, Uh^Crys, Xu, Xu, Xu, Xu, Xu, Xu, Xu, Xu, Xu, Xu, Xu, Xu, Xu, Xu, Xu, Xu, Xu, Xu, Xu, Xu, Xu, Xu, Xu
Xu, Xu, Xu, Xu, Uh^Crys, Xu, Uh^Crys, Uh^Crys, Uh^Crys, Xu, Uh^Crys, Uh^Crys, Ur, Uh, Ur^Br/, Uu^Br\, Uh^Br\, Uh^Dr, Uh^Crys, Uu, Uh^Vud, Uh^Crys, Uh^Crys, Xu, Xu, Xu, Uu, Xu, Xu, Xu, Ur^Xo, Xu, Xu, Ur^Kov, Xu, Xu, Ur^Xo, Xu, Xu, Xu, Xu, Xu
Xu, Xu, Xu, Uh^Crys, Uh^Vud, Xu, Uh^Crys, Uh^Crys, Uu, Uh^Crys, Uu, Uh^Dr, Uu^Br/, Ur^Br/, Xu, Xu, Uu, Uu^Br\, Ur^Br/, Ur^Br\, Ur^Br\, Uh^Crys, Uu, Xu, Uh^Dr, Uh^Br|, Uh^Dr, Xu, Uu, Xu, Xu, Ur^Xo, Ur^Kov, Ur^Kov, Ur^Kov, Ur^Xo, Xu, Xu, Xu, Xu, Xu, Xu
Xu, Xu, Xu, Uh^Dr, Uu, Uu, Xu, Xu, Ur, Uu, Xu, Xu, Uh^Crys, Xu, Uu^Vud, Xu, Xu, Ur, Uh^Br|, Xu, Xu, Uu^Br\, Uu^Br\, Uu, Uu^Br/, Ur^Br/, Uh^Crys, Ur, Uu, Xu, Ur^Xo, Xu, Ur^Kov, Ur^Qov, Ur^Kov, Xu, Ur^Xo, Xu, Xu, Xu, Xu, Xu
Xu, Xu, Uh^Crys, Uh^Br\, Uh^Br\, Uu, Xu, Uu, Uh^Crys, Uu, Uh^Crys, Uh^Crys, Uu, Uh, Ur^Br\, Uu, Uh^Br/, Uu^Br\, Uu^Br\, Xu, Xu, Uu, Ur, Uu^Br/, Uu^Br|, Ur^Vud, Xu, Xu, Uu, Xu, Xu, Ur^Xo, Ur^Kov, Ur^Kov, Ur^Kov, Ur^Xo, Xu, Xu, Xu, Xu, Xu, Xu
Xu, Xu, Xu, Uh^Crys, Uu, Uu^Br|, Xu, Uu, Uu^Crys, Ur, Ur^Br\, Uh^Crys, Ur^Br/, Uu^Br/, Uh^Dr, Uh^Br\, Uh^Crys, Uu, Uu^Crys, Ur^Br\, Ur, Ur, Uh^Crys, Xu, Uh^Br\, Uu, Xu, Uh, Xu, Xu, Ur^Xo, Xu, Ur^Kov, Ur^Qov, Ur^Kov, Xu, Ur^Xo, Xu, Xu, Xu, Xu, Xu
Xu, Xu, Uh^Crys, Uu, Uu, Uu^Br|, Xu, Xu, Uh^Br/, Uu^Br/, Xu, Uh^Br\, Uh, Uh^Br|, Uh^Dr, Uh^Crys, Uh^Crys, Uu^Crys, Uu, Uh^Br|, Ur^Vud, Uh^Crys, Xu, Xu, Uu, Uh^Br|, Xu, Uu, Uh, Xu, Xu, Ur^Xo, Ur^Kov, Ur^Kov, Ur^Kov, Ur^Xo, Xu, Xu, Xu, Xu, Xu, Xu
Wo, Xu, Xu, Uh, Xu, Uh^Br\, Uu^Br|, Uu^Br/, Uu, Uh^Vud, Uh^Crys, Uh^Crys, Xu, Ur^Br|, Uu^Br\, Uh^Crys, Xu, Xu, Uh, Uu^Br|, Uu, Uu, Uu, Xu, Ur^Br/, Uu^Br/, Xu, Ur, Uu, Xu^Pysg, Ur^Kov, Xu, Ur^Kov, Ur^Qov, Ur^Kov, Xu, Ur^Xo, Xu, Xu, Xu, Xu, Xu
Wo, Xu, Xu, Uh^Crys, Uh^Vud, Uu, Uh^Br|, Ur, Xu, Uu, Uh^Crys, Uh^Crys, Uu, Uu, Uh^Dr, Ur^Br|, Uu, Xu, Xu, Ur^Br\, Uh^Br\, Uu, Uh^Br/, Ur^Br/, Ur^Br\, Xu, Uh^Vud, Xu, Ur, Uu^Xo, Xu^Pysg, Ur^Xo, Ur^Kov, 1 Ur^Kov, Ur^Kov, Ur^Xo, Xu, Xu, Xu, Xu, Xu, Xu
Wo, Xu, Xu, Xu, Xu, Uh^Crys, Uh^Br|, Uh, Uh^Crys, Ur, Uu, Ur, Uh^Crys, Ur, Uh^Br/, Ur^Br|, Ur, Uu^Crys, Xu, Xu, Uh^Br|, Uu^Br\, Xu, Ur, Uh^Crys, Uh^Br\, Uu^Br|, Xu, Xu, Ur, Uh^Dr, Xu, Urb, Ur^Kov, Urb, Xu, Xu, Xu, Xu, Xu, Xu, Xu
Xu, Wo, Wo, Xu, Uh^Br/, Uh^Br/, Xu, Uh, Uu, Ur, Uh, Xu, Xu, Uh^Dr, Xu, Uh^Crys, Uu, Ur, Uu^Crys, Xu, Uu^Br|, Uh^Crys, Uu, Uh, Uh^Crys, Uh, Uh^Br\, Xu, Xu, Ur, Uh^Br|, Xu, Urb, Urb, Urb, Xu, Xu, Xu, Xu, Xu, Xu, Xu
Xu, Xu, Uh, Wo^Br/, Wo, Xu, Xu, Uh^Vud, Uh, Uu, Uh^Crys, Uu, Xu, Xu, Uh, Uh^Crys, Uh^Vud, Uu, Xu, Xu, Uh^Br|, Uh^Crys, Uu^Crys, Xu, Uh^Crys, Uh^Crys, Xu, Uu^Br|, Xu, Uu, Uu^Br|, Xu, Xu, Urb, Xu, Xu, Xu, Xu, Xu, Xu, Xu, Xu
Xu, Xu, Uh^Crys, Uh^Br|, Xu, Wo, Wo, Xu, Sm^Uf, Uh, Uh, Uh^Crys, Uh^Crys, Uh^Crys, Uh^Crys, Uu, Uu, Ur, Xu, Xu, Uu^Br\, Uh^Vud, Uh^Crys, Uh, Uh, Uh^Crys, Xu, Uu^Br\, Uu, Uh^Dr, Uu^Br|, Xu, Xu, Urb, Xu, Xu, Xu, Xu, Xu, Xu, Xu, Xu
Xu, Xu, Xu, Uh^Br|, Uh, Xu, Wo^Ii, Xu, Ss^Ii, Sm^Emf, Sm^Uf, Rb^Em, Uu, Uu, Uh^Crys, Ur, Uh, Xu, Xu, Uh^Crys, Uh, Uh^Br\, Uh^Br\, Ur, Xu, Xu, Uh^Br/, Uh^Br|, Uu^Br\, Uu, Uh^Br/, Xu, Xu, Urb, Urb^Xo, Xu, Xu, Xu, Xu, Xu, Xu, Xu
Xu, Xu, Uh^Crys, Uh^Br|, Uh^Vud, Xu, Ww^Ii, Ss^Ii, Rb^Uf, Sm^Uf, Sm^Em, Rb^Uf, Uh, Rb^Uf, Uh, Uu, Ur, Xu, Xu, Xu, Xu, Xu, Xu, Uu^Br\, Uu^Br/, Ur^Br/, Uu^Crys, Uh^Vud, Uh, Uh^Br/, Xu, Xu, Urb, Urb^Gyto, Xu, Xu, Uh, Xu, Uh, Xu, Xu, Xu
Xu, Xu, Uh^Br/, Uh^Br|, Xu, Ww, Ww, Xu, Sm^Uf, Rb^Uf, Rb^Uf, Rb^Uf, Rb^Em, Uh, Xu, Uu, Ur, Uu, Uu, Xu, Xu, Xu, Xu, Uh^Crys, Uh^Crys, Uh^Crys, Uh^Crys, Uh, Uu, Uh^Crys, Xu, Xu, Urb, Urb, Xu, Uh^Vu, Xu, Uh, Xu, Xu, Xu, Xu
Xu, Xu, Uh^Br|, Xu, Ww, Ww, Xu, Xu, Sm^Uf, Sm^Emf, Sm^Uf, Rb^Uf, Uu, Ur, Xu, Xu, Xu, Ur, Ur, Xu, Xu, Xu, Xu, Uh^Crys, Xu, Uh, Xu, Uu, Xu, Xu, Urb, Urb, Xu, Xu, Xu, Xu, Xu, Uh^Crys, Uh, Xu, Xu, Xu
Xu, Xu, Xu, Uh^Br\, Ww^Br\, Xu, Xu, Xu, Xu, Sm^Uf, Sm^Uf, Sm^Uf, Uh^Crys, Ur, Ur, Xu, Xu, Ur, Urb^Vud, Urb, Urb, Xu, Urb^Vud, Xu, Xu, Xu, Xu, Xu, Xu, Xu, Urb, Xu, Xu, Xu, Wwt, Wwt, Wwt, Xu, Uh, Xu, Xu, Xu
Xu, Xu, Xu, Ww, Xu, Uh^Br\, Uh^Br|, Xu, Xu, Xu, Xu, Xu, Xu, Uu, Ur, Ur, Urb, Urb, Urb, Urb, Xol, Urb, Urb, Urb, Urb, Xu, Xu, Xu, Urb, Urb, Xu, Xu, Wwt, Wwt, Wot, Wot, Wot, Wwt, Wwt, Xu, Xu, Xu
Xu, Xu, Xu, Ww, Xu, Xu, Uh^Br\, Xu, Xu, Xu, Xu, Xu, Xu, Xu, Urb, Urb, Urb, Urb, Xol, Urb, Urb, Urb, Xol, Urb, Urb, Urb, Urb, Urb, Xu, Xu, Xu, Xu, Wwt, Wot, Wot, Wo^Ii, Wo^Ii, Wot, Wwt, Wwt, Xu, Xu
Xu, Xu, Ww, Ww, Xu, Xu, Uh^Br|, Xu, Xu, Xu, Xu, Xu, Urb, Urb, Urb, Urb, Urb, Urb, Urb, Urb, Xol, Urb, Urb, Urb, Urb, Urb, Urb, Urb, Urb, Xu, Xu, Xu, Xu, Wwt, Wwt, Wot, Wot, Wot, Wwt, Xu, Xu, Xu
Ww, Ww, Xu, Xu, Xu, Xu, Uu^Br/, Xu, Xu, Xu, Urb, Urb^Vud, Urb, Urb, Xol, Urb, Urb, Urb, Urb, Urb, Urb, Urb, Urb, Urb, Urb, Urb, Xol, Urb, Urb, Urb^Vud, Urb, Xu, Xu, Xu, Xu, Wwt^Bsb|, Wwt, Wwt, Xu, Xu, Xu, Xu
Xu, Xu, Xu, Xu, Uu^Br/, Uu^Br/, Xu, Xu, Urb, Urb, Urb, Urb, Xol, Urb, Urb, Urb, Xol, Urb, Urb, Urb, Urb^Vud, Urb, Urb, Urb, Xol, Urb, Urb, Urb, Xol, Urb, Urb, Urb, Urb, Xu, Xu, Ur, Ur, Xu, Ur, Ur, Xu, Xu
Xu, Xu, Uu^Br|, Uu^Br/, Xu, Xu, Urb, Urb, Urb, Urb, Urb, Urb, Urb, Urb, Xol, Urb, Urb, Urb, Urb, Urb, Urb, Urb, Urb, Urb, Urb, Urb, Xol, Urb, Urb, Urb, Urb, Urb, Urb, Urb, Urb, Ur, Xu, Ur, Ur, Ur, Xu, Xu
Xu, Xu, Uu^Br|, Xu, Urb^Vud, Urb, Urb, Urb, Xol, Urb, Urb, Urb, Urb, Urb, Urb, Urb, Urb, Urb, Urb, Cud, Xol, Cud, Urb, Urb, Urb, Urb, Urb, Urb, Urb, Urb, Urb, Urb, Xol, Urb, Urb, Urb, Urb^Vud, Xu, Uh, Xu, Xu, Xu
Xu, Xu, Uu^Br|, Xu, Urb, Urb, Xol, Urb, Urb, Urb, Xol, Urb, Urb, Urb, Urb^Vud, Urb, Urb, Cud, Xol^Cov, Cud, 2 Kud, Cud, Xol^Cov, Cud, Urb, Urb, Urb^Vud, Urb, Urb, Urb, Xol, Urb, Urb, Urb, Xol, Urb, Urb, Xu, Uh, Xu, Xu, Xu
Xu, Xu, Uu^Br|, Xu, Urb^Vud, Urb, Urb, Urb, Xol, Urb, Urb, Urb, Urb, Urb, Urb, Urb, Urb, Cud, Urb, Cud, Xol, Cud, Urb, Cud, Urb, Urb, Urb, Urb, Urb, Urb, Urb, Urb, Xol, Urb, Urb, Urb, Urb^Vud, Xu, Xu, Uh, Xu, Xu
Xu, Xu, Uu^Br|, Xu, Xu, Urb, Urb, Urb, Urb, Urb, Urb, Urb, Urb, Urb, Xol, Urb, Urb, Urb, Urb, Cud, Urb, Cud, Urb, Urb, Urb, Urb, Xol, Urb, Urb, Urb, Urb, Urb, Urb, Urb, Urb, Urb, Xu, Xu, Uh, Uh, Xu, Xu
Xu, Xu, Xu, Uu^Br\, Uu^Br\, Xu, Xu, Urb, Urb, Urb, Urb, Urb, Xol, Urb, Urb, Urb, Xol, Urb, Urb, Urb, Urb^Vud, Urb, Urb, Urb, Xol, Urb, Urb, Urb, Xol, Urb, Urb, Urb, Urb, Urb, Xu, Xu, Uu, Uu, Uh^Crys, Xu, Xu, Xu
Xu, Xu, Xu, Xu, Xu, Uu^Br\, Uu^Br\, Xu, Urb, Urb, Urb, Urb, Urb, Urb, Xol, Urb, Urb, Urb, Urb, Urb, Urb, Urb, Urb, Urb, Urb, Urb, Xol, Urb, Urb, Urb, Urb, Urb, Xu, Ur, Xu, Xu, Uh, Xu, Xu, Xu, Xu, Xu
Xu, Xu, Xu, Xu, Xu, Xu, Urb^Br|, Urb^Br\, Urb^Br\, Xu, Xu, Urb^Vud, Urb, Urb, Urb, Urb, Urb, Urb, Urb, Urb, Xol, Urb, Urb, Urb, Urb, Urb, Urb, Urb, Urb, Urb^Vud, Xu, Xu, Sm^Uf, Sm^Emf, Sm^Uf, Xu, Xu, Uh, Uu, Xu, Xu, Xu
Xu, Xu, Xu, Xu, Xu, Xu, Urb^Br\, Urb, Urb, Urb^Br\, Urb^Br|, Xu, Xu, Urb, Urb, Urb, Urb, Urb, Xol, Urb, Urb, Urb, Xol, Urb, Urb, Urb, Urb, Urb, Xu, Xu, Xu, Xu, Sm^Emf, Sm^Em, Rb^Uf, Sm^Emf, Xu, Xu, Uu, Uh, Xu, Xu
Xu, Xu, Xu, Xu, Urb, Urb, Urb, Urb^Br\, Urb^Br\, Urb, Urb^Br|, Urb, Xu, Xu, Xu, Urb, Urb, Urb, Urb, Urb, Xol, Urb, Urb, Urb, Urb, Urb, Rr, Xu, Xu, Xu, Xu, Sm^Uf, Sm^Uf, Sm^Uf, Rb^Uf, Sm^Uf, Xu, Xu, Uu, Xu, Xu, Xu
Xu, Xu, Xu, Xu, Xu, Urb, Urb, Urb, Urb, Urb^Br/, Xu, Xu, Urb, Urb, Urb, Xu, Urb^Pr\, Urb, Urb^Vud, Urb, Urb, Urb, Urb^Vud, Urb, Xu, Rr, Rr, Rr, Rr, Xu, Xu, Sm^Uf, Rb^Uf, Sm^Em, Sm^Emf, Rb^Uf, Uh, Xu, Uu, Uh, Xu, Xu
Xu, Xu, Xu, Xu, Xu, Xu, Xu, Urb, Xu, Xu, Xu, Xu, Xu, Urb, Urb, Urb, Urb, Xu, Xu, Xu, Xu, Xu, Xu, Xu, Xu, Xu, Xu, Rr, Rr, Xu, Xu, Xu, Rb^Uf, Rb^Uf, Rb^Uf, Xu, Uh, Uu, Uh, Xu, Xu, Xu
Xu, Xu, Xu, Xu, Xu, Xu, Xu, Xu, Xu, Xu, Xu, Xu, Xu, Xu, Xu, Urb, Urb, Urb, Xu, Xu, Xu, Xu, Xu, Xu, Xu, Xu, Xu, Rr, Rr, Xu, Xu, Xu, Xu, Xu, Xu, Xu, Xu, Xu, Xu, Xu, Xu, Xu
Xu, Xu, Xu, Xu, Xu, Xu, Xu, Xu, Xu, Xu, Xu, Xu, Xu, Xu, Xu, Xu, Xu, Xu, Xu, Xu, Xu, Xu, Xu, Xu, Xu, Xu, Xu, Rr, Rr, Xu, Xu, Xu, Xu, Xu, Xu, Xu, Xu, Xu, Xu, Xu, Xu, Xu
