Wo, Wo, Wo, Wo, Wo, Wo, Ww, Ww, Ww, Ww, Ww, Ww, Wo, Wo, Wo, Wo, Wo, Wo, Ww, Ww, Ds, Ww, Ww, Ww, Wo, Wo, Wo, Wo, Wo, Wo, Wo, Wo, Wo, Wo, Wo, Wo, Wo, Wo, Wo, Wo, Wo, Wo, Wo, Wo, Wo, Wo, Wo, Wo, Wo, Wo, Wo, Wo, Wo, Wo, Wo, Wo, Wo, Wo, Wo, Wo
Wo, Wo, Ww, Ww, Ww, Ww, Ww, Ww, Ww, Ww, Ww, Ww, Wo, Wo, Wo, Wo, Wo, Wo, Ww, Ds, Gd, Ds, Ds, Ds, Ds, Wo, Wo, Wo, Wo, Wo, Wo, Wo, Wo, Wo, Wo, Wo, Wo, Wo, Wo, Wo, Wo, Wo, Wo, Wo, Wo, Wo, Wo, Wo, Wo^Vm, Wo, Wo, Wo, Wo, Wo, Wo, Wo, Wo, Wo, Wo, Wo
Wo, Ww, Ds, Ds, Ds, Ww, Ww, Ww, Ww, Ww, Ww, Wo, Wo, Wo, Wo, Wo, Wo, Wo, Ww, Gs^Vh, Gs, Gd^Fp, Gs^Fp, Gs^Fp, Ds, Wo, Wo, Wo, Wo, Wo, Wo, Wo, Wo, Wo, Wo, Wo, Wo, Wo, Wo, Wo, Wo, Wo, Wo, Wo, Wo, Wo, Wo, Wo, Wo, Wo, Wo, Wo, Wo, Wo, Wo, Wo, Wo, Wo, Wo, Wo
Wo, Ww, Ww, Gs^Vh, Ds, Ds, Ww, Ww, Ww, Ww, Ww, Wo, Wo, Wo, Wo, Wo, Wo, Wo, Wo, Ww, Ww, Ww, Ww, Ww, Wo, Wo, Wo, Wo, Wo, Wo, Wo, Wo^Vm, Wo, Wo, Wo, Wo, Wo, Wo, Wo, Wo, Wo, Wo, Wo, Wo, Wo, Wo, Wo, Wo, Ww, Wo, Wo, Wo, Wo, Wo, Wo, Wo, Wo, Wo, Wo, Wo
Wo, Ww, Ww, Ds, Ds, Ww, Ww, Ww, Ww, Ww, Ww, Ww, Wo, Wo, Wo, Wo, Wo, Wo, Wo, Wo, Wo, Wo, Wo, Wo, Wo, Wo, Wo, Wo, Wo, Wo, Wo, Wo, Wo, Wo, Wo, Wo, Wo, Wo, Wo, Wo, Wo, Wo, Wo, Wo, Ww^Bw\, Ww, Ds, Ww, Gs, Gs, Ds, Wo^Bw/, Wo, Wo, Wo, Wo, Wo, Wo, Wo, Wo
Wo, Wo, Wo, Ww, Ww, Ww, Ww, Ww, Ww, Ww, Ww, Ww, Ww, Wo, Ww, Wo, Wo, Wo, Wo, Wo, Wo, Wo, Wo, Wo, Wo, Wo, Wo, Wo, Wo, Wo, Wo, Wo, Wo, Wo, Cme, Cme, 7 Kme, Cme, Cme, Wo, Wo, Wo, Wo, Wo, Ww, Gs^Vh, Gs^Fp, Gg, Gs^Fp, Gs^Vl, Ds, Wo, Wo, Wo, Wo, Wo, Wo, Wo, Wo, Wo
Wo, Wo, Wo, Wo, Ww, Ww, Ww, Ww, Ww, Ww, Ww, Ww, Ww, Ww, Ww, Ww, Ww, Ww, Ww, Ww, Ww, Ww, Ww, Ww, Ww, Wo, Wo, Wo, Wo, Wo, Wo, Wo, Wo, Wo, Wo, Cme, Ww, Cme, Wwr, Wwr, Wo, Wo, Wo, Wo, Wo, Ww, Ww, Gs^Fp, Ds, Ds, Wo, Wo, Wo, Wo, Wo, Wo, Wo, Wo, Wo, Wo
Ww, Ww, Ww, Ww, Ds, Ww, Ds, Ds, Ds, Ww, Ds, Ds, Ds, Ds, Ds, Ww, Ww, Ww, Ds, Ds, Ds, Ww, Ww, Ww^Vm, Ww, Ww, Ww, Ww, Ww, Wo, Ww, Wo, Ww, Wo, Wo, Ww, Ww, Ww, Wo, Wo, Wo, Wo, Wo, Wo, Wo, Wo, Wo, Ww, Wo, Wo, Ww, Ww, Ww, Ww, Ww, Wo, Wo, Wo, Wo, Wo
Ds, Ww, Ds, Ds, Gg, Ds, Gg^Es, Ds, Rd, Ds, Rd, Gg^Es, Gg, Gg, Ds, Ww, Ww, Ww, Ds, Gg, Gg, Ds, Ds, Ds, Ds, Ds, Ds, Ds, Ds, Ww, Ww, Ww, Ww, Ww, Ww, Ww, Ww, Wo, Wwr, Wo, Ww, Wo, Ww, Wo, Wo, Wo, Ww, Wo, Ww, Ww, Ww, Ww, Ds, Ww, Ww, Ww, Ww, Wo, Wo, Wo
Gg, Ds, Gs, Gg, Gg, Gg, Gs, Gg^Es, Re, Rd, Re, Gs^Es, Gs, Gg^Vh, Gg, Ds, Ds, Ds, Gs, Gg, Gg, Gg, Gg, Gg, Gg, Ds, Gg, Ds, Gg, Ds, Ds, Ds, Ds, Ds, Ds, Ds, Ds, Ww, Ds, Ww, Ds, Ww, Ds, Ww, Ds, Ww, Ww, Ww, Ww, Ww, Ds, Ds, Ds, Ds, Ds, Ww, Ww^Vm, Ww, Wo, Wo
Gg, Gg, Gg, Gs, Gs, Gs, Gg, Gg, Gs, Re, Re, Re, Gs, Gg, Gs, Gs, Gg, Gs, Gs, Gg, Gs, Gs, Gg, Gg, Gg, Gg, Gg, Gs, Gs, Gs, Gs, Ds, Gs, Ds, Gs, Ds, Gg, Ds, Gg, Ds, Ds, Ds, Gg, Ds, Gg, Ds, Ds, Ds, Ds, Ds, Gg, Ds, Gg, Ds, Ds, Ds, Ww, Ww, Wo, Wo
Gg, Gs, Gg, Gs, Gs, Gs, Gs, Gs^Vh, Gs, Re, Re, Re, Gs, Gs, Gg, Gs, Gs, Gs, Gg, Gs, Gs, Gs, Gg, Gs, Gs, Gs, Gs, Gs, Gs, Gs, Hh^Fp, Gs, Hh^Fp, Gs, Gg, Gs, Gs, Gg, Gs, Gg, Gg, Gg, Gg, Gg, Gg, Gg, Gg, Gg, Gg, Gg, Gg, Gg, Gg, Gg, Gg, Ds, Ww, Wo, Wo, Wo
Gs, Gg, Gs, Gs, Ce, Gg, Gs, Gs, Gg, Gs, Re, Re, Gs, Gs, Gs, Gg, Gs, Gs, Gs, Gs, Gs, Gs, Gs, Gs, Gs, Gs, Gs, Gs, Gs, Gs, Gs, Hh^Fp, Gg, Gg, Hh^Fp, Gs, Gs, Gs^Vc, Gs, Gg, Gg, Gg, Gg, Gg, Hh, Hh, Mm, Hh, Hh, Gg, Gs, Gs, Gg, Gs, Gg, Ds, Ww, Wo, Wo, Wo
Gs, Gg, Gs, Ce, 5 Ke, Ce, Gs, Gs, Gs, Gs, Re, Re, Gs, Gs, Gs, Gs, Gs, Gs, Gs, Gs, Gg^Fp, Gs, Gs, Gs, Gg, Gs, Gs, Gs, Gs^Vc, Gs, Gs, Gs, Gs, Gg, Gs, Gs, Gs, Gs, Gs, Gg, Gs, Gg, Gg, Hh^Fp, Hh^Fp, Mm, Mm, Mm, Hh^Fp, Hh, Gg, Gs, Gg^Fp, Gg^Fp, Gg^Fp, Ds, Wo, Wo, Wo, Wo
Re, Re, Re, Ce, Ce, Ce, Re, Gs, Re, Re, Re, Re, Re, Gs, Gd, Gs, Gs, Gs^Fp, Gs^Fp, Gs^Fms, Gs, Gs, Gs, Gs, Gg, Gg, Gg^Fp, Gs, Gs, Gd, Gs, Gs, Gs, Gs, Gs, Gs, Gs, Gg, Gs, Gs, Gs, Gs, Gs, Gs, Gg, Hh, Hh^Fp, Hh, Gg^Fp, Hh, Gg, Gg^Ve, Gg, Gg^Fp, Ww, Ww, Wo, Wo, Ww, Ww
Gg, Gs, Gg, Re, Re, Re, Gs, Re, Gs, Gs, Gs, Re, Re, Gs, Gd, Gd, Gs, Gs, Gg^Fms, Gs^Fp, Gs, Gs, Gs, Gs, Gs, Gg, Gs, Gs, Gs, Gs, Gs, Gs, Gs, Gs, Gs, Gs, Gs, Gs, Gs, Gs, Gd, Gs, Gs, Gg, Gg, Gg, Gg, Gg, Gg, Gg, Gg, Gg^Fp, Gg^Fp, Ss, Ww, Ww, Ww^Vm, Wo, Ww, Ww
Gg, Gs, Gs, Gg, Gg, Gg, Gg, Gs, Gs, Gs, Gs, Re, Re, Gs, Gs, Gd, Gs, Gs, Gs, Gs, Gs, Gs^Vl, Gs, Gs, Gs, Gs, Gd, Gs, Gd, Gs, Gs, Gs, Gs, Gs, Gs, Gs, Gs, Gs, Gs, Gd, Gs, Gs, Gs^Vht, Gs, Gg, Gll^Fp, Gg, Gll^Fp, Ss, Ss, Gll^Fp, Ss, Ww, Ww, Wo, Wo, Ww, Ww, Gg^Fp, Gg^Fp
Gg, Gg, Gg, Gs, Gs, Gs, Gs, Gs, Gs, Gs, Gs, Re, Re, Re, Re, Gs, Gs, Gs, Gs, Gs, Gs, Gg, Gs, Gs, Gd, Gd, Gd, Gd, Gs, Gs, Gs, Gs, Gg, Gg, Gg, Gg, Gs, Gs, Gs, Gs, Gs, Gs, Gg, Gg^Em, Ss, Sm, Ss, Ss, Gg^Em, Ss, Gs^Fms, Ss, Ww, Ww, Wo, Wo, Ww, Gg^Fms, Gg^Fp, Gg^Fp
Gg, Gs, Gs, Gs, Gs, Gs, Gs, Gs, Gs, Gd, Gd, Gd, Gd, Re, Re, Re, Re, Gs, Gs, Gs, Gs, Gs, Gs, Gs, Gs, Gs, Gs, Gs, Gg, Gs, Gs, Gs, Gg^Fp, Gg, Gg, Gg, Gs, Gs, Gs, Gg, Gg, Gg, Ss, Ss, Ss, Sm, Ss, Chs, Chs, Chs, Ss, Ww, Wo, Wo, Wo, Ww, Gg^Fms, Gs^Fds, Gg, Gg
Gg, Gg, Gg, Gs, Gs, Gs, Gs, Gs, Gs, Gd, Gd, Gs, Gs, Gd, Gd, Re, Re, Gs, Gs, Gd, Gs, Gs, Gd, Gs, Gs, Gs, Gs, Gg, Gg^Fp, Gg^Fp, Gg^Fms, Gg^Fp, Gll^Fp, Gg^Fms, Gg, Gg^Fp, Gs, Gs, Gs, Gs, Gg, Ss, Ww, Ss, Ss^Vhs, Ss, Chs, 3 Khs, 8 Khs, Ss, Ww, Ww, Wo, Wo, Ww, Ww, Gg^Fp, Gg^Fp, Gg^Fp, Gg
Gg, Gg, Gs, Gs, Gs, Gs, Gg^Fp, Gg^Fp, Gg^Fp, Gs, Gs, Gd, Gs, Gd, Gs, Re, Re, Re, Re, Gs, Gs, Gs, Gs, Gd, Gs, Gs, Gs, Gg, Gs, Gg^Fp, Gg^Fp, Gg, Gg^Fms, Gs, Gs, Gg^Em, Gg^Fp, Gs, Gg^Fp, Gs, Gg^Em, Sm, Sm, Ww, Gll^Fp, Chs, Sm, Sm, Ww, Ss^Vhs, Wo, Wo, Wo, Ww, Gg^Fp, Gg^Fp, Gg^Fp, Gg, Gg^Fp, Gg^Fp
Gg, Gg, Gg, Gs, Gs, Gs, Gs, Gs, Gs, Gs, Gs^Vh, Gs, Gs, Gs, Gs, Gs, Gs, Re, Re, Re, Re, Gs, Re, Gs, Gs, Gs, Gs, Gs, Gs, Gs, Ce, Gg^Fp, Gg^Fp, Gs^Ve, Gg^Fp, Ss, Gg^Fp, Gg^Fms, Gg^Fp, Gg, Ss, Gg^Fp, Gg^Fp, Ss, Ss, Ss, Ww, Ww, Wo, Wo, Wo, Wo, Ww, Ww, Gg^Fp, Gg^Fp, Gll^Fp, Gg, Gg, Gg^Fp
Gg, Gg, Hh, Gg, Gg, Gs, Gs, Gs, Gd, Gs, Gs, Gs, Gs, Gs, Hh, Hh, Hh, Hh^Fp, Hh^Fp, Re, Re, Re, Re, Re, Re, Re, Re, Gs, Ce, Ce, 1 Ke, Ce, Ce, Gg^Fms, Gg, Gg, Gs, Gg, Gg, Gg, Gg^Fp, Ss, Ss, Sm, Ww, Ww, Wo, Wo, Ww, Wo, Ww, Ww, Gg^Fp, Gg^Fp, Gg^Fp, Gg^Fp, Gll^Fp, Gll^Fp, Gg^Fp, Gg
Hh, Hh, Gg, Gg, Mm, Gs, Gs, Gs, Gs, Gd, Gd, Gs, Gg, Hh, Mm, Mm, Mm, Hh^Fp, Hh^Fp, Gs, Gs, Re, Gs, Re, Re, Re, Re, Re, Re, Ce, Ce, Ce, Gg^Fp, Gg^Fp, Gg, Gs, Gs, Gs, Gs^Vht, Gg, Ww, Ss, Ww, Ww, Wo, Wo, Wo, Ww, Gg^Fp, Ww, Gg^Fp, Gg^Fp, Gll^Fp, Gll^Fp, Gg^Fp, Gll^Fp, Gg^Fp, Gg^Fp, Gg, Gg^Fp
Gg, Hh, Gg, Mm, Mm, Mm, Mm, Gg, Gs, Gd, Gd, Gs, Gg, Hh, Hh, Mm, Hh, Hh, Gg, Gs, Gs, Gs^Vht, Gs, Gg, Gs, Gs, Gs, Re, Re, Re, Re, Gg, Gg, Gg^Fp, Gg^Fp, Gs, Gs, Gs, Ww, Ww, Wo, Ww, Wo, Wo, Wo, Ww^Vm, Ww, Gg^Fp, Sm^Em, Gg^Fp, Gg^Fp, Gll^Fp, Gll^Fp, Gll^Fp, Gg^Fp, Gg, Gg, Gg^Fp, Gg^Fp, Gg
Mm, Hh, Hh, Mm, Mm, Mm, Mm, Gg, Gs, Gs, Gd, Gs, Gg, Gg, Gg, Hh, Gs, Gs, Gs, Gs, Gs, Gs, Gg, Gs, Gs, Gd, Gd, Gs, Gs, Re, Re, Re, Re, Gg, Gg, Gg, Ww, Ww, Wo, Wo, Ww, Wo, Ww, Ww, Wo, Ww, Ss, Gg^Em, Ss, Ww, Gg^Em, Gll^Fp, Gs^Fds, Gs^Fds, Gg^Fp, Gg^Fp, Gg^Fp, Gg^Fp, Gg^Fp, Gg^Fp
Mm, Mm, Mm, Hh^Vhh, Hh, Mm, Mm, Mm, Gs, Gs, Gs, Gs, Gs, Gg, Gs, Gs, Gs, Gs, Gs, Gs, Gs, Gs, Gs, Gs, Gs, Gs, Gs, Gs, Gs, Gg, Gg^Vh, Re, Re, Re, Ww, Ww, Wo, Wo, Ww, Ww, Gg^Fp, Ww, Gg^Fp, Ss, Wo, Ww, Gg^Fp, Ss, Ss, Sm^Em, Gg^Fms, Gg^Fp, Gg^Fp, Gg^Fp, Gll^Fp, Gg^Fp, Gll^Fp, Gg^Fp, Gg^Fp, Gg^Fp
Mm, Mm, Mm, Mm, Mm, Mm, Mm, Mm, Gs, Gs, Mm, Gg, Gg, Hh^Fp, Hh^Fp, Gg, Gs, Gs, Gs, Hh, Hh, Gg, Gs, Gs, Gg^Fp, Gs, Ww, Gg^Fp, Ww, Ww, Wo, Wo, Wo, Ww^Bsb\, Ww^Bsb\, Wo, Gg, Gg, Gg, Gg^Fms, Gs^Fds, Gg^Fp, Gg^Fp, Ss, Ww, Ww, Gg^Fp, Gll^Fp, Ss, Gg^Ve, Gg^Fms, Gg^Fms, Gll^Fp, Gll^Fp, Gll^Fp, Gll^Fp, Gs^Fds, Gll^Fp, Gll^Fp, Gll^Fp
Mm, Mm, Mm, Mm, Mm, Mm, Mm, Hh, Mm, Gs, Mm, Gg, Hh, Hh, Hh^Fp, Hh, Hh, Gs, Hh, Hh, Ww, Gg, Ww, Gg^Fp, Ww, Ww, Wo, Ww, Wo, Wo, Gg, Ww, Ww, Wo, Re, Re, Re, Gg, Gs, Gg^Fp, Gg^Fp, Gg^Fp, Gg^Fp, Ss, Ww, Ww, Gg^Fp, Gll^Fp, Ss, Gg, Gg^Fp, Gg^Fp, Gg^Fet, Gll^Fp, Gll^Fp, Gll^Fp, Gll^Fp, Gll^Fp, Gll^Fp, Gll^Fp
Wo, Wo, Wo, Ww, Ww, Mm, Mm, Hh, Hh, Mm, Hh, Hh, Hh, Hh^Fp, Hh, Hh, Wo, Hh, Ww, Ww, Wo, Ww, Wo, Ww^Vm, Gg^Fp, Wo, Gg^Fp, Wo, Gg, Gg, Gg, Gg, Gg, Gg, Gg, Re, Re, Re, Re, Gs, Gs^Ve, Gg, Gg^Fp, Ss, Ww, Ww, Gg^Fp, Gll^Fp, Gll^Fp, Gll^Fp, Gll^Fp, Gll^Fp, Gg^Fp, Gll^Fp, Gll^Fp, Gll^Fp, Gll^Fp, Gll^Fp, Gll^Fp, Gll^Fp
Wo, Wo, Wo, Wo, Wo, Ww, Ww, Ww, Ww, Ww, Ww^Bh|, Ww, Ww, Ww, Ww, Ww, Ww, Ww, Hh, Wo, Gg, Gg, Gg, Gg^Fp, Gg, Gg, Gg, Gg, Gg, Gg, Gs, Gg, Hh^Fp, Gg, Gg, Gg, Gg, Re, Re, Re, Gs, Gg^Fp, Gg, Ss, Ww, Ww, Gg^Fms, Gll^Fp, Gll^Fp, Gll^Fp, Gg^Fp, Gg, Gg^Fp, Gll^Fp, Gg^Fp, Gll^Fp, Gll^Fp, Gll^Fp, Gll^Fp, Gll^Fp
Mm, Mm, Mm, Mm, Mm, Ww, Mm, Ww, Mm, Ww, Hh, Ww, Mm, Ww, Hh, Hh, Hh^Fp, Hh, Hh, Gg, Gg, Gg, Gg, Gs, Gs, Gg, Gs, Gs, Gs, Gg, Gs, Gs, Gs, Hh^Fp, Gs, Gg, Gs, Gg, Re, Re, Gs, Gll^Fp, Gg^Fms, Gg^Fp, Gg^Fp, Ww, Ww, Gg^Fp, Gg^Fp, Gll^Fp, Gg^Fp, Gg^Fp, Gg^Fp, Gg^Fp, Gg^Fp, Gg^Fp, Gg^Fp, Gg^Fet, Gll^Fp, Gll^Fp
Mm, Mm, Mm, Mm^Vud, Mm, Mm, Hh, Mm, Mm, Mm, Hh, Hh, Mm, Mm, Hh, Hh, Hh, Hh, Hh, Hh, Hh, Hh^Fp, Hh^Fp, Gs, Gg, Gg, Gs, Gd, Gs, Gs, Gg, Gs, Gs, Gs, Gs, Gs, Gs, Gg, Re, Re, Re, Gg^Fp, Gg^Fp, Gll^Fp, Gg, Ww, Ww, Ww, Gg, Gg^Fp, Gg^Fp, Gs^Fds, Gg^Fet, Gs^Fds, Gg^Fp, Gg, Gll^Fp, Gll^Fp, Gll^Fp, Gll^Fp
Mm, Mm, Mm, Mm, Mm, Mm, Gg, Mm, Mm, Mm, Mm, Gg, Mm^Vud, Mm, Mm, Gg, Hh, Gg, Gs, Gs, Gs, Hh^Fp, Gg, Gg, Gs, Gs, Gg, Gg, Gs, Gs, Gs, Gg, Gs, Gs, Gs, Gs, Gs, Gs, Gd, Re, Re, Re, Re, Gg, Gg^Fp, Gg, Gg, Ww, Ww, Gg^Fp, Gg^Fp, Gg^Fds, Cv, Cv, Cv, Gg^Fds, Gg^Fp, Gll^Fp, Gll^Fp, Gll^Fp
Mm, Mm, Mm, Mm, Mm, Mm, Mm, Mm, Mm, Mm, Mm, Mm, Mm, Mm, Mm, Hh, Hh, Hh^Fp, Hh^Fp, Gs, Gd, Gd, Gs, Hh, Gg, Gg, Hh, Gg, Gs, Gg, Gs^Vh, Gs, Gg, Gs, Hh^Fp, Gg, Gg, Gs, Gs, Gd, Gd, Re, Re, Gs, Gg^Fp, Gg^Fp, Gg, Gg^Ve, Ww, Ww, Gg, Gg^Fds, Cv, 6 Kv, Cv, Gg^Fds, Gg^Fp, Gll^Fp, Gll^Fp, Gll^Fp
Mm, Mm, Mm, Mm, Ha^Vhha, Mm, Mm, Mm, Mm, Mm, Mm, Mm, Gg, Mm, Mm, Mm, Mm, Hh^Fp, Hh, Hh, Gs, Gs, Gd, Gs, Hh^Fp, Hh, Hh, Hh, Gs, Gg, Gs, Gg, Gg, Hh, Hh, Hh^Fp, Gs, Gs, Gd, Gd, Gd, Re, Re, Re, Re, Gg^Fp, Gg^Fp, Gg^Fp, Gg^Fp, Ww, Ww^Bw/, Gg, Gg^Fp, Cv, Gg^Fet, Gs^Fds, Gg^Fp, Gg^Fp, Gll^Fp, Gll^Fp
Mm, Mm, Mm, Mm, Mm, Mm, Cud, Cud, Cud, Hh, Hh, Mm, Mm, Mm, Mm, Mm, Mm, Mm, Hh, Hh, Hh, Hh, Hh, Hh^Fp, Hh, Hh^Fp, Hh, Hh^Fp, Gg, Gs, Gs, Gg, Gs, Gg, Gs, Gs, Gs, Gd, Gd, Gs, Gd, Re, Re, Gs, Gg^Fp, Re, Re, Re, Re, Ww^Bw/, Ww, Ww, Gg, Gs^Fds, Gg^Fms, Gg^Fp, Gg^Fp, Gg^Fp, Gg^Fp, Gg^Fp
Mm, Mm, Mm, Mm, Mm, Mm, Mm, Mm, 4 Kud, Cud, Cud, Mm, Mm, Mm, Gg, Mm, Mm, Mm, Hh, Hh, Mm, Gg, Mm, Mm, Mm, Hh, Gs, Hh, Hh, Hh, Gg, Gs, Gs, Gs, Gg, Hh^Fp, Hh^Fp, Gs, Gs, Gs, Gs, Re, Re, Gg, Gg^Fp, Gg, Gg^Fp, Gll^Fp, Gg^Fp, Gll^Fp, Gg^Fp, Ww, Ww, Gg, Gg, Gg, Gg^Fms, Gg^Fp, Gg^Fp, Gg^Fp
Mm, Mm, Mm^Xm, Mm, Mm, Mm, Mm, Mm, Mm, Mm, Mm, Cud, Mm, Mm, Mm, Mm, Mm, Mm, Mm, Mm, Mm, Mm, Mm, Mm, Mm, Hh, Gs, Hh, Gs, Gg, Gs, Gs, Gs, Gs, Gg, Gg, Gg, Gg, Gg, Gg, Gs, Re, Re, Gg^Fp, Gg^Fms, Gs^Fds, Gg^Fms, Gg^Fp, Gg, Gg^Fds, Gg^Fms, Gg^Fp, Ww, Ww, Ww, Gg^Fms, Gg^Fms, Gg^Fp, Gg^Fp, Gg^Fp
Mm, Mm, Mm, Mm, Mm, Mm, Mm, Mm, Mm, Mm, Mm, Cud, Mm^Vud, Hh, Gg, Mm, Mm, Mm, Gg, Mm, Mm, Mm, Mm, Mm, Hh, Hh, Gs, Gs, Gg, Gs, Gs, Gd, Gg, Gs, Gs, Gs, Gg, Gg^Fp, Gg^Fp, Gg, Gg, Re, Re, Gg, Gg, Gg^Fms, Gg^Fp, Gg^Fp, Gg^Fp, Ss, Gg^Fms, Gg^Fp, Gg, Ww, Ww, Gg^Fp, Gg^Fms, Gg^Fp, Gg^Fp, Gg^Fp
Mm, Mm^Xm, Mm^Xm, Mm, Mm, Mm^Xm, Mm^Xm, Mm, Mm, Mm, Mm, Mm, Mm, Mm, Mm, Mm, Mm, Mm, Mm, Mm, Mm, Mm, Mm, Mm, Hh^Vhh, Hh, Gs, Hh^Fp, Hh, Gs, Gg, Gs, Gs, Gs, Gg, Gg, Gg^Fp, Gg^Fp, Gg^Ve, Gg^Fp, Gg, Re, Re, Gg, Gg^Fp, Gg, Gg^Fp, Gg, Gg, Gg, Gg^Fet, Gg^Fp, Gg^Fms, Gg^Fp, Gg^Fp, Ww, Ww, Gg^Fp, Gg^Fp, Gg^Fp
Mm^Xm, Mm^Xm, Mm^Xm, Mm^Xm, Mm, Mm^Vud, Mm, Mm^Xm, Mm^Xm, Mm, Mm, Mm, Mm, Hh, Mm, Mm, Mm, Mm, Mm, Mm, Mm, Mm, Mm, Mm, Mm, Gs, Gs, Hh, Gg, Gs, Gg, Ce, Ce, Gs, Ce, Ce, Gg, Gg^Fp, Gg, Gg^Fp, Gg, Re, Re, Gg^Fp, Gg, Gg^Ve, Gg^Fp, Gg^Fp, Gg^Fp, Gg^Fp, Gg^Fp, Gg, Gs^Fds, Gll^Fp, Gs^Fds, Ww, Ww, Ww, Ww, Ww
Mm^Xm, Mm^Xm, Mm^Xm, Mm, Mm, Mm, Mm, Mm^Xm, Mm, Mm, Mm, Mm, Mm, Mm, Mm, Mm, Mm, Mm, Mm, Mm, Mm, Hh, Mm, Mm, Hh, Hh, Gg, Gs, Gs, Gs, Gg, Gg, Ce, 2 Ce^Kov, Ce, Gs, Gs, Gg, Gs, Gg, Gd, Re, Re, Gg^Fp, Gg^Fp, Gg, Gg, Gg, Gg^Fms, Gll^Fp, Gg^Fp, Gg^Fms, Gg, Gll^Fp, Gs^Fds, Gs^Fds, Gg, Gg^Fp, Gg^Fp, Ww
Mm^Xm, Mm^Xm, Mm^Xm, Mm^Xm, Mm^Xm, Mm^Xm, Mm^Xm, Mm, Mm, Mm, Mm, Mm, Mm, Mm, Mm, Mm, Mm, Mm, Mm, Mm^Vud, Mm, Mm, Mm, Mm, Mm, Hh, Hh, Gs, Gg, Gs, Gg, Gg, Gg, Gg, Gg, Gg, Gg, Gs, Gs, Gd, Gd, Re, Re, Gg, Gg, Gg, Gg^Fp, Gg, Gg, Gg^Fp, Gg, Gg^Fms, Gs^Vl, Gg, Gg^Fp, Gg^Fp, Gg^Fp, Gg^Fp, Gg, Gg
Mm, Mm^Xm, Mm, Mm^Xm, Mm, Mm^Xm, Mm^Xm, Mm^Xm, Mm, Mm^Xm, Mm, Mm, Mm, Mm, Gg, Mm, Gg, Mm, Mm, Mm, Mm, Mm, Mm, Mm, Mm, Gg, Hh, Hh, Gg, Gg, Gg, Gg, Gg, Gll^Fp, Gll^Fp, Gg^Fp, Gg, Gg^Fp, Gg, Gs, Gll^Fp, Re, Re, Gg, Gll^Fp, Gg, Gg, Gg, Gg, Gg^Fp, Gg^Fp, Gg, Gll^Fp, Gg, Gg^Fp, Gg^Fp, Gg, Gg, Gg, Gg
