Wo, Wo, Wo, Wo, Wo, Wo, Wo, Wo, Wo, Wo, Wo, Wo, Wo, Wo, Wo, Wo, Wo, Wo, Wo, Wo, Wo, Wo, Wo, Wo, Wo
Wo, Wo, Wo, Wo, Wo, Wo, Wo, Wo, Wo, Wo, Wo, Wo, Wo, Wo, Wo, Wo, Wo, Wo, Wo, Wo, Wo, Wo, Wo, Wo, Wo
Wo, Wo, Wo, Wo, Wo, Wo, Wo, Wo, Wwt, Wo, Wwrt, Wwt, Wwt, Wo, Wo, Wo, Wo, Wo, Wo, Wo, Wo, Wo, Wo, Wo, Wo
Wo, Wo, Wo, Wo, Wwt, Wwt, Wwrt, Wwt, Wwt, Dd, Dd^Do, Wwrt, Wwt, Wwt, Wo, Wo, Wo, Wo, Wo, Wo, Wo, Wo, Wo, Wo, Wo
Wo, Wo, Wwt, Wwt, Wwt^Vm, Wwrt, Ds, Ds, Ds, Wwt, Gs^Ft, Dd, Wwt, Wwt, Wwt, Wo, Wo, Wo, Wo, Wo, Wo, Wo, Wo, Wo, Wo
Wo, Wo, Wwt, Wwt, Ds, Wwt, Ss, Gs^Ft, Gs^Ft, Wwt, Gs^Ft, Wwt, Ds, Wwrt, Wwrt, Wwt, Wo, Wo, Wo, Wo, Wwr, Wo, Wo, Wo, Wo
Wo, Wo, Wwt, Wwrt, Wwt, Wwt, Wwt, Gs^Ft, Wwt, Wwt, Wwt, Gs^Ft, Ds, Wwrt, Wwt, Wwt, Wo, Wo, Wo, Wwr, 1 Kme, Wwr, Wo, Wo, Wo
Wo, Wo, Wo, Wwt, Dd, Dd, Gs^Ft, Wwt, Ss, Ss, Ds, Wwt, Wwt, Ds, Wwt, Wo, Wo, Wo, Wo, Cme, Wwr, Wwr, Wo, Wo, Wo
Wo, Wo, Wo, Wwt, Wwrt, Dd, Dd, Gs^Ft, Dd, Gs^Ft, Gs^Ft, Ds, Wwt^Vm, Wwt, Wwt, Wwt, Wwt, Wo, Wo, Wo, Wo, Wo, Wo, Wo, Wo
Wo, Wo, Wo, Wwt, Wwt, Wwrt, Wwrt, Dd^Do, Wwrt, Ds, Wwt, Wwt, Wwt, Wwt, Wwt, 2 Wwt, Wwt, Wo, Wo, Wo, Wo, Wo, Wo, Wo, Wo
Wo, Wo, Wo, Wo, Wo, Wwt, Wwt, Wwrt, Wwt, Wwrt, Wwt, Wwt, Wo, Wwt, Wo, Wwt, Wo, Wo, Wo, Wo, Wo, Wo, Wo, Wo, Wo
Wo, Wo, Wo, Wo, Wo, Wo, Wo, Wo, Wo, Wwt, Wo, Wo, Wo, Wo, Wo, Wo, Wo, Wo, Wo, Wo, Wo, Wo, Wo, Wo, Wo
Wo, Wo, Wo, Wo, Wo, Wo, Wo, Wo, Wo, Wo, Wo, Wo, Wo, Wo, Wo, Wo, Wo, Wo, Wo, Wo, Wo, Wo, Wo, Wo, Wo
Wo, Wo, Wo, Wo, Wo, Wo, Wo, Wo, Wo, Wo, Wo, Wo, Wo, Wo, Wo, Wo, Wo, Wo, Wo, Wo, Wo, Wo, Wo, Wo, Wo
