Ww, Ww, Ww, Ww, Ww, Ww, Gs^Fp, Ss, Ss, Ss, Ss, Ss, Gg^Efm, Ss, Ss, Ss, Ss, Ss, Ss, Ss
Ww, Ww, Ww, Ww, Ww, Ww, Gs^Fp, Ss, Gs^Fp, Gs^Fp, Ss, Gg^Efm, Gg^Efm, Gg^Efm, Ss, Ss, Ss^Vm, Ww, Ss, Ss
Ww, Ww, Ww, Ww, Ds, Gs^Ft, Rd, Ss, Ss, Ss, Gs^Fp, Gg^Efm, Gs^Fp, Ss, Chs, Ss, Ss, Ss, Ss, Ss
Ww, Ww, Ww, Ww, Ww, Ww, Gs^Fp, Ss, Gs^Fms, Gs^Fp, Wo, Gs^Fms, Gs^Fp, Ss, Ss, Ss, Re^Uf, Gs^Fms, Gs^Fp, Ss
Ww, Ww, Ss, Gs^Fp, Re^Uf, Gs^Fp, Gs^Fp, Ss, Gs^Fms, Wo, Wo, Wo, Gs^Fp, Ss, Ss, Re, Re^Uf, Gs^Fms, Ss, Ss
Ww, Ww, Ss, Re^Uf, Ss, Gs^Fp, Gg^Efm, Re, Ss, Gs^Fp, Gs^Fp, Gs^Fp, Ss, Ss, Ss, Ss, Ss, Ss, Ss, Ss
Ww, Ww, Gs^Fp, Ss, Ww, Ss, Ss, Ss, Gs^Fms, Gs^Fp, Re^Uf, Ss, Ss, Ww, Ss, Ss, Qxe, Ss, Ss, Ss
Ss, Gs^Fp, Gs^Fp, Ss, Ss, Ss, Gs^Fp, Gs^Fp, Gs^Fp, Gs^Fp, Gs^Fp, Ss, Gg^Efm, Ss, Qxe, Qxe, Gs^Fp, Qxe, Ss, Ss
Ss, Re^Uf, Gs^Fp, Ss^Vhs, Gs^Fp, Gs^Fms, Gs^Fp, Gs^Fms, Ww, Gs^Fp, Gs^Fms, Ss, Ss, Ss, Gs^Fp, Gs^Fp, Ss^Vhs, Gs^Fp, Hh, Gs^Fp
Ss, Re^Uf, Gs^Fms, Gs^Fms, Gs^Fp, Hh, Gs^Fp, Ww, Ww, Gs^Fp, Gs^Fds, Gs^Fms, Gs^Fp, Ss, Ss, Ss, Gs^Fp, Gs^Fms, Hh, Gs^Fp
Ww, Ss, Gs^Fp, Gs^Fms, Gs^Fp, Gs^Fp, Ss, Gs^Fp, Gs^Fp, Gs^Fp, Gs^Fms, Gs^Fp, Gs^Fp, Ss, Ss, Ss, Ss, Gs^Fp, Gs^Fp, Gs^Fp
Ww, Ss, Gg^Efm, Ss, Ss, Ss, Ss, Ss, Ss, Gs^Fp, Ss, Ss, Gs^Fp, Ss, Gs^Fp, Gs^Fp, Gs^Fms, Gs^Fds, Ss, Ss
Gs, Gs, Ss, Ss, Ss, Ss, Ss, Ss, Gg^Vc, Ss, Gs^Fp, Ss, Ss, Ss, Gs^Fp, Hh, Gs^Fds, Re^Uf, Ss, Ss
Ww, Gs, Gs, Gs^Fp, Ss, Gs^Fp, Gs^Fp, Gg^Efm, Ss, Ss, Gs^Fms, Gs^Fp, Ss, Ss, Chs, Gs^Fp, Ss, Ss, Ss, Ss
Ww, Ww, Gs^Ft, Ss, Ss, Re^Uf, Gs^Fp, Ss, Ss, Ss, Ss, Gs^Fms, Ss, Gs^Fp, Ss, Ss, Ww, Ww, Ss, Ss
Ww, Ww, Gs^Ft, Dd^Do, Ss, Gs^Fp, Ss, Ss, Ss, Ss, Gs^Fp, Ss, Ss, Ss, Gs^Fp, Ss, Ww, Ww, Ww, Ss
Ww, Ww, Gs^Ft, Gs^Ft, Ww, Ss, Ss, Ss, Re, Re^Uf, Gs^Fms, Gs^Fp, Gs^Fds, Gs^Fms, Gs^Fp, Ss, Ss, Ww, Ss, Ss
Ww, Ww, Ww, Gs^Ft, Ww, Ww, Gs^Fp, Ss, Gs^Fms, Gs^Fp, Gs^Fp, Ss, Ss, Gs^Fp, Gs^Fp, Gs^Fp, Ss, Ss, Ss, Ss
Ww, Ww, Ww, Gs^Ft, Gs^Ft, Ww, Gs^Fp, Gs^Fms, Gs^Fms, Gs^Fp, Ww, Ss, Gs^Fp, Gs^Fp, Ss, Ss, Gs^Fp, Gs^Fp, Ss, Ss
Ww, Ww, Ww, Ww, Gs, Gs^Fp, Ww, Ss, Ss, Gs^Fp, Ss, Ww, Ss^Vhs, Ss, Ss, Re, Re^Uf, Gs^Fms, Gs^Fms, Ss
Ww, Ww, Ww, Ww, Ss, Ss, Ss, Ss, Ss, Ss, Qxe, Ss, Ss, Ss, Gs^Fp, Ss, Ss, Ss, Chs, Ss
Ww, Ww, Ww, Ww, Chw, Ss, Ss, Ss, Ss, Qxe, Qxe, Qxe, Ss, Ss, Gs^Fms, Ss, Ss, Ss, Ss, Ss
Ww, Ww, Ww, Ww, 1 Khw, Chs, Ss, Ss, Ss, Ss, Ss, Ss, Re, Ss, Ss, Ss, Gs^Fp, Gs^Fp, Gs^Fp, Ss
Ww, Ww, Ww, Ww, Ww, Ss, Ss, Gs^Fp, Gs^Fms, Gs^Fp, Gs^Fp, Re^Uf, Re^Uf, Ss, Ss, Gg^Efm, Gg^Efm, Hh, Gs^Fms, Ss
Ww, Ww, Ww, Ww, Ww, Ww, Ss, Ss, Ss, Gs^Fms, Ss, Gs^Fp, Ss, Ss, Gg^Efm, Gg^Vc, Gg^Efm, Hh, Gs^Fp, Ss
Ww, Ww, Ww, Ww, Ww, Ww, Gs^Fp, Ss, Ss, Ss, Ss, Ss, Ss, Ss, Ss, Gg^Efm, Ss, Ss, Ss, Ss
