Wo, Wo, Wo, Wo, Wo, Wo, Wo, Wo, Wo, Ww, Ww, Ww, Ds, Ds, Gg, Gg, Re^Gvs, Re^Gvs, Re^Gvs, Re^Gvs, Re^Gvs, Re^Gvs, Re^Gvs, Gg, Gg, Gs^Fp, Gs^Fp, Gs^Fp, Re^Gvs, Re^Gvs, Re^Gvs, Re^Gvs, Rr, Gg, Gg, Gg, Gg, Re, Re
Wo, Wo, Wo, Wo, Wo, Wo, Wo, Wo, Wo, Ww, Ww, Ww, Ww, Ds, Ds, Ch, Gg^Vh, Re^Gvs, Re^Gvs, Re^Gvs, Re^Gvs, Re^Gvs, Re^Gvs, Re^Gvs, Gs^Fp, Gs^Fp, Gg, Gg, Gg^Vh, Re^Gvs, Re^Gvs, Rr, Re^Gvs, Re^Gvs, Gg^Vh, Gg, Re, Re, Re
Wo, Wo, Wo, Wo, Wo, Wo, Wo, Wo, Wo, Ww, Ww, Ww, Ww, Ds, Ds, Gg, Re^Gvs, Re^Gvs, Re^Gvs, Re^Gvs, Re^Gvs, Re^Gvs, Re^Gvs, Re^Gvs, Gg^Vh, Gg, Gg, Gg, Gg, Re^Gvs, Gg, Rr, Rr, Re^Gvs, Gg, Gg, Re, Re, Gg
Wo, Wo, Wo, Wo, Wo, Wo, Wo, Wo, Wo, Ww, Ww, Ww, Ww, Ds, Ds, Ch, Re^Gvs, Re^Gvs, Re^Gvs, Re^Gvs, Gg^Vh, Ch, Gg, Ch, Ds, Gg, Ds, Ch, Ds, Gg, Ch, Gg, Gg, Rr, Gg, Gg, Gg, Gg, Gs^Fp
Wo, Wo, Wo, Wo, Wo, Wo, Wo, Wo, Wo, Ww, Ww, Ww, Ww, Ww, Ds, Ds, Gg, Re^Gvs, Gg, Ch, Ds, Ds, Ww^Bw|, Ds, Ww, Ww^Bw/, Ds, Ds, Ww^Bw/, Ds, Ds, Ds, Gg^Vh, Rr, Rr, Gg, Re^Gvs, Gs^Fp, Gg^Efm
Wo, Wo, Wo, Wo, Wo, Wo, Wo, Wo, Wo, Wo, Ww, Ww, Ww, Ww, Ds, Ds, Ch, Gg, Gg, Ds, Ww, Ww, Ww, Ww, Ww, Ww, Ww, Ww^Bw/, Ww, Ww, Ww^Bw/, Ds, Ch, Gg, Rr, Re^Gvs, Re^Gvs, Re^Gvs, Gg^Efm
Wo, Wo, Wo, Wo, Wo, Wo, Wo, Wo, Wo, Wo, Wo, Ww, Ww, Ww, Ww, Ds, Ch, Ch, Ds, Ww^Bw\, Ww, Ww, Ww, Wo, Wo, Wo, Wo, Ww, Ww, Ww^Bw/, Ww, Ds, Ds, Gg, Rr, Re^Gvs, Re^Gvs, Re^Gvs, Gg
Wo, Wo, Wo, Wo, Wo, Wo, Wo, Wo, Wo, Wo, Wo, Ww, Ww, Ww, Ww, Ds, Ds, Ds, Ww, Ww, Ww, Ww, Wo, Wo, Wo, Wo, Wo, Wo, Ww, Ww, Ww^Bw\, Ww, Ds, Gg, Rr, Gg, Gg, Gg^Vh, Gg
Wo, Wo, Wo, Wo, Wo, Wo, Wo, Wo, Wo, Wo, Wo, Ww, Ww, Ww, Ds, Ds, Ch, Ds, Ww, Ww, Ww, Ww, Wo, Wo, Wo, Wo, Wo, Wo, Ww, Ww, Ww, Ww^Bw\, Ds, Ch, Gg, Re, Gg, Gg, Re
Wo, Wo, Wo, Wo, Wo, Wo, Wo, Wo, Wo, Wo, Wo, Ww, Ww, Ww, Ww, Ds, Ch, Ch, Ww, Ww, Ww, Wo, Wo, Wo, Wo, Wo, Wo, Wo, Ww, Ww, Ww^Bw\, Ds, Gg, Gg, Re, Gg, Gg, Gg, Gg
Wo, Wo, Wo, Wo, Wo, Wo, Wo, Wo, Wo, Wo, Wo, Ww, Ww, Ww, Ww, Ds, Ww, Ds, Ww, Ww, Ww, Wo, Ww, Ww, Ww, Ww, Ww, Ww, Ww^Bw\, Ww, Ds, Gg, 2 Kh, Ch, Re, Re, Re, Re, Gs^Fp
Wo, Wo, Wo, Wo, Wo, Wo, Wo, Wo, Wo, Wo, Wo, Wo, Wo, Ww, Ww, Ww, Ww, Ww, Ww, Ww, Wo, Wo, Ww, Ww, Ww, Ww, Ds, Ww, Ds, Ww^Bw\, Ds, Ch, Ch, Ch, Re, Re, Gs^Fp, Gs^Fp, Gs^Fp
Wo, Wo, Wo, Wo, Wo, Wo, Wo, Wo, Wo, Wo, Wo, Wo, Wo, Ww, Ww, Ww, Ww, Ww, Ww, Wo, Wo, Wo, Ww, Ww, Ww, Ds, Ch, Ds, Ds, Ds, Ch, Gg, Gg, Re, Re, Gs^Fp, Gs^Fp, Gs^Fp, Re
Wo, Wo, Wo, Wo, Wo, Wo, Wo, Wo, Wo, Wo, Wo, Wo, Wo, Wo, Wo, Ww, Wo, Wo, Wo, Wo, Wo, Ww, Ww, Ww, Ww, Ch, Ds, Ds, Ds, Ds, Ds, Gg^Efm, Gg, Gg, Gg, Gg, Gg^Vh, Re, Re
Wo, Wo, Wo, Wo, Wo, Wo, Wo, Wo, Wo, Wo, Wo, Wo, Wo, Wo, Wo, Wo, Wo, Wo, Wo, Wo, Wo, Ww, Ww, Ww, Ww, Ww, Ww, Ww, Ww, Ds, Ww, Ds, Ds, Ch, Gg, Re, Re, Gg, Gg
Wo, Wo, Wo, Wo, Wo, Wo, Wo, Wo, Wo, Wo, Wo, Wo, Wo, Wo, Wo, Wo, Wo, Wo, Wo, Wo, Wo, Wo, Wo, Ww, Ww, Ww, Ww, Ww, Ww, Ww, Ww, Ds, Ww, Ds, Ds, Gg, Ch, Gg, Gg
Wo, Wo, Wo, Wo, Wo, Wo, Wo, Wo, Wo, Wo, Wo, Wo, Wo, Wo, Wo, Wo, Wo, Wo, Wo, Wo, Wo, Wo, Wo, Ww, Ww, Ww, Ww, Ww, Ww, Ww, Ww, Ww, Wo, Ww, Ww, Ds, Gg, Gg^Efm, Re^Gvs
Wo, Wo, Wo, Wo, Wo, Wo, Wo, Wo, Wo, Wo, Wo, Wo, Wo, Wo, Wo, Wo, Wo, Wo, Wo, Wo, Wo, Wo, Wo, Wo, Wo, Ww, Wo, Wo, Wo, Wo, Wo, Wo, Wo, Wo, Ww, Ds, Gg, Re^Gvs, Re^Gvs
Wo, Wo, Wo, Wo, Wo, Wo, Wo, Wo, Wo, Wo, Wo, Wo, Wo, Wo, Wo, Wo, Wo, Wo, Wo, Wo, Wo, Wo, Wo, Wo, Wo, Wo, Wo, Wo, Wo, Wo, Wo, Wo, Wo, Wo, Ww, Ww, Ce, Re^Gvs, Re^Gvs
Wo, Wo, Wo, Wo, Wo, Wo, Wo, Wo, Wo, Wo, Wo, Wo, Wo, Wo, Wo, Wo, Wo, Wo, Wo, Wo, Wo, Wo, Wo, Wo, Wo, Wo, Wo, Wo, Wo, Wo, Wo, Wo, Wo, Wo, Ww, Ce, 1 Ke, Ce, Re^Gvs
Wo, Wo, Wo, Wo, Wo, Wo, Wo, Wo, Wo, Wo, Wo, Wo, Wo, Wo, Wo, Wo, Wo, Wo, Wo, Wo, Wo, Wo, Wo, Wo, Wo, Wo, Wo, Wo, Wo, Wo, Wo, Wo, Wo, Ww, Ds, Ce, Ce, Ce, Re^Gvs
Wo, Wo, Wo, Wo, Wo, Wo, Wo, Wo, Wo, Wo, Wo, Wo, Wo, Wo, Wo, Wo, Wo, Wo, Wo, Wo, Wo, Wo, Wo, Wo, Wo, Wo, Wo, Wo, Wo, Wo, Wo, Wo, Wo, Ww, Ds, Ds, Re^Gvs, Re^Gvs, Re^Gvs
