Wo, Wo, Wo, Wo, Wo, Wo, Wo, Wo, Wo, Wo, Wwt, Wwt, Wwt, Wwt, Ds, Ds, Wwt, Hd, Md, Md^Xm, Md^Xm, Md^Xm, Md^Xm, Md^Xm, Hd, Md, Wwrt, Wo, Wo, Wo, Wo, Wo, Wo, Wo, Wo
Wo, Wo, Ds, Wwrt, Wwt, Wo, Wo, Wo, Wo, Wo, Wwt, Wwt, Wwt, Wwt, Wwt, Dd^Vda, Wwt, Hd, Wwt, Md, Hd, Md, Hd, Md, Wwrt, Wwrt, Wwrt, Wwt, Wo, Wo, Wo, Wo, Wo, Wo, Wo
Wo, Wwt^Vm, Wwrt, Wwrt, Wwt, Wwrt, Wwrt, Wo, Wo, Wo, Wo, Wwt^Vm, Wo, Wwt, Wwt, Dd, Wwt, Wwt, Hd, Wwt, Wwt, Wwt, Gs^Ft, Gs^Ft, Wwt, Wwrt, Wwt^Vm, Wwrt, Wo, Wo, Wo, Wo, Wo, Wo, Wo
Wo, Wo, Wo, Wwrt, Dd, Dd, Chw, Wwt, Wwt, Wo, Wo, Wo, Wo, Wo, Wo, Wwt, Wwrt, Hd, Md, Md^Xm, Md^Xm, Gs^Vht, Wwt, Gs^Ft, Wwt, Wwt, Wo, Wo, Wo, Wo, Wo, Wo, Wo, Wo, Wo
Wo, Wo, Wo, Wwrt, Dd, 2 Khw, Chw, Dd, Wwt, Wo, Wo, Wo, Wo, Wo, Wo, Wwt, Wwrt, Dd, Hd, Md^Xm, Md, Hd, Wwrt, Wwt, Wwt, Wo, Wo, Wo, Wo, Wo, Wo, Wo, Wo, Wo, Wo
Wo, Wo, Wo, Wwt, Wwt, Dd, Dd, Dd, Wwt, Wo, Wo, Wo, Wo, Wo, Wo, Wwt, Wwt, Dd^Do, Wwrt, Dd, Wwrt, Wwrt, Wwrt, Wwrt, Wwt, Wo, Wo, Wo, Wo, Wo, Wo, Wo, Wo, Wo, Wo
Wo, Wo, Wo, Wo, Wo, Wwt, Wwt, Wwt, Wo, Wo, Wo, Wo, Wo, Wo, Wo, Wo, Wo, Wwt, Wwt, Wwrt, Wwt, Wwrt, Ww, Wwrt, Wwt, Wo, Wo, Wo, Wo, Wo, Wo, Wo, Wo, Wo, Wo
Wo, Wo, Wo, Wo, Wo, Wo, Wo, Wo, Wo, Wo, Wo, Wo, Wo, Wo, Wo, Wo, Wo, Wo, Wo, Wwt, Wwt, Dd, Dd, Dd^Dc, Dd, Wwt, Wwt, Wo, Wo, Wo, Wo, Wo, Wo, Wo, Wo
Wo, Wo, Wo, Wo, Wwt, Wo, Wo, Wo, Wwt^Vm, Wo, Wo, Wo, Wo, Wo, Wo, Wo, Wo, Wo, Wo, Wo, Wo, Wwt, Wwrt, Wwrt, Wwrt, Dd^Vda, Wwt, Wwt, Wwt, Wo, Wo, Wo, Wo, Wo, Wo
Wo, Wo, Wo, Wwt, Wwrt, Wwt, Wwrt, Wwt, Wwrt, Wwt, Wwt, Wo, Wo, Wo, Wo, Wo, Wo, Wo, Wo, Wo, Wo, Wo, Wwt, Wwrt, Wwrt, Wwt, Dd, Wwt, Wwt, Wwt, Wwt, Wo, Wo, Wo, Wo
Wo, Wo, Wwt, Wwrt, Wwrt, Wwrt, Ds, Wwrt, Dd, Wwrt, Wwrt, Wo, Wo, Wo, Wo, Wo, Wwt^Vm, Wo, Wo, Wo, Wo, Wo, Wwt, Wwt, Wwt, Dd, Gs^Ft, Wwt, Wwt, Ds, Ds, Wwt, Wo, Wo, Wo
Wo, Wo, Wwt, Wwrt, Wwrt, Ds, Gs^Ft, Gs^Ft, Mm^Xm, Wwrt, Wwrt, Wwt, Wo, Wo, Wo, Wwt, Wwrt, Wwrt, Wo, Wo, Wo, Wwt, Wwt, Wwrt, Dd, Gs^Ft, Wwt, Gs^Ft, Ds, Ds, Chw, Wwt, Wo, Wo, Wo
Wo, Wo, Wo, Wwrt, Wwrt, Ds, Gs^Ft, Mm^Xm, Hh, Gs^Ft, Wwrt, Wwt, Wwt, Wo, Wo, Wo, Wo, Wwrt, Wo, Wo, Wo, Wo, Wo, Wwrt, Wwt, Dd, Dd, Ds, Ds, Ds, 1 Khw, Wwt, Wo, Wo, Wo
Wo, Wo, Wo, Wwt, Wwt, Wwrt, Dd^Vda, Gs^Ft, Dd, Wwrt, Wwrt, Wwrt, Wwt, Wo, Wo, Wo, Wo, Wo, Wwt, Wo, Wwt, Wo, Wo, Wo, Wo, Wwt, Chw, Chw, Chw, Chw, Wwrt, Wwrt, Wo, Wo, Wo
Wo, Wo, Wo, Wo, Wo, Wwrt, Wwrt, Dd^Do, Wwrt, Wwrt, Wwt, Wwt, Wo, Wo, Wo, Wo, Wwt, Wwt, Wwrt, Wwrt, Wwrt, Wwt, Wo, Wo, Wo, Wo, Wo, Wwrt, Wwrt, Wwrt, Wwrt, Wo, Wo, Wo, Wo
Wo, Wo, Wo, Wo, Wo, Wo, Wo, Wwt, Wo, Wo, Wo, Wo, Wo, Wo, Wo, Wo, Wo, Wwrt, Dd, Ss^Vhs, Ss, Wwt, Wwt, Wo, Wo, Wo, Wwt^Vm, Wwt, Wwrt, Wwt, Wo, Wo, Wo, Wo, Wo
Wo, Wo, Wo, Wo, Wo, Wo, Wo, Wo, Wo, Wo, Wo, Wo, Wo, Wo, Wo, Wo, Wo, Wwt, Dd, Dd, Dd, Wwt, Wwt, Wo, Wo, Wwt, Wwt, Wwt, Wwt, Wo, Wo, Wo, Wo, Wo, Wo
