Xu, Rp, Uu^Ii, Xu, Xu, Xu, Xu, Xu, Xu, Xu, Xu, Xu, Xu, Xu, Xu, Xu, Xu, Xu, Xu, Xu, Xu, Xu, Uu^Ii, Rp, Uu^Ii, Uu^Ii
Xu, Rp, Uu^Ii, Xu, Xu, Xu, Xu, Xu, Xu, Xu, Xu, Xu, Xu, Xu, Xu, Xu, Xu, Xu, Xu, Xu, Xu, Xu, Uu^Ii, Rp, Uu^Ii, Xu
Xu, Rp^Ii, Uu^Ii, Xu, Xu, Xu, Xu, Xu, Xu, Rr, Rr, Rr, Rr, Rr, Xu, Xu, Xu, Xu, Xu, Xu, Xu, Xu, Uu^Vud, Rp^Ii, Uu^Ii, Xu
Xu, Rp^Ii, Rp, Uu^Ii, Xu, Xu, Xu, Xu, Xu, Rr, Rr, Rr, Rr, Rr, Xu, Xu, Xu, Xu, Xu, Xu, Uu^Ii, Uu^Ii, Rp, Rp^Ii, Uu^Vud, Xu
Xu, Uu^Vud, Rp^Ii, Uu^Ii, Xu, Xu, Xu, Xu, Xu, Rr, Xu, Rr, Xu, Rr, Xu, Xu, Xu, Xu, Uu^Ii, Uu^Ii, Rp, Rp, Uu^Ii, Uu^Ii, Xu, Xu
Xu, Xu, Rp^Ii, Uu, Xu, Xu, Xu, Xu, Xu, Xu, Uu, Rr, Uu, Xu, Xu, Xu, Xu, Xu, Uu, Rp, Uu, Uu, Uu^Ii, Xu, Xu, Xu
Xu, Xu, Rp, Uu, Uu, Xu, Uu^Ii, Xu, Uu^Ii, Uu, Cud, Rr, Cud, Uu, Uu, Xu, Xu, Uu^Ii, Uu^Vud, Rp, Uu^Vud, Uu^Ii, Xu, Xu, Xu, Xu
Xu, Xu, Rp^Ii, Uu^Vud, Rr, Uu, Uu^Vud, Uu^Ii, Cud, Cud, Rr, Rr, Rr, Cud, Cud, Uu, Uu, Uu, Rr, Rr, Uu^Ii, Uu^Ii, Xu, Xu, Xu, Xu
Xu, Xu, Xu, Rp, Uu^Vud, Rr, Rr, Cud, Rr, Rr^Vud, Cud, Cud^Ebn, Cud, Rr^Vud, Rr, Cud, Rr, Rr, Uu^Vud, Uu^Ii, Xu, Xu, Xu, Xu, Xu, Xu
Xu, Xu, Xu, Xu, Xu, Xu, Xu, Rr, Cud^Ebn, Cud, Cud, Cud, Cud, Cud, Cud^Ebn, Rr^Ii, Cud, Uu, Uu, Uu^Ii, Xu, Xu, Xu, Xu, Xu, Xu
Xu, Xu, Xu, Xu, Xu, Xu, Xu, Xu, Cud, Cud, Cud, Cud, Cud, Cud, Cud, Rr, Cud, Uu, Xu, Xu, Xu, Xu, Xu, Xu, Xu, Xu
Xu, Xu, Xu, Xu, Xu, Xu, Xu, Xu, Cud, Cud, Cud, 2 Kud, Cud, 1 Cud, Cud, Rr, Cud, Uu, Xu, Xu, Xu, Xu, Xu, Xu, Xu, Xu
Xu, Xu, Xu, Xu, Xu, Xu, Xu, Xu, Cud^Ebn, Cud, Cud, Cud, Cud, Cud, Cud^Ebn, Rr, Cud, Uu^Vud, Xu, Xu, Xu, Xu, Xu, Xu, Xu, Xu
Xu, Xu, Xu, Xu, Xu, Xu, Rr^Ii, Rr, Rr, Cud, Cud, Cud, Cud, Cud, Rr, Rr, Rr, Uu, Uu^Ii, Xu, Xu, Xu, Xu, Xu, Xu, Xu
Xu, Xu, Uu^Vud, Xu, Rr, Rr, Uu, Cud, Cud, Rr^Vud, Rr, Cud^Ebn, Rr, Rr^Vud, Cud, Cud, Uu, Rr, Rr, Uu^Ii, Xu, Xu, Xu, Xu, Xu, Xu
Uh, Uh^Ii, Uu, Rp^Ii, Uh, Uu^Vud, Uu, Uu, Uu, Cud, Cud, Rr, Cud, Cud, Uu, Uu, Uu^Vud, Uu, Rr, Uu, Uu^Ii, Xu, Xu, Xu, Xu, Xu
Uu^Ii, Uu, Rp, Rp^Ii, Uu^Ii, Uu^Ii, Xu, Uu^Ii, Uu, Uu, Rr, Rr, Rr, Uu, Uu, Uu, Xu, Uu^Ii, Rr, Uu^Vud, Uu^Ii, Xu, Xu, Xu, Xu, Xu
Uu, Uu^Vud, Rp^Ii, Uu^Vud, Uh, Xu, Xu, Xu, Xu, Uu, Rr, Rr, Rr, Uu^Vud, Xu, Xu, Xu, Uu, Uu^Vud, Rp^Ii, Uu^Ii, Uu, Xu, Xu, Xu, Xu
Rp, Rp^Ii, Uu^Vud, Uu^Ii, Xu, Xu, Xu, Xu, Xu, Xu, Xu, Xu, Xu, Xu, Xu, Xu, Xu, Uu, Uu^Ii, Rp, Rp^Ii, Uu, Uu^Ii, Xu, Xu, Xu
Uu, Uu, Uu^Ii, Uu, Xu, Xu, Xu, Xu, Xu, Xu, Xu, Xu, Xu, Xu, Xu, Xu, Xu, Xu, Uu^Ii, Uu^Ii, Rp, Uu^Ii, Uu^Ii, Uu^Ii, Xu, Xu
