Gg, Gg, Gg, Gg, Gg, Gg, Gg, Gg, Gg, Gg, Gg, Ww, Gg, Gg, Gg, Gg, Gg, Gg, Gg, Gg, Gg, Gg, Gg, Rp, Gg, Gg, Gg, Gg, Gs^Fp, Gg, Gg, Gg, Gg, Gg, Gg, Gg, Gg
Gg, Gg, Gg, Gg, Re^Gvs, Gg, Gg, Gg, Gg, Gg, Gg, Ww, Gg, Gg, Gs^Fp, Gg, Gg, Gg, Gs^Fp, Gs^Fp, Gs^Fp, Gg, Gg, Rp, Gg^Efm, Gg, Gg, Gs^Fp, Gs^Fp, Gs^Fp, Gs^Fp, Gg, Gg, Gg, Gg, Gg, Gg
Gg, Gg, Gg, Re^Gvs, Re^Gvs, Re^Gvs, Re^Gvs, Gg, Gg, Gg, Gg, Ww, Gg, Gs^Fp, Gs^Fp, Gs^Fp, Gs^Fp, Gs^Fp, Gs^Fp, Gs^Fp, Gs^Fp, Gs^Fp, Gg, Rp, Gg^Efm, Gg^Efm, Gg, Gs^Fp, Gs^Fp, Gs^Fp, Gs^Fp, Gs^Fp, Gs^Fp, Gg, Gg, Gg, Gg
Gg, Gg, Gg, Re^Gvs, Re^Gvs, Re^Gvs, Re^Gvs, Re^Gvs, Re^Gvs, Gg, Gg, Ww, Ww, Gs^Fp, Gs^Fp, Gs^Fp, Gs^Fp, Gs^Fp, Gs^Fp, Gs^Fp, Gs^Fp, Gs^Fp, Gg, Rp, Gg, Gg, Hh, Hh, Gs, Gs^Fp, Gs^Fp, Gs^Fp, Gs^Fp, Gg, Gg, Gg, Gg
Gg, Gg, Gg, Gg, Gg, Re^Gvs, Re^Gvs, Re^Gvs, Re^Gvs, Gg, Gg, Gg, Gll^Fp, Ww, Ww, Gg, Gg, Gs^Fp, Gs^Fp, Gs^Fp, Gs^Fp, Gg, Gg, Rp, Gg, Hh, Hh, Hh, Hh, Gs, Gs, Gs^Fp, Gs^Vl, Gs, Gg, Gg, Gg
Gg, Gg, Gg, Gg, Gg, Re^Gvs, Re^Gvs, Re^Gvs, Re^Gvs, Gg, Gg, Gll^Fp, Gll^Fp, Gll^Fp, Gg, Ww, Gg, Gg, Gg, Gs^Fp, Hh^Fp, Hh^Fp, Hh, Rp, Gg, Hh, Hh, Hh, Hh^Fp, Hh^Fp, Gs^Fp, Gs^Fp, Gs^Fp, Gs^Fp, Gs, Gg, Gs
Gg, Gg, Gg, Gg, Gg, Gg, Gg, Re^Gvs, Gg, Gg, Gll^Fp, Gll^Fp, Gll^Fp, Gll^Fp, Gg, Ww, Ww, Gg, Gg, Hh, Hh^Fp, Hh^Fp, Hh, Rp, Rp, Hh, Hh, Gs, Hh^Fp, Gs^Fp, Gs^Fp, Gs^Fp, Gs^Fp, Gs^Fp, Ce, Ce, Gs
Gg, Gg, Gg, Gg^Efm, Gg^Efm, Gg, Gg, Gg^Vc, Gg, Gll^Fp, Gll^Fp, Gll^Fp, Gg^Vc, Gg, Gg, Gg, Wwf, Gg, Hh, Hh, Hh, Hh^Fp, Gg, Gg, Hh, Rp, Hh^Fp, Hh^Fp, Gs^Fp, Gs^Fp, Gg^Efm, Gs^Vl, Gs, Ce, 3 Ke, Ce, Gs
Gs^Fp, Gs^Fp, Gs, Gg^Efm, Gs^Fp, Hh, Hh, Gg, Gg, Gll^Fp, Gll^Fp, Gll^Fp, Gg^Efm, Gg^Efm, Re^Gvs, Re^Gvs, Re^Gvs, Ww, Re^Gvs, Hh, Re^Gvs, Hh, Gg, Gg, Hh, Rp, Gs^Fp, Gs^Fp, Gs^Fp, Gs^Fp, Gs^Fp, Gg, Gg, Ce, Ce, Ce, Gs
Hh, Hh, Gs^Fp, Gs, Gs, Gs^Fp, Hh, Hh, Gg, Gg, Gg, Gg, Re^Gvs, Re^Gvs, Re^Gvs, Re^Gvs, Re^Gvs, Ww, Re^Gvs, Re^Gvs, Re^Gvs, Gg^Vl, Re^Gvs, Re^Gvs, Re^Gvs, Rp, Gg, Gs^Fp, Gs^Fp, Gs^Fp, Gs^Fp, Gg, Gg, Gg, Gg, Ce, Gg
Hh, Hh, Gs, Gs, Ce, Gs, Gg, Hh, Gg, Gg, Gg, Re^Gvs, Re^Gvs, Re^Gvs, Re^Gvs, Re^Gvs, Ww, Ww, Ww, Re^Gvs, Re^Gvs, Re^Gvs, Re^Gvs, Re^Gvs, Re^Gvs, Rp, Gg, Gg, Gg, Gs^Fp, Rr, Gg, Gg, Gg^Vl, Gg, Gg, Rp
Rp, Gs^Vl, Gs, Ce, 1 Ke, Ce, Gg, Gs^Vl, Gg, Gg, Gg, Re^Gvs, Re^Gvs, Re^Gvs, Ww, Ww, Mm, Mm, Hh, Ww, Re^Gvs, Re^Gvs, Re^Gvs, Re^Gvs, Rr, Rr, Rr, Gg, Rr, Rr, Re^Gvs, Rr, Rr, Gg, Rr, Rr, Gg
Gg, Rr, Rr, Ce, Ce, Ce, Gg, Gg, Gg, Gg, Gg, Gg, Ww, Ww, Hh, Mm, Mm, Hh, Gs^Fp, Ww, Ww, Re^Gvs, Rr, Rr, Hh, Hh, Hh, Rr, Re^Gvs, Re^Gvs, Re^Gvs, Re^Gvs, Gg, Rr, Hh, Hh, Gg
Gg, Gg, Gs^Fp, Rr, Rr, Gg, Gs^Vl, Gg, Hh^Fp, Hh^Fp, Hh, Ww, Gg, Gg, Gg, Gg, Gg, Hh, Gs^Fp, Gs^Fp, Rr, Ww^Bw/, Ww, Mm, Mm, Mm, Hh^Vhh, Re^Gvs, Re^Gvs, Re^Gvs, Re^Gvs, Re^Gvs, Hh, Hh, Hh^Fp, Hh^Vhh, Hh
Gg, Gg, Gg, Gs^Fp, Gg, Rr, Rr, Gg, Hh^Fp, Hh, Rr, Ww, Gg, Gg, Gg, Gg, Gs^Fp, Gg, Rr, Rr, Rb^Gvs, Rb^Gvs, Rb^Gvs, Ww, Ww, Mm, Hh, Re^Gvs, Re^Gvs, Re^Gvs, Gg, Gg, Hh^Fp, Hh^Fp, Gll^Fp, Hh^Fp, Gg^Fp
Gg, Gg, Hh, Gg, Gg, Gg^Efm, Gg^Efm, Rr, Rr, Rr, Gg, Ww^Bw\, Rr, Gg, Gg, Gg, Rr, Rr, Rb^Gvs, Rb^Gvs, Rb^Gvs, Rb^Gvs, Rb^Gvs, Gg, Ww, Hh, Hh, Hh, Gg, Gg, Gg, Hh^Fp, Gll^Fp, Gll^Fp, Gll^Fp, Gll^Fp, Gg^Fp
Gg^Fp, Gs^Fp, Gs^Fp, Hh, Hh, Gg, Gg^Efm, Gg, Gg, Gs^Vl, Gg, Ww, Gg, Rr, Rr, Rr, Gg^Vo, Rb^Gvs, Rb^Gvs, Rb^Gvs, Rb^Gvs, Rb^Gvs, Gs^Fp, Gg, Ww, Hh, Gg, Gg, Gll^Fp, Gg, Gll^Fp, Gll^Fp, Gs^Ve, Gll^Fp, Gll^Fp, Gll^Fp, Gg^Fp
Gg^Fp, Gs^Fp, Gs^Fp, Hh, Hh, Hh, Gg, Gg, Gg, Gg, Ww, Ww, Rb^Gvs, Gg, Rp, Gg, Gg, Rb^Gvs, Rb^Gvs, Rb^Gvs, Gg, Gs, Hh, Hh, Wwf, Gg, Gg, Gll^Fp, Gll^Fp, Gll^Fp, Gll^Fp, Gll^Fp, Gs, Gll^Fp, Gll^Fp, Gll^Fp, Gs
Gg^Fp, Gs^Fp, Gs^Fp, Gs^Fp, Hh, Gg, Gg, Gg, Ww, Ww, Rb^Gvs, Rb^Gvs, Rb^Gvs, Rb^Gvs, Rp, Gg, Gg, Gg, Hh, Gg, Gs, Gs, Rb^Gvs, Rb^Gvs, Ww, Gg, Gg, Gll^Fp, Gll^Fp, Gll^Fp, Gll^Fp, Gll^Fp, Gs, Gs, Gll^Fp, Gs, Gs
Gg, Gs^Fp, Gg, Gg, Gg, Gg, Ww, Wwf, Rb^Gvs, Rb^Gvs, Rb^Gvs, Rb^Gvs, Rb^Gvs, Rb^Gvs, Rp, Gg, Gg, Hh, Gs^Fp, Hh, Gs, Gs, Rb^Gvs, Rb^Gvs, Rb^Gvs, Ww, Ww, Gg, Gg, Gs, Hh, Gs, Gs, Gll^Fp, Gll^Fp, Gll^Fp, Gg^Fp
Gg, Gg, Gg, Gg, Gg, Ww, Rb^Gvs, Rb^Gvs, Rb^Gvs, Rb^Gvs, Rb^Gvs, Rb^Gvs, Gs^Vo, Gs, Rp, Gs, Hh, Hh, Gs^Fp, Gs, Co, Co, Co, Gs, Gs, Gg, Ww, Gg, Gg, Gg, Hh, Hh, Gg, Gll^Fp, Gll^Fp, Gll^Fp, Gs
Gg, Gg, Gg, Gg, Gg, Ww, Rb^Gvs, Rb^Gvs, Rb^Gvs, Rb^Gvs, Gg, Gs, Gs, Gs, Rp, Gs, Gs, Hh, Gs^Fp, Gs, Co, 2 Ko, Co, Gs, Gs^Vo, Gg, Ww, Gg, Gg, Hh, Hh, Hh, Gg, Gg, Gg, Gg, Gg
Gg, Gg, Gg, Gg, Ww, Ww, Gg, Rb^Gvs, Gg, Gg, Gg, Gg, Gg, Gg, Rp, Gs, Gs, Gs, Gs^Fp, Gs^Vo, Gs, Co, Gs, Gs, Gg, Gg, Wwf, Gg, Gs^Fp, Hh, Gg, Hh^Vhh, Gg^Efm, Gg, Gg^Efm, Gg, Gg
Gg, Gg, Ww, Ww, Gg, Gg, Gg, Gg, Gg, Gg, Gg^Efm, Gg^Efm, Gg, Gg, Gs^Vo, Rp, Rp, Gs, Gs, Gs^Fp, Gs^Fp, Gs, Gs, Gs^Vo, Gg, Gg, Ww, Gs^Fp, Gs^Fp, Gs^Fp, Gg, Gg, Gg, Gg^Efm, Gg, Gg, Gg
Ww, Ww, Gg, Gg, Gg, Gg, Gg, Gg, Gg, Gg, Gg, Gg, Rb^Gvs, Rb^Gvs, Rb^Gvs, Rb^Gvs, Rp, Gs, Gs^Fp, Gs^Fp, Gs^Fp, Gs^Fp, Gg, Gg, Gg, Gg, Ww, Gs^Fp, Gs^Fp, Gs^Fp, Gg, Gg, Gg, Gg, Gg, Gg, Gg
Gg, Gg, Gg, Gg, Gg, Gg, Gg, Gg, Gg, Gg, Rb^Gvs, Rb^Gvs, Rb^Gvs, Rb^Gvs, Rb^Gvs, Rb^Gvs, Rp, Gg, Gg, Gg, Gg, Gg, Gg, Gg, Gg, Gg, Gg, Ww, Gg, Gg, Gg, Gg, Gg, Gg, Gg, Gg, Gg
Gg, Gg, Gg, Gg, Gg, Gg, Gg, Gg, Gg, Gg, Rb^Gvs, Rb^Gvs, Rb^Gvs, Rb^Gvs, Rb^Gvs, Rb^Gvs, Rp, Gg, Gg, Gg, Gg, Gg, Gg, Gg, Gg, Gg, Gg, Ww, Gg, Gg, Gg, Gg, Gg, Gg, Gg, Gg, Gg
