Gd, Gd, Gd, Gd, Gd, Gd, Gll, Gll^Fp, Gll^Fp, Gll^Fp, Gd, Gd, Gd, Gd, Gd, Gd, Gd, Gd, Hhd, Gd, Gd, Gd, Hhd, Gd, Gd, Gd, Gd, Gd, Hhd, Hhd, Hhd, Gd, Gd, Gd, Gll^Fp, Gll^Fp, Gll^Fp, Hhd, Gll^Fp, Gd, Gd, Ms, Ms, Ms, Ms, Ms, Ms
Gd, Gd, Gd, Gd, Gll^Fp, Gd, Gd, Gll^Fp, Gll^Fp, Gll^Fp, Gd, Gd, Gd, Gd, Gd, Gd, Gd, Hhd, Hhd, Hhd, Hhd, Hhd, Hhd, Hhd, Hhd, Gd, Hhd, Hhd, Hhd, Hhd, Hhd, Gd, Gll^Fp, Gll^Fp, Gll^Fp, Gll^Fp, Gll^Fp, Gll^Fp, Gll^Fp, Gll^Fp, Gll^Fp, Ms, Ms, Ms, Ms, Ms, Ms
Gd, Gd, Gll^Fp, Gll^Fp, Gll^Fp, Gll^Fp, Gd, Gd, Gd, Gd, Gd^Vl, Gd, Gd, Gd, Gd, Gd, Gd, Hhd, Hhd, Hhd, Hhd, Hhd, Hhd, Hhd, Hhd, Hhd^Vc, Hhd, Hhd, Hhd, Hhd, Gll^Fp, Gll^Fp, Gll^Fp, Gll^Fp, Gll^Fp, Gll^Fp, Gd, Gll^Fp, Gll^Fp, Gll^Fp, Gll^Fp, Aa^Fpa, Aa^Fpa, Aa^Fpa, Ms, Ms, Ms
Gll, Gll^Fp, Gll^Fp, Gll^Fp, Gll^Fp, Gll^Fp, Gd, Gd, Gd, Gd, Gd, Gd, Gd, Gd, Gd, Gd, Gd, Gd, Gd, Hhd, Gd, Gd, Gd, Hhd, Hhd, Hhd, Hhd, Hhd, Gll^Fp, Gll^Fp, Gll^Fp, Gll^Fp, Gll^Fp, Gll^Fp, Gd, Gll, Gll^Fp, Gll^Fp, Gll^Fp, Gll^Fp, Aa^Fpa, Aa^Fpa, Aa^Fpa, Aa^Fpa, Ms, Ms, Ms
Gd, Gll^Fp, Gll^Fp, Gll^Fp, Gd, Gll, Gll^Fp, Gd, Gd, Gd, Gd, Gd, Gd, Gd, Gll^Fp, Gll^Fp, Gd, Gd, Gd, Gd, Gd, Gd, Gd, Gd, Gd, Hhd, Gll^Fp, Gd, Gll^Fp, Gll^Fp, Gll^Fp, Gll^Fp, Gd, Gd, Gd, Gll^Fp, Gll^Fp, Gll^Fp, Gll^Fp, Aa^Fpa, Aa^Fpa, Aa^Fpa, Aa^Fpa, Aa^Fpa, Ms, Ms, Ms
Gd, Gd, Gd, Gll, Gd, Gll^Fp, Gll^Fp, Gll^Fp, Gd, Gd, Gd, Gd, Gll^Fp, Gll^Fp, Gll^Fp, Gll^Fp, Hhd, Gd, Hhd, Hhd, Hhd, Gd, Gd, Gd, Gd, Gll^Fp, Gll^Fp, Gll^Fp, Gll^Fp, Gll^Fp, Gll^Fp, Gd, Aa^Fpa, Aa^Fpa, Gll^Fp, Gll^Fp, Gll^Fp, Gll^Fp, Aa^Fpa, Aa^Fpa, Aa^Fpa, Aa^Fpa, Aa^Fpa, Aa^Fpa, Ms, Ms, Ms
Gd, Gd, Gd, Gd, Gd, Gll^Fp, Gll^Fp, Gll^Fp, Gll^Fp, Gd, Gd, Gd, Gll^Fp, Gll, Hhd, Hhd, Hhd, Hhd, Hhd^Vhh, Hhd, Gd, Gd, Gd, Gd, Gd, Gll^Fp, Gll^Fp, Aa^Fpa, Gd, Gll^Fp, Gd, Gd, Gll^Fp, Gll^Fp, Gll^Fp, Gd, Aa^Fpa, Aa^Fpa, Aa^Fpa, Aa^Fpa, Aa^Fpa, Aa^Fpa, Mm, Aa^Fpa, Ms, Ms, Ms
Gs, Gs, Gd, Gd^Vl, Gd, Gd, Gll^Fp, Gll^Fp, Gll^Fp, Gd, Gll^Fp, Gll^Fp, Gll^Fp, Gd, Gd, Hhd, Gd, Gd, Gd, Gd, Gd, Gd, Gd, Gd, Gd, Gd, Ce, Gd, Gll^Fp, Gll^Fp, Gll^Fp, Gll^Fp, Gll^Fp, Gll^Fp, Aa^Fpa, Aa^Fpa, Aa^Fpa, Aa^Fpa, Aa^Fpa, Aa^Fpa, Aa^Fpa, Mm, Mm, Mm, Ms, Ms, Ms^Xm
Gs, Gs, Gs, Gs, Gll^Fp, Gll^Fp, Gll^Fp, Gll^Fp, Gd, Gd, Gd, Gll^Fp, Gll^Fp, Gd, Gd, Gd, Gd, Gd, Gd, Gd, Gd, Gd, Gd, Gd, Gll, Ce, 3 Ke, Ce, Gll^Fp, Gll^Fp, Gll^Fp, Gll^Fp, Gll^Fp, Aa^Fpa, Aa^Fpa, Aa^Fpa, Aa^Fpa, Aa^Fpa, Mm, Mm, Mm, Mm, Mm, Mm, Ms^Xm, Ms^Xm, Ms^Xm
Hh, Hh, Gs, Gs, Gs^Fp, Gll^Fp, Gll^Fp, Gd, Gd, Gd, Gd, Gd, Gd, Gd, Gd, Gd, Gd, Gd, Gd, Gd, Gd, Gd^Fp, Gd^Fp, Gll^Fp, Gd, Ce, Ce, Ce, Gd, Gll^Fp, Gd, Gll^Fp, Hhd^Vc, Aa^Fpa, Mm, Mm, Mm, Mm, Mm, Mm, Mm, Mm, Ms^Xm, Ms^Xm, Ms^Xm, Ms^Xm, Ms^Xm
Hh, Hh, Gs, Gs, Gs, Gll^Fp, Gs, Gs, Gs, Gs, Gd, Gd, Gd, Gll^Fp, Gll, Gll^Fp, Gd, Gd, Ww, Ww, Ww, Ww, Ww, Gd, Ww, Gd, Gd, Gd, Gd, Hhd, Hhd, Hhd, Hhd, Hhd, Mm, Mm, Mm, Mm, Mm, Mm, Ha, Mm, Mm, Mm, Ms^Xm, Ms^Xm, Ms^Xm
Hh, Hh, Gs, Gs, Gs, Gs, Ww, Ww, Ww, Gs, Gs^Fp, Gll^Fp, Gs^Fp, Gll^Fp, Gs, Gs, Ww, Ww, Gs^Fp, Ww, Ww, Ww, Ww, Ww, Ww, Ww, Gs, Gd, Gd, Hhd, Ww, Hhd, Ww, Hhd, Ww, Mm, Hhd, Hhd, Ha, Ha, Ha, Ha, Mm, Mm, Ms, Ms^Xm, Ms^Xm
Hh, Hh, Hh, Gs, Ww, Ww, Gs, Gs, Gs, Ww, Ww, Gs^Fp, Ww, Gs^Fp, Ww, Ww, Gs^Fp, Gs^Fp, Gll^Fp, Gs^Fp, Ss^Vhs, Ww, Ww, Ww, Ww, Ww, Ww, Gs, Ww, Ww, Gs, Ww, Gs, Ww, Aa^Fpa, Ww, Ww, Aa^Fpa, Ha, Ha, Ww, Hhd, Mm, Mm, Mm, Ms, Ms
Gs, Hh, Ww, Ww, Gs, Gs, Gs, Gs, Gs, Gs, Gs, Ww, Gs, Ww, Gs, Gs^Fp, Gll^Fp, Gll^Fp, Gll^Fp, Gll^Fp, Gs, Ss, Hh, Gs, Hh, Hh, Hh, Ww, Gs^Fp, Gs^Fp, Gll^Fp, Gll^Fp, Gll^Fp, Gs, Aa^Fpa, Aa^Fpa, Re, Ww, Ww, Ww, Re, Ww, Ww, Mm, Mm, Ms, Mm
Ww, Ww, Gs, Hh, Hh, Gs, Gs, Gs, Gs, Gs, Gs, Gs, Gs, Gs, Gs, Gll^Fp, Gll^Fp, Gll^Fp, Gs, Gs, Hh, Hh, Hh, Hh, Hh, Hh, Hh, Hh, Gll^Fp, Gs, Gll^Fp, Gll^Fp, Aa^Fpa, Gd, Gd, Re, Hhd, Re, Re, Re, Hhd, Re, Re, Ww, Ww, Mm, Ww
Gs, Gs, Gll^Fp, Gll^Fp, Gll^Fp, Hh, Hh, Gs, Gll^Fp, Gll^Fp, Gll^Fp, Gs, Gs, Gs, Hh, Hh, Gll^Fp, Gll^Fp, Gll^Fp, Hh, Hh, Hh, Hh, Hh, Hh, Hh, Hh, Hh, Gll^Fp, Gll^Fp, Gll^Fp, Aa^Fpa, Re, Re, Aa, Aa, Gd, Hhd, Hhd, Hhd, Hhd, Hhd, Hhd, Re, Re, Ww, Aa
Gs, Gll, Gll^Fp, Gll^Fp, Gll^Fp, Gs, Gs^Vc, Hh, Gll^Fp, Gll^Fp, Gll^Fp, Gs, Gs, Gs, Gs, Hh, Gll^Fp, Gll^Fp, Gll^Vc, Hh, Hh, Hh, Gs, Hh, Gs, Gs, Gs, Gll^Fp, Gd, Gll^Fp, Re, Re, Gd, Gd^Fp, Ce, Hhd, Re, Hhd, Hhd, Hhd, Hhd, Hhd, Hhd, Aa, Mm, Re, Re
Gll^Fp, Gll^Fp, Gll^Fp, Gll^Fp, Gs, Gll^Fp, Gll^Fp, Gll^Fp, Gll^Fp, Gll^Fp, Gs, Gs, Gs, Gs, Gs, Gs, Re, Gll^Fp, Gs, Gs, Gs, Gs, Gll^Fp, Gll^Fp, Gll^Fp, Gs, Gd, Gd, Re, Re, Gd, Gd, Re, Ce, 2 Ke, Ce, Hhd, Hhd, Hhd, Aa^Fpa, Mm, Hhd, Hhd, Mm, Mm, Mm, Ms
Gll^Fp, Gll^Fp, Gll^Fp, Gs, Gs, Gll^Fp, Gll^Fp, Gll^Fp, Gll^Fp, Gll^Fp, Gs, Gs, Gs, Gs, Re, Re, Gs, Re, Re, Gs, Gd, Gll^Fp, Gll^Fp, Gll^Fp, Gll^Fp, Gd^Vc, Re, Gd, Gd, Gd, Gd, Gd, Gd, Ce, Ce, Ce, Hhd, Hhd, Hhd, Mm, Mm, Mm, Hhd, Mm, Mm, Ms, Ms
Gs, Gll^Fp, Gs, Gs, Gs, Gs, Gs, Gll, Gs, Hh, Hh, Gs^Vl, Re, Re, Hh, Gs, Gs, Gd, Gd, Re, Re, Gll^Fp, Gll^Fp, Gll^Fp, Re, Re, Gd, Gd, Gd, Gd, Gd, Gd, Gd, Gd, Hhd, Re, Hhd, Hhd, Hhd, Mm, Mm, Mm, Hhd, Mm, Mm, Mm, Ms
Gs, Gs, Gs, Gs, Gs, Gs, Gs, Gs, Gs, Hh, Re, Re, Gs, Gs, Hh, Gs, Gs, Gd, Gd, Gd, Gd, Re, Re, Re, Gd, Gd, Gd, Gd, Hhd, Gd, Hhd, Hhd, Hhd, Hhd, Hhd, Hhd, Aa^Fpa, Aa^Fpa, Aa^Fpa, Aa^Fpa, Aa^Fpa, Aa^Fpa, Hhd, Hhd, Mm, Ms^Xm, Ms^Xm
Gs, Gs, Ce, Gs, Gs, Gs, Gs, Gs, Re, Re, Hh, Hh, Hh, Hh, Hh, Gs, Gd, Gd, Gll^Fp, Gll^Fp, Gll^Fp, Chr, Khr, Chr, Gd, Gd, Hhd, Hhd, Hhd, Hhd, Hhd, Hhd^Vc, Hhd, Hhd, Hhd, Hhd, Aa^Fpa, Aa^Fpa, Aa^Fpa, Aa^Fpa, Aa^Fpa, Aa^Fpa, Gd, Ha, Mm, Ms^Xm, Ms^Xm
Gs, Ce, 1 Ke, Ce, Gs, Gs, Re, Re, Gs, Gs, Gs, Hh, Gll^Fp, Gll^Fp, Gll^Fp, Gs, Gs, Gd, Gll^Fp, Gll^Fp, Gll^Fp, Gd, Hhd, Hhd, Gd, Hhd, Gd, Hhd, Hhd, Hhd, Hhd, Hhd, Hhd, Hhd, Hhd, Hhd, Gll^Fp, Aa^Fpa, Gd, Aa^Fpa, Aa^Fpa, Aa^Fpa, Ha, Ha, Mm, Ms^Xm, Ms^Xm
Gs, Ce, Ce, Ce, Re, Re, Gll^Fp, Gs, Gs, Gs, Gs, Hh, Gll^Fp, Gll^Fp, Gll^Fp, Hh, Hh, Hh, Hhd, Gll^Fp, Hhd, Hhd, Gd, Gd, Gll^Fp, Gd, Gd, Hhd, Ha, Ha, Gd, Gd, Gll^Fp, Gll^Fp, Aa^Fpa, Gll^Fp, Gll^Fp, Gll^Fp, Gd, Gd, Gd, Gd, Ha, Gd, Mm, Ms^Xm, Ms^Xm
Gs, Ce, Re, Re, Gs, Gll^Vl, Gll^Fp, Gll^Fp, Gs, Gs, Gll^Fp, Gll^Fp, Gll^Fp, Gll^Fp, Gs, Hh, Gd^Vl, Hhd, Gd, Hhd, Gll^Fp, Gd, Gll^Fp, Gll^Fp, Gll^Fp, Gll^Fp, Gd, Gd, Gd, Gd, Gll^Fp, Gd, Gll^Fp, Gll^Fp, Gll^Fp, Aa^Fpa, Gll^Fp, Gll^Fp, Aa^Fpa, Gd, Aa^Fpa, Aa^Fpa, Ha, Mm, Ms, Ms^Xm, Ms^Xm
Re, Re, Gs, Gs, Gs, Gll^Fp, Gll^Fp, Gll^Fp, Gs, Gs, Gll^Fp, Gll^Fp, Gll^Fp, Gs, Gs, Gs, Gd, Gd, Gd, Gll^Fp, Gll^Fp, Gll^Fp, Gll^Fp, Gll^Fp, Gll^Fp, Gd^Vo, Gd, Gd, Gd, Gll^Fp, Gll^Fp, Gll^Fp, Gll^Fp, Gll^Fp, Gll^Fp, Gll^Fp, Aa^Fpa, Aa^Fpa, Aa^Fpa, Aa^Fpa, Aa^Fpa, Aa^Fpa, Mm, Mm, Ms^Xm, Ms^Xm, Ms^Xm
Gs, Gs, Gs, Gs, Gs, Gs, Gs, Gs, Gs, Gs, Gs^Vl, Gll^Fp, Hh, Hh, Gs, Gd, Gd, Gd, Gd, Gll^Fp, Gll^Fp, Gll^Fp, Gd, Gll^Fp, Gd, Gd, Gd, Gd, Gll^Fp, Gll^Fp, Gll^Fp, Gll^Fp, Gll^Fp, Gll^Fp, Gll^Fp, Gd, Hhd, Gd, Hhd, Hhd, Ha, Mm, Mm, Ms, Ms^Xm, Ms^Xm, Ms^Xm
Gs, Gs, Gs, Gs, Gs, Gs, Gs, Gs, Gs, Gs, Gs, Gs, Hh, Hh, Gs, Gd, Gll^Fp, Gll^Fp, Gll^Fp, Gll^Fp, Gll^Fp, Gll^Fp, Gd, Gd, Gd, Gd, Gd, Gd, Gll^Fp, Gll^Fp, Gll^Fp, Gd, Gd, Gll^Fp, Gd, Hhd^Vhh, Hhd, Hhd, Hhd, Ha, Ha, Mm, Mm, Mm, Ms^Xm, Ms^Xm, Ms^Xm
Gs, Gs, Gs, Gs, Gs, Gs, Gs, Gs, Gs, Gll, Gll^Fp, Gll^Fp, Gll^Fp, Hh, Gs, Gd, Gll^Fp, Gll^Fp, Gll^Fp, Gll^Fp, Gll^Fp, Gll^Fp, Gd, Gd, Gd, Gd, Gd, Gd, Ce, Gll^Fp, Gd, Gd, Hhd, Hhd, Hhd, Hhd, Hhd, Hhd, Hhd, Ha, Ha, Mm, Mm, Ms^Xm, Ms^Xm, Ms^Xm, Ms^Xm
Gs, Gs, Gs, Gs^Vl, Gs, Gs, Gll^Fp, Gs, Gll^Fp, Gll^Fp, Gll^Fp, Gll^Fp, Gll^Fp, Gs, Gs, Gd, Gd, Gll^Fp, Gd, Gd, Gd, Gd, Gd^Vc, Gd, Gd, Gd, Gd, Ce, 4 Ke, Ce, Gd, Hhd, Hhd, Hhd, Hhd, Hhd, Hhd, Hhd, Aa, Hhd, Mm, Mm, Ms, Ms, Ms, Ms^Xm, Ms^Xm
Gs, Gs, Gs, Gs, Gs, Gll^Fp, Gll^Fp, Gll^Fp, Gll^Fp, Gll^Fp, Gll^Fp, Gll^Fp, Mm, Mm, Mm, Gd, Gd, Gd, Gd, Gd, Gd, Gd, Gd, Gd, Gd, Gd, Gd, Ce, Ce, Ce, Gd, Gd, Aa, Hhd, Aa, Gd, Aa, Gd, Gd, Aa, Mm, Mm, Ms^Xm, Ms^Xm, Ms^Xm, Ms^Xm, Ms^Xm
Gs, Gs, Gs, Gs, Gs, Gll^Fp, Gll^Fp, Gll^Fp, Gll, Gll^Fp, Gll, Gll, Mm, Mm, Mm, Mm, Gd, Gd, Gd, Gd, Gd, Gd, Gd, Gd, Gd, Gd, Gd, Gd, Gd, Gd, Gd, Gd, Gd, Aa, Aa, Gd, Gd, Aa, Aa, Gd, Gd, Mm, Ms^Xm, Ms^Xm, Ms^Xm, Ms^Xm, Ms^Xm
