Mm, Hhd, Hhd, Ha, Ha, Hhd, Hhd, Hhd, Hhd, Gd, Ai, Ai, Ai, Aa^Fpa, Aa^Fpa, Ms, Ms, Gd, Gd, Gd, Gd, Mm, Mm, Mm, Mm, Mm, Mm, Mm, Mm, Mm, Mm, Hh
Mm, Ms, Ms, Ha, Ha, Hhd, Hhd, Hhd, Ai, Ai, Ai, Ai, Ms, Aa^Fpa, Aa^Fpa, Aa^Fpa, Ms, Gd, Coa, Gd, Gd, Mm, Mm, Mm, Mm, Mm, Mm, Mm, Mm, Mm, Aa^Fpa, Aa^Fpa
Mm, Ms, Ha, Ha, Ha, Hhd, Ai, Ai, Ai, Ai, Ms, Aa^Fpa, Ms, Ms, Aa^Fpa, Aa^Fpa, Aa^Fpa, Ha, Coa, 2 Koa, Ha, Aa^Fpa, Aa^Fpa, Aa^Fpa, Aa^Fpa, Mm, Ms, Mm, Mm, Mm, Aa^Fpa, Aa^Fpa
Mm, Mm, Mm^Xm, Ms, Wo, Ai, Wo, Ai, Ms, Ms, Ms, Aa^Fpa, Ms, Ha^Vca, Aa^Fpa, Aa^Fpa, Aa^Fpa, Ms, Ha, Ha, Ms, Ms, Aa^Fpa, Aa^Fpa, Aa^Fpa, Ms, Mm, Mm, Mm, Aa^Fpa, Aa^Fma, Aa^Fpa
Mm, Mm, Mm, Ms, Wo, Wo, Mm, Ms, Ms, Ms, Aa^Fpa, Aa^Fpa, Aa^Fpa, Ms, Ms, Aa^Fpa, Aa^Fpa, Ms, Ms, Ms, Ms, Ms, Aa^Fpa, Aa^Fma, Aa^Fpa, Ms, Mm, Mm^Vc, Mm, Aa^Fpa, Aa^Fpa, Aa^Fpa
Mm^Xm, Mm^Xm, Ms, Wo, Wo, Wo, Mm, Md, Aa^Fpa, Aa^Fpa, Aa^Fpa, Aa^Fpa, Aa^Fpa, Ms, Ms, Ms, Aa^Fpa, Aa^Fpa, Mm, Ms, Ms, Ms, Mm, Aa^Fpa, Aa^Fpa, Ms, Ms, Mm, Mm, Aa^Fpa, Hhd, Hhd
Mm, Ms, Ms, Wo, Wo, Mm, Mm, Mm, Aa^Fpa, Aa^Fma, Mm, Ms, Aa^Fpa, Aa^Fpa, Ha^Vca, Ms, Ms, Aa^Fpa, Aa^Fpa, Ms, Ms, Ms, Ms, Mm, Aa^Fpa, Aa^Fpa, Aa^Fpa, Mm, Hhd, Hhd, Hhd, Hhd
Mm, Ms, Ha, Wo, Wo, Mm, Ha, Aa^Fpa, Aa^Fpa, Mm, Mm, Ms, Aa^Fpa, Aa^Fpa, Mm, Ms, Mm, Aa^Fpa, Aa^Fpa, Mm, Ms, Ms, Ms, Ms, Ms, Aa^Fpa, Aa^Fpa, Mm, Mm, Hhd, Mm, Hhd
Ha, Ha, Ha, Wo, Wo, Ha, Aa^Fpa, Ha^Vca, Aa^Fpa, Mm, Re, Mm, Re, Re, Re, Mm, Mm, Aa^Fpa, Aa^Fpa, Mm, Ms, Ms, Ms, Ms, Ha^Vca, Aa^Fpa, Aa^Fpa, Ms, Mm, Hhd, Mm, Mm
Wo, Ha, Wo, Wo, Wo, Aa^Fpa, Aa^Fpa, Aa^Fpa, Re, Re, Re^Es, Re, Re, Re, Re, Re, Re^Es, Aa^Fpa, Aa^Fpa, Ms, Ms, Ms, Mm, Ms, Mm, Aa^Fpa, Aa^Fpa, Mm, Mm, Mm, Hhd, Hhd
Wo, Wo, Wo, Wo, Re, Re, Re, Re^Es, Re, Re, Mm, Re, Mm, Aa^Fpa, Mm, Re, Re, Re, Re, Ha^Vca, Ms, Mm, Re^Es, Mm, Mm, Aa^Fpa, Aa^Fpa, Gd, Mm, Mm^Vc, Hhd, Hhd
Re, Ce, Ce, Re, Re, Re^Es, Re, Re, Aa^Fpa, Mm, Mm, Mm, Mm, Aa^Fpa, Ms, Mm, Ms, Re, Re, Re, Re, Re, Re, Re, Re, Aa^Fpa, Ms, Mm, Re, Re, Re^Es, Hhd
Re, 1 Ke, Ce, Re, Aa^Fpa, Aa^Fpa, Aa^Fpa, Aa^Fpa, Aa^Fpa, Mm, Mm, Ms, Mm^Vc, Aa^Fpa, Aa^Fpa, Ms, Ha^Vca, Aa^Fpa, Aa^Fpa, Re, Re^Es, Re, Mm, Re, Re, Re, Re, Re, Re, Re, Re, Re
Hhd, Ce, Mm, Mm, Mm, Aa^Fpa, Aa^Vea, Mm, Aa^Fpa, Aa^Fpa, Aa^Fpa, Mm, Aa^Fpa, Aa^Fpa, Aa^Fpa, Ms, Ms, Aa^Fpa, Aa^Fpa, Mm, Mm, Mm, Mm, Mm, Mm, Re, Re^Es, Re, Ha, Hhd, Hhd, Re
Hhd, Hhd, Mm, Mm, Ms, Aa^Fpa, Aa^Fpa, Mm, Mm, Aa^Fpa, Aa^Fpa, Aa^Fpa, Aa^Fpa, Aa^Fpa, Aa^Fpa, Ms, Aa^Fpa, Aa^Fpa, Aa^Fpa, Ms, Mm, Ms, Ms, Ms, Mm, Mm, Mm^Vc, Aa^Fpa, Aa^Fpa, Ha, Hhd, Hhd
Hhd, Hhd, Mm, Mm, Aa^Fpa, Aa^Fpa, Aa^Fpa, Mm, Aa^Fpa, Aa^Fpa, Ms, Aa^Fpa, Aa^Fpa, Ha^Vca, Ms, Aa^Fpa, Mm, Aa^Fpa, Aa^Fpa, Aa^Vea, Aa^Fpa, Ms, Ms, Ms, Ms, Ms, Ms, Ms, Aa^Fpa, Ha, Hhd, Hhd
Hhd, Hhd, Mm, Mm, Aa^Fma, Aa^Fpa, Mm, Mm, Aa^Fpa, Ms, Ms, Aa^Fpa, Aa^Fpa, Ms, Ms, Ms, Ms, Aa^Fpa, Aa^Fpa, Aa^Fpa, Aa^Fpa, Ms, Ms, Ms, Aa^Fpa, Aa^Fpa, Ms, Ms, Aa^Fpa, Aa^Fpa, Aa^Fpa, Aa^Fpa
Mm, Mm, Mm, Aa^Fpa, Aa^Fpa, Aa^Fpa, Ms, Ms, Mm, Aa^Fpa, Aa^Fpa, Aa^Fpa, Mm, Ms, Ms, Ms, Mm, Aa^Fpa, Aa^Fpa, Aa^Fpa, Aa^Fpa, Ms, Ms, Ms, Aa^Fpa, Aa^Fpa, Aa^Fpa, Aa^Fpa, Mm, Hhd, Hhd, Aa^Fpa
Mm, Mm, Aa^Fpa, Aa^Fpa, Aa^Fpa, Mm, Mm, Mm, Aa^Fpa, Aa^Fpa, Aa^Fpa, Aa^Fpa, Mm, Ms, Ms, Ms, Mm, Aa^Fpa, Aa^Fpa, Aa^Fma, Aa^Fpa, Ms, Ms, Ms, Mm, Aa^Fpa, Aa^Fpa, Aa^Fpa, Mm, Hhd, Hhd, Hhd
Mm, Mm, Aa^Fpa, Aa^Fpa, Aa^Fpa, Mm, Mm, Mm, Aa^Fpa, Aa^Fpa, Aa^Fma, Aa^Fpa, Ms, Ms, Ms, Ms, Ms, Mm, Aa^Fpa, Aa^Fpa, Aa^Fpa, Ms, Ms, Ms, Ms, Mm, Aa^Fpa, Aa^Fpa, Mm, Hhd, Hhd, Hhd
Mm, Mm, Mm, Aa^Fpa, Aa^Fpa, Aa^Fpa, Aa^Fpa, Aa^Fpa, Aa^Fpa, Aa^Fpa, Aa^Fpa, Ms, Ms, Ms, Ms, Ms, Ms, Mm, Aa^Fpa, Aa^Fpa, Aa^Fpa, Ms, Ms, Ms, Ms, Mm, Aa^Fpa, Mm, Mm, Mm, Hhd, Hhd
Mm, Mm, Mm, Aa^Fpa, Aa^Fpa, Aa^Fpa, Aa^Fpa, Aa^Fpa, Aa^Fpa, Aa^Fpa, Aa^Fpa, Ms, Ms, Ms, Ms, Ms, Ms, Ms, Aa^Fpa, Aa^Fpa, Aa^Fpa, Ms, Ms, Ms, Ms, Aa^Fpa, Aa^Fpa, Mm, Mm, Hhd, Hhd, Hhd
