Gll^Fp, Gll^Fp, Gll^Fp, Gll^Fp, Gll^Fp, Gll^Fp, Gll^Fp, Gs, Gs, Gll^Fp, Gll^Fp, Gll^Fp, Gs, Gs^Fp, Gs^Fp, Hh, Hh, Hh, Hh, Rr, Gs, Gs, Hh, Hh, Hh, Hh, Gll^Fp, Gll^Fp, Gll^Fp, Gll^Fp, Gll^Fp, Gs, Gll^Fp, Gll^Fp, Gll^Fp, Gll^Fp, Re, Gs^Fp, Mm, Mm, Hh, Mm, Mm, Mm^Xm, Mm^Xm, Mm^Xm, Mm^Xm
Gll^Fp, Gll^Fp, Gll^Fp, Gll^Fp, Gll^Fp, Gll^Fp, Gll^Fp, Gs, Gs, Gll^Fp, Gll^Fp, Gll^Fp, Gs, Gs^Fp, Gs^Fp, Hh, Hh, Hh, Hh, Rr, Gs, Gs, Hh, Hh, Hh, Hh, Gll^Fp, Gll^Fp, Gll^Fp, Gll^Fp, Gll^Fp, Gs, Gll^Fp, Gll^Fp, Gll^Fp, Gll^Fp, Re, Gs^Fp, Mm, Mm, Hh, Mm, Mm, Mm^Xm, Mm^Xm, Mm^Xm, Mm^Xm
Gll^Fp, Gs, Gll^Fp, Gll^Fp, Gll^Fp, Gll^Fp, Gll^Fp, Gs, Gs, Gll^Fp, Gll^Fp, Gll^Fp, Gs, Gs^Fp, Gs^Fp, Gs^Fp, Hh, Gs, Hh, Rr, Gs, Gs, Hh, Gll^Fp, Hh, Hh, Gll^Fp, Hh, Hh, Hh, Hh, Hh, Gll^Fp, Hh, Gll^Fp, Gll^Fp, Hh, Re, Mm, Hh, Hh, Hh, Mm, Mm^Xm, Mm^Xm, Mm^Xm, Mm^Xm
Gs, Gll^Fp, Gs, Gs, Gll^Fp, Gs, Gll^Fp, Gll^Fp, Gll^Fp, Gll^Fp, Gll^Fp, Gs, Gs, Gs, Gs^Fp, Gs^Vc, Hh, Gs, Gs^Es, Rr, Gs, Gs^Es, Re, Gll^Fmw, Gll^Fmw, Gll^Fp, Hh, Hh, Hh, Hh, Hh, Hh, Hh, Hh, Gll^Fp, Hh, Re^Fp, Re, Hh, Mm, Hh, Mm, Hh, Mm, Mm^Xm, Mm, Mm^Xm
Gll^Fp, Gll^Fp, Gs, Gll^Fp, Gll^Fp, Gs, Gs, Gll^Fp, Gll^Fp, Gll^Fp, Gll^Fp, Gs, Gs, Gs, Gs, Gs, Gs^Fp, Gs, Rr, Rr, Ce^Es, Ce, Ce, Re^Fp, Gll^Fmw, Gll^Fp, Hh, Gll^Fp, Hh, Hh, Hh, Hh^Vhh, Gs^Fp, Hh, Gll^Fp, Hh, Re^Fp, Re, Hh, Mm, Mm, Hh^Vhh, Hh, Mm, Hh, Hh, Ww
Gll^Fp, Gll^Fp, Gll^Fp, Gll^Fp, Gs, Gll^Fp, Gll^Fp, Gs, Gll^Fp, Gll^Fp, Gll^Fp, Gs, Gs, Gs, Gs, Gs, Rr, Rr, Gs^Es, Re, Ce, 3 Ke, Ce, Re^Es, Gll^Fp, Gll^Fmw, Gll^Fp, Gll^Fp, Hh, Hh, Hh, Hh, Hh, Hh, Hh, Hh, Hh, Re, Ww, Ww, Ww, Ww, Ww, Hh, Ww, Ww, Mm^Xm
Gll^Fp, Gll^Fp, Gs^Vl, Gll^Fp, Gll^Fp, Gll^Fp, Gs, Gs, Gll^Fp, Gs, Gs^Vl, Gs, Gs, Gs, Gs, Gs, Rr, Gs, Gs, Gs^Es, Re^Es, Ce, Re, Re^Fmw, Gll^Fp, Gs, Gll^Fp, Gll^Fp, Gll^Fp, Gll^Fp, Hh, Gll^Fp, Hh, Hh, Hh, Hh, Ww, Ww^Bw|, Hh, Hh, Mm, Mm, Mm, Ww, Hh, Hh, Mm^Xm
Gll^Fp, Gll^Fp, Gll^Fp, Gll^Fp, Gll^Fp, Gll^Fp, Gs, Gll^Fp, Gs, Gll^Fp, Gs, Gs, Gs, Gs, Gs, Gs^Fp, Rr, Gs, Gs, Gs, Gs^Es, Re^Fp, Gll^Fmw, Gll^Fp, Gs, Gll^Fp, Gll^Fp, Gll^Fp, Gll^Fp, Gll^Fp, Gll^Fp, Gll^Fp, Gll^Fp, Gs^Fp, Ww, Ww, Hh, Rr, Hh^Vhh, Hh, Mm, Mm, Mm, Mm, Mm, Mm, Mm^Xm
Gll^Fp, Gll^Fp, Gll^Fp, Gll^Fp, Gll^Fp, Gll^Fp, Gll^Fp, Gll^Fp, Gll^Fp, Gll^Fp, Gll^Fp, Gs, Gs, Gs^Fp, Gs, Gs, Rr, Re^Vh, Re, Gs, Gs, Gll^Fp, Gll^Fp, Gs, Gll^Fp, Gll^Fp, Hh, Gll^Fp, Gll^Fp, Gll^Fp, Gll^Fp, Gll^Fp, Gs^Fp, Gs^Fp, Ww, Gs, Rr, Rr, Hh, Mm, Mm, Mm, Mm, Mm, Mm^Xm, Mm^Xm, Mm^Xm
Gll^Fp, Gll^Fp, Gll^Fp, Gll^Fp, Gll^Fp, Gll^Fp, Gll^Fp, Gll^Fp, Gll^Fp, Gll^Fp, Gll^Fp, Gll^Fp, Gll^Fp, Gs, Gs, Gs, Rr, Re^Gvs, Re^Gvs, Re, Gs, Gll^Fp, Gll^Fp, Gs, Gll^Fp, Hh, Hh, Hh, Gll^Fp, Gs, Gs^Fp, Gs^Fp, Ww, Ww, Gs, Gs, Rr, Gll^Fp, Hh, Hh, Mm, Mm, Mm, Mm, Mm^Xm, Mm^Xm, Mm^Xm
Gll^Fp, Gll^Fp, Gll^Fp, Gll^Fp, Gll^Fp, Gll^Fp, Gll^Fp, Gs^Vl, Gll^Fp, Gll^Fp, Gll^Fp, Gs, Gs, Gll^Fp, Gll^Fp, Gs, Rr, Re^Gvs, Re^Gvs, Re^Fp, Gll^Fp, Gs, Gs, Gs, Hh, Hh, Hh, Hh, Re^Gvs, Gs, Gs^Fp, Ww, Gs^Fp, Gs^Fp, Gs, Gs, Rr, Gll^Fp, Hh, Hh, Mm, Mm, Mm, Mm, Mm^Xm, Mm^Xm, Mm^Xm
Gll^Fp, Gll^Fp, Gll^Fp, Gll^Fp, Gll^Fp, Gs, Gll^Fp, Gll^Fp, Gll^Fp, Gs, Gll^Fp, Gll^Fp, Gs, Gs, Gs, Gs^Vc, Rr, Re^Gvs, Re^Gvs, Re^Fp, Gs, Gll^Fp, Hh, Hh, Hh, Hh, Hh, Hh^Vhh, Re^Gvs, Re^Gvs, Gs, Ww, Gs^Fp, Gs, Gs^Fp, Rr, Gll^Fp, Gll^Fp, Gll^Fp, Hh, Mm, Mm, Mm, Mm, Mm^Xm, Mm, Mm^Xm
Gll^Fp, Gll^Fp, Gll^Fp, Gs, Gll^Fp, Gs, Gll^Fp, Gs, Gll^Fp, Gll^Fp, Gs, Gll^Fp, Gs, Gs, Gs, Rr, Gs, Gs, Hh, Hh, Gs^Vl, Gll^Fp, Hh, Gll^Fp, Hh, Hh, Gs, Re^Fp, Re^Gvs, Re^Gvs, Ww, Ww, Gs, Gs, Gs^Fp, Rr, Gll^Fp, Gll^Fp, Gll^Fp, Hh, Mm^Vhh, Hh, Mm, Mm, Mm, Mm, Mm
Gll^Fp, Gs, Gll^Fp, Gll^Fp, Gs, Gs, Gs, Gll^Fp, Gs, Gll^Fp, Gll^Fp, Gll^Fp, Gll^Fp, Gs, Gs, Rr, Gs, Gs, Hh, Hh, Gll^Fp, Gll^Fp, Gll^Fp, Gll^Fp, Hh, Hh, Hh, Gs, Gs, Ww, Gs, Gs, Hh, Hh, Gs, Rr, Gll^Fp, Gll^Fp, Gll^Fp, Gll^Fp, Hh, Hh, Gs^Fp, Mm, Mm, Mm, Mm
Gs, Gll^Fp, Gs^Vh, Gll^Fp, Gs, Gll^Fp, Gs, Gll^Fp, Gll^Fp, Gll^Fp, Gll^Fp, Gll^Fp, Gll^Fp, Gs, Gs, Rr, Gs, Hh, Hh, Hh, Hh, Gll^Fp, Gll^Fp, Gll^Fmw, Gll^Fdw, Gs, Gs^Fp, Gs^Es, Gs, Ww, Gs, Hh, Hh, Hh, Gs, Rr, Gll^Fp, Gs, Gll^Fp, Gs, Hh, Hh, Hh, Mm, Cud, Mm, Mm
Gll^Fp, Gll^Fp, Gll^Fp, Gll^Fp, Gll^Fp, Gll^Fp, Gs, Gll^Fp, Gll^Fp, Gll^Fp, Gll^Fp, Gs, Gll^Fp, Gs, Gs, Rr, Hh, Hh, Hh, Hh, Gs, Gll^Fp, Gll^Fdw, Re, Ce, Ce, Ce, Gs^Fp, Gs, Ww, Gs, Gs, Hh, Gs^Fp, Gs, Rr, Gs, Gll^Fp, Gll^Fp, Hh, Hh, Hh, Rr, Cud, 2 Kud, Cud, Mm
Gll^Fp, Gll^Fp, Gll^Fp, Gll^Fp, Gll^Fp, Gll^Fp, Gs, Gll^Fp, Gll^Fp, Gs, Gll^Fp, Gll^Fp, Gs, Gs, Rr, Rr, Hh, Hh, Gs, Gs, Gs, Gll^Fp, Gs^Es, Re^Es, Ce, 4 Ke, Ce, Re^Es, Ww, Ww, Hh, Hh, Gs^Fp, Gs^Fp, Re^Gvs, Rr, Gs, Gs, Gs, Gs, Rr, Rr, Hh, Cud, Cud, Cud, Hh
Gll^Fp, Gll^Fp, Gll^Fp, Gll^Fp, Gll^Fp, Gll^Fp, Gs, Gs, Gs^Fp, Gs, Gs, Hh, Hh, Hh, Rr, Hh, Hh, Gll^Fp, Gs, Gs, Gll^Fp, Gll^Fp, Rr, Re^Es, Re, Ce, Gs, Ww, Gs^Fp, Gs, Hh, Hh, Gs^Fp, Gs^Ve, Re^Gvs, Rr, Gs, Gs, Rr, Rr, Gs, Gs, Hh, Mm, Mm, Mm, Hh
Gll^Fp, Gll^Fp, Ce, Gll^Fp, Gll^Fp, Gll^Fp, Gs, Gs^Fp, Gs^Vl, Gs^Fp, Gs, Hh, Hh, Hh, Rr, Hh, Gll^Fp, Gll^Fp, Gs, Gll^Fp, Rr, Rr, Gll^Fp, Rr, Rr, Gs^Fp, Ww, Ww, Gs^Fp, Gs, Gs, Gs^Fp, Rr, Rr, Rr, Rr, Rr, Rr, Gs, Gs, Re^Gvs, Gs, Hh, Mm, Mm, Mm, Mm
Gll^Fp, Ce, 1 Ke, Ce, Re^Fp, Gs, Rr, Gs, Rr, Gs^Fp, Gll^Fp, Hh, Chr, Chr, Rr, Gll^Fp, Gll^Fp, Gll^Fp, Rr, Rr, Gll^Fp, Gll^Fp, Gs^Fp, Gs^Fp, Ww, Ww^Bw\, Rr, Gs^Es, Gs, Gs, Rr, Rr, Gs^Fp, Re^Gvs, Re, Gs, Gs, Gs, Gs, Re^Gvs, Re^Gvs, Hh, Hh, Mm, Mm, Mm, Mm
Gll^Fp, Ce, Ce, Ce, Rr, Rr, Gs, Rr, Gll^Fp, Rr, Rr, Hh, Chr, Chr, Rr, Gll^Fp, Rr, Rr, Gll^Fp, Gll^Fp, Gll^Fp, Gll^Fp, Gs^Fp, Ww, Gs^Fp, Gs^Fp, Gll^Fp, Rr, Rr, Rr, Gs, Gs, Gs^Fp, Re^Gvs, Re^Gvs, Gs, Gs^Fp, Gs, Gs, Gll^Fp, Gll^Fp, Hh^Vhh, Mm, Mm, Mm, Mm, Hh
Gs, Re^Fp, Rr, Rr, Gs, Gll^Fp, Gs, Gll^Fp, Gll^Fp, Gll^Fp, Gll^Fp, Rr, Rr, Rr, Gll^Fp, Rr, Gs, Gs, Gll^Fp, Gs, Gs^Fp, Gs^Fp, Ww, Ww, Gs^Fp, Gs, Gs, Gs, Gs, Gs^Fp, Gs, Gs, Gs^Fp, Re^Gvs, Re^Gvs, Re^Gvs, Gs, Hh, Hh, Hh, Gll^Fp, Gll^Fp, Mm, Mm, Mm, Mm, Mm
Rr, Rr, Gs, Gll^Fp, Gll^Fp, Gll^Fp, Gll^Fp, Gll^Fp, Gll^Fp, Gll^Fp, Gll^Fp, Gs^Vc, Rr, Gll^Fp, Gll^Fp, Gs, Gs^Fp, Gs, Gll^Fp, Gs, Gs^Fp, Ww, Gs^Fp, Gs, Gll^Fp, Gs, Gs, Gs^Fp, Gs, Gs^Fp, Gs, Gs, Gs, Re^Gvs, Re^Gvs, Re^Gvs, Gs, Gs, Gs, Hh, Gll^Fp, Hh, Mm, Mm, Mm, Mm^Xm, Mm
Gll^Fp, Gll^Fp, Gll^Fp, Gll^Fp, Gll^Fp, Gll^Fp, Gll^Fp, Gll^Fp, Gll^Fp, Gll^Fp, Gll^Fp, Gll^Fp, Rr, Gll^Fp, Gs, Gs, Gs, Gs, Gs, Ss, Ww, Ww, Gll^Fp, Gll^Fp, Gs, Gs, Hh, Gs, Gs^Fp, Gs^Fp, Gs^Fp, Gs, Gs, Re^Gvs, Gs, Gll^Fp, Gs, Gll^Fp, Gs, Gll^Fp, Gll^Fp, Hh, Hh, Mm, Mm, Mm^Xm, Mm
Gll^Fp, Gll^Fp, Gll^Fp, Gll^Fp, Gll^Fp, Gll^Fp, Gll^Fp, Gll^Fp, Gll^Fp, Gll^Fp, Gll^Fp, Gll^Fp, Rr, Gll^Fp, Gs, Gs^Fp, Gs, Gs, Ss, Ss, Ww, Ss, Gs, Gll^Fp, Gs, Hh, Hh, Gs, Gs^Fp, Gs, Gs^Fp, Gs, Gs, Gll^Fp, Gs, Gll^Fp, Gs, Gll^Fp, Gs, Gll^Fp, Gll^Fp, Hh, Hh, Mm, Mm^Xm, Mm, Mm
Gll^Fp, Gll^Fp, Gll^Fp, Gs^Vc, Gll^Fp, Gll^Fp, Gll^Fp, Gll^Fp, Gll^Fp, Gs^Vl, Gll^Fp, Gll^Fp, Rr, Gs, Gll^Fp, Gs, Gs, Gs, Ss, Ss, Ww, Ss, Gll^Fp, Gll^Fp, Gll^Fp, Gs, Hh, Hh, Hh, Gs, Gs, Gs, Gs, Gll^Fp, Gll^Fp, Gll^Fp, Gll^Fp, Gll^Fp, Gll^Fp, Hh, Gll^Fp, Hh, Hh, Hh, Mm, Mm, Mm
Gll^Fp, Gll^Fp, Gll^Fp, Gs, Gll^Fp, Gs, Gll^Fp, Gll^Fp, Gll^Fp, Gll^Fp, Gll^Fp, Rr, Gll^Fp, Gll^Fp, Gs, Gll^Fp, Gs, Gs, Ss, Ss, Ww, Ss, Gll^Fp, Gll^Fp, Gll^Fp, Gs^Es, Gs, Hh, Hh, Hh, Gs, Gs^Fp, Gs, Gll^Fp, Gll^Fp, Gll^Fp, Gll^Fp, Gll^Fp, Gll^Fp, Gll^Fp, Hh, Mm, Hh, Mm^Vhh, Mm, Mm, Mm
Gll^Fp, Gll^Fp, Gll^Fp, Gs, Gs, Gs, Gll^Fp, Gll^Fp, Gll^Fp, Gs, Gll^Fp, Rr, Gs, Gll^Fp, Gll^Fp, Gll^Fp, Gs, Gll^Fp, Ss, Ss^Vhs, Ww, Ss, Gll^Fp, Gll^Fmw, Gll^Fp, Gll^Fp, Gs^Es, Gll^Fp, Hh, Hh, Hh, Hh^Vhh, Gll^Fp, Gll^Fp, Gll^Fp, Hh, Gll^Fp, Hh, Hh, Hh, Gs^Fp, Mm, Hh, Mm, Mm, Mm, Mm
Gll^Fp, Gs, Gll^Fp, Gs, Gs, Gs, Gll^Fp, Gs, Gll^Fp, Gs, Gs, Rr, Gll^Fp, Gll^Fp, Gll^Fp, Gll^Fp, Gll^Fp, Gll^Fp, Ss, Ww, Ss, Ss, Gll^Fp, Gll^Fp, Ce^Es, Ce, Ce, Gll^Fp, Hh, Gs^Fp, Hh, Hh, Gll^Fp, Hh, Hh, Gll^Fp, Gll^Fp, Hh, Gs^Fp, Hh, Mm, Mm, Mm, Mm, Mm, Mm^Xm, Mm
Gs, Gs, Gs, Gll^Fp, Gs, Gll^Fp, Gs, Gll^Fp, Gs, Gll^Fp, Rr, Rr, Gll^Fp, Gll^Fp, Gll^Fp, Gll^Fp, Gll^Fp, Gll^Fp, Ss, Ww, Gll^Fp, Gll^Fp, Gll^Fp, Gs^Es, Ce, 5 Ke, Ce^Es, Gll^Fp, Gll^Fp, Hh, Hh, Hh, Hh, Gll^Fp, Hh, Hh, Hh, Mm, Gs^Fp, Hh, Mm, Mm, Mm, Mm, Mm, Mm^Xm, Mm^Xm
Gs, Gll^Fp, Gs, Gll^Fp, Gll^Fp, Gll^Fp, Gs, Gll^Fp, Gll^Fp, Gll^Fp, Rr, Gll^Fp, Gll^Fp, Gll^Fp, Gll^Fp, Gll^Fp, Gll^Fp, Gll^Fp, Gll^Fp, Ww, Gll^Fp, Gll^Fp, Gll^Fmw, Gll^Fp, Gll^Fmw, Ce, Gll^Fp, Gll^Fp, Gll^Fmw, Gll^Fp, Gll^Fp, Gll^Fp, Gll^Fp, Hh, Hh, Hh, Hh, Mm, Hh, Mm, Mm, Mm, Mm, Mm, Mm, Mm^Xm, Mm^Xm
Gll^Fp, Gll^Fp, Gll^Fp, Gll^Fp, Gll^Fp, Gll^Fp, Gll^Fp, Gll^Fp, Gll^Fp, Gll^Fp, Rr, Gll^Fp, Gll^Fp, Gll^Fp, Gll^Fp, Gll^Fp, Gll^Fp, Gll^Fp, Gll^Fp, Ww, Gll^Fp, Gll^Fp, Gll^Fp, Gll^Fp, Gll^Fp, Gll^Fp, Gll^Fp, Gll^Fmw, Gll^Fp, Gll^Fp, Gll^Fp, Gll^Fp, Gll^Fp, Hh, Gs^Fp, Hh, Mm, Mm, Mm, Mm, Mm, Mm, Mm, Mm, Mm^Xm, Mm^Xm, Mm^Xm
Gll^Fp, Gll^Fp, Gll^Fp, Gll^Fp, Gll^Fp, Gll^Fp, Gll^Fp, Gll^Fp, Gll^Fp, Gll^Fp, Rr, Gll^Fp, Gll^Fp, Gll^Fp, Gll^Fp, Gll^Fp, Gll^Fp, Gll^Fp, Gll^Fp, Ww, Gll^Fp, Gll^Fp, Gll^Fp, Gll^Fp, Gll^Fp, Gll^Fp, Gll^Fp, Gll^Fp, Gll^Fp, Gll^Fp, Gll^Fp, Gll^Fp, Gll^Fp, Hh, Gs^Fp, Hh, Mm, Mm, Mm, Mm, Mm, Mm, Mm, Mm, Mm^Xm, Mm^Xm, Mm^Xm
