Xu, Uu, Rr, Uu, Xu, Xu, Xu, Xu, Xu, Xu, Xu, Xu, Xu, Xu, Xu, Xu, Xu, Xu, Xu, Xu, Xu, Xu, Uu, Uu, Uu, Xu
Xu, Uu, Rr, Uu, Xu, Xu, Xu, Xu, Xu, Xu, Xu, Xu, Xu, Xu, Xu, Xu, Xu, Xu, Xu, Xu, Xu, Xu, Cud, Uu, Cud, Xu
Xu, Uu, Rr, Uu, Xu, Xu, Xu, Xu, Xu, Xu, Xu, Xu, Xu, Xu, Xu, Xu, Xu, Xu, Xu, Xu, Xu, Xu, Uu, Cud, Uu, Xu
Xu, Uu, Rr, Uu, Uu, Cud, Cud, Xu, Xu, Xu, Xu, Xu, Xu, Xu, Xu, Xu, Xu, Xu, Xu, Xu, Xu, Xu, Uu, Rr, Uu, Xu
Xu, Uu, Uu, Rr, Rr, Uu, Uu, Cud, Xu, Xu, Xu, Xu, Qxu, Xu, Qxu, Xu, Xu, Xu, Xu, Xu, Xu, Xu, Uu, Rr, Uu, Xu
Xu, Cud, Cud, Uu, Uu, Rr, Rr, Uu, Xu, Xu, Xu, Xu, Qxu, Qxu, Qxu, Qxu, Qxu, Qxu, Xu, Xu, Xu, Xu, Uu, Rr, Uu, Xu
Xu, Xu, Xu, Cud, Xu, Uu, Rr, Uu, Uu, Xu, Xu, Qxu, Cud, Qxu, Cud, Qxu, Cud, Qxu, Xu, Xu, Uu, Cud, Cud, Rr, Uu, Xu
Xu, Xu, Xu, Xu, Xu, Xu, Xu, Rr, Rr, Uu, Uu, Cud, Cud, Cud, Cud, Cud, Cud, Cud, Uu, Uu, Rr, Rr, Uu, Cud, Xu, Xu
Xu, Xu, Xu, Xu, Xu, Xu, Xu, Uu, Uu, Rr, Rr, Uu, Uu, Uu, Rr, Uu, Uu, Uu, Rr, Rr, Uu, Uu, Xu, Xu, Xu, Xu
Xu, Xu, Xu, Xu, Xu, Xu, Xu, Uu^Vud, Uu, Cud, Cud, Rr, Rr, Rr, Rr, Rr, Cud, Rr, Cud, Uu, Xu, Xu, Xu, Xu, Xu, Xu
Xu, Xu, Xu, Xu, Xu, Xu, Cud, Cud, Cud, Cud, Rr, Rr, Rr, Rr, Rr^Vud, Cud, Cud, Cud, Xu, Xu, Xu, Xu, Xu, Xu, Xu, Xu
Xu, Xu, Xu, Xu, Xu, Xu, Cud, Cud, 1 Cud, Cud, Rr, Rr, Rr, Rr, Cud, Cud, 2 Kud, Cud, Xu, Xu, Xu, Xu, Xu, Xu, Xu, Xu
Xu, Xu, Xu, Xu, Xu, Xu, Cud, Cud, Cud, Cud, Rr, Rr, Rr, Rr, Rr^Vud, Cud, Cud, Cud, Xu, Xu, Xu, Xu, Xu, Xu, Xu, Xu
Xu, Xu, Xu, Xu, Xu, Xu, Xu, Cud, Uu, Cud, Cud, Rr, Rr, Rr, Rr, Cud, Cud, Cud, Cud, Xu, Xu, Xu, Xu, Xu, Xu, Xu
Xu, Xu, Xu, Xu, Xu, Xu, Xu, Uu^Vud, Uu, Cud, Rr, Rr, Uu, Rr, Rr, Rr, Uu, Rr, Rr, Uu, Uu, Xu, Xu, Xu, Xu, Xu
Xu, Xu, Xu, Xu, Xu, Xu, Uu, Uu, Rr, Rr, Uu, Uu, Cud, Uu, Cud, Uu, Cud, Uu, Uu, Rr, Rr, Uu, Uu, Xu, Xu, Xu
Xu, Xu, Xu, Xu, Xu, Xu, Uu, Rr, Uu, Uu, Xu, Cud, Cud, Cud, Cud, Cud, Cud, Cud, Xu, Uu, Uu, Rr, Cud, Cud, Uu, Xu
Xu, Xu, Xu, Xu, Cud, Cud, Uu, Rr, Uu, Xu, Xu, Qxu, Qxu, Qxu, Qxu, Qxu, Qxu, Qxu, Xu, Xu, Xu, Cud, Uu, Rr, Uu, Xu
Xu, Xu, Cud, Cud, Uu, Uu, Rr, Rr, Uu, Xu, Xu, Qxu, Qxu, Qxu, Qxu, Qxu, Qxu, Xu, Xu, Xu, Xu, Xu, Uu, Rr, Uu, Xu
Xu, Xu, Uu, Uu, Rr, Rr, Uu, Uu, Cud, Xu, Xu, Xu, Xu, Xu, Xu, Xu, Xu, Xu, Xu, Xu, Xu, Xu, Uu, Rr, Uu, Xu
Uu, Uu, Rr, Rr, Uu, Uu, Cud, Cud, Xu, Xu, Xu, Xu, Xu, Xu, Xu, Xu, Xu, Xu, Xu, Xu, Xu, Xu, Uu, Rr, Uu, Xu
