Xv, Xv, Xv, Xv, Xv, Xv, Xv, Xv, Xv, Xv, Xv, Xv, Xv, Xv, Xv, Xv, Ms, Xv, Aa, Ai, Aa, Aa, Ai, Ha, Ha, Xv, Xv, Xv, Xv, Xv, Rr, Rr, Hhd, Rr, Rr, Ql, Ql, Hhd, Mm, Mv, Mm, Md, Ql, Kd, Kd, Cd, Cd, Cd, Cd, Cd, Rr
Xv, Xv, Xv, Xv, Xv, Xv, Aa^Fpa, Xv, Xv, Xv, Ha, Xv, Ms, Xv, Ha, Ha^Fpa, Ha^Fpa, Aa, Ai, Ai, Cha, Aa, Aa, Ai, Ai, Aa^Fpa, Xv, Xv, Rr, Ql, Ql, Hhd, Md, Md, Mv, Rr, Rr, Ql, Md, Md, Ql, Ql, Kd, Ql, Ql, Kd, Kd, Cd, Rr, Rr, Rr
Xv, Xv, Xv, Xv, Xv, Aa^Fpa, Ms, Ha, Ms, Ha, Aa^Fpa, Ha, Ha^Fpa, Ha^Fpa, Aa, Ha, Aa, Aa, Ai, Cha, Kha, Cha, Aa, Ai, Ms, Ha^Fpa, Ha, Xv, Xv, Rr, Ql, Md, Md, Md, Md, Md, Rr, Ql, Ql, Ql, Rrc, Kd, Kd, Kd, Ql, Ql, Rr, Rr, Rr, Rr, Cd
Xv, Xv, Xv, Xv, Aa^Fpa, Ha, Aa, Aa^Fpa, Aa, Aa^Fpa, Ai, Aa, Aa, Aa, Ai, Aa, Ai, Ai, Cha, Kha, Kha, Cha, Aa, Ai, Ms, Ms, Ms, Xv, Xv, Rr, Rr, Ql, Md, Mv, Md, Hhd, Ql, Ql^Bsb\, Rr, Ql^Bsb/, Ql, Qlf, Qlf, Kd, Rr, Ql^Bsb/, Ql^Bsb/, Rr, Rr, Kd, Kd
Xv, Xv, Xv, Ms, Ha^Fpa, Aa^Fpa, Ai, Ai, Ai, Ai, Ai, Ai, Ai, Ai, Ai, Ai, Ai, Ai, Rrc, Cha, Cha, Cha, Ai, Ai, Ms, Ms, Ha^Fma, Xv, Xv, Hhd, Hhd, Ql, Ql, Md, Ql, Ql, Kd, Ql, Ql, Rr, Rr, Ql, Ql, Qlf, Qlf, Rr, Rr, Ql^Bsb/, Ql, Ql, Ql
Xv, Xv, Ms, Ms, Aa, Aa, Ai, Ai, Ai, Ai, Ai, Ai, Ai, Ai, Ai, Ai, Ms, Rrc, Aa^Fpa, Ai, Ai, Ai, Ms, Ms, Ms, Ms, Ms, Xv, Xv, Md, Mv, Md, Ql, Ql, Cd, Kd, Kd, Qlf, Ql, Ql, Rr, Rr, Rr, Ql, Ql, Qlf, Qlf, Kd, Kd, Kd, Kd
Ai, Ha^Fpa, Aa^Fpa, Ha^Fpa, Aa, Ai, Ai, Ai, Ai, Ai, Ai, Ai, Ai, Ai, Ms, Ha, Rrc, Rrc, Aa^Fpa, Aa^Fpa, Ha^Fpa, Ha^Fpa, Aa^Fpa, Aa^Fma, Ha^Fma, Aa^Fma, Xv, Xv, Xv, Md, Md, Md, Ql, Qlf, Qlf, Kd, Kd, Kd, Rr, Ql, Ql, Rr, Rr, Rr, Rr, Ql, Ql, Qlf, Rr, Kd, Ql
Ha^Fpa, Ai, Ai, Aa^Fpa, Ai, Ai, Ai, Ai, Ai, Ai, Aa, Ai, Aa^Fpa, Aa^Fpa, Ha, Ha^Fpa, Rrc, Aa^Fpa, Ha^Fpa, Aa^Fpa, Xv, Xv, Xv, Xv, Xv, Xv, Xv, Xv, Xv, Xv, Xv, Md, Hhd, Ql, Ql, Ql, Qlf, Ql, Ql^Bsb/, Rr, Rr, Ql, Ql, Ql, Ql, Rr, Rr, Ql^Bsb/, Ql, Ql, Md
Ha^Fpa, Ms, Ai, Ai, Ai, Ai, Aa, Ai, Aa, Aa, Aa, Aa, Aa, Ms, Rrc, Rrc, Aa^Fpa, Aa^Fpa, Xv, Xv, Xv, Xv, Xv, Xv, Xv, Xv, Xv, Xv, Xv, Xv, Xv, Xv, Xv, Xv, Mm, Mv, Mm, Rr, Ql, Ql, Kd, Kd, Kd, Qlf, Kd, Ql, Ql, Ql^Bsb\, Rr, Ql, Ql
Ai, Ai, Ai, Ai, Aa^Fpa, Aa, Aa, Aa, Ha, Ms, Aa^Fpa, Aa, Aa, Aa^Fpa, Rrc, Aa^Fpa, Xv, Xv, Xv, Xv, Re, Re^Fp, Hh, Re, Re, Re, Re, Re^Fp, Mm, Hh, Wwf, Xv, Xv, Xv, Xv, Mm, Xv, Rr, Ql, Qlf, Qlf, Kd, Cd, Kd, Qlf, Qlf, Ql, Ql, Rr, Rr, Xv
Ai, Ai, Aa^Fpa, Ha, Ha, Ha^Fpa, Ha^Fpa, Aa, Xv, Xv, Xv, Ms, Rrc, Rrc, Xv, Xv, Xv, Xv, Re^Fdf, Re, Re, Re, Hh^Fdf, Re, Re, Re, Re, Re, Re^Fdf, Hh^Fmf, Wwf, Re^Fdf, Re, Xv, Xv, Xv, Xv, Xv, Xv, Ql, Ql, Qlf, Qlf, Qlf, Ql, Ql, Mv, Hhd, Md, Rr, Xv
Ha^Fpa, Ha^Fpa, Ha, Ms, Ai, Ms, Aa, Xv, Xv, Xv, Xv, Xv, Xv, Xv, Xv, Xv, Ww, Mm, Re, Re, Re, Re, Re, Re^Vct, Hh, Re^Fmf, Re^Uf, Re, Re, Ss, Hh, Wwf, Re^Vct, Re, Kh, Xv, Xv, Xv, Xv, Ql, Ql, Ql, Ql, Ql, Md, Md, Md, Md, Md, Hhd, Xv
Xv, Xv, Xv, Aa^Fpa, Aa, Aa, Xv, Xv, Xv, Xv, Xv, Xv, Xv, Xv, Wo, Wo, Wwf, Hh^Uf, Re, Re, Re, Re, Re, Re, Hh^Fp, Mm, Re, Re, Re, Re, Re, Wwf, Re, Re, Chr, Kh, Re^Uf, Xv, Xv, Xv, Ql, Qlf, Kd, Kd, Kd, Md, Md, Mv, Md, Md, Xv
Gs^Ft, Gs^Ft, Gs^Ft, Xv, Xv, Xv, Gs^Ft, Xv, Qxua, Xv, Xv, Xv, Xv, _off^_usr, _off^_usr, Ww, Re, Ss^Vhs, Re, Re, Mm, Hh^Fmf, Re, Re, Re, Re, Re, Re^Vct, Re, Re, Re, Wwf, Re^Fdf, Re, Re, Chw, Wwf, Wwf, Xv, Xv, Ql, Qlf, Qlf, Kd, Kd, Kd, Qlf, Md, Ql, Ql, Xv
Gs, Gs^Ft, Iwr, Gs^Wm, Gs^Wm, Gs^Ft, Qxua, Qxua, Qxua, Qxua, Xv, Xv, Hh, Mm, Hh^Fmf, _off^_usr, _off^_usr, Re, Re, Re, Re, Re^Fp, Re, Re, Re, Re, Kh, Re, Re, Re, Re, Wwf, Wwf, Re, Re, Chw, Wwf, Hhd^Fp, Md, Xv, Xv, Ql, Ql, Qlf, Qlf, Qlf, Ql, Ql, Ql, Ql, Xv
Iwr, Iwr, Iwr, Iwr, Iwr, Gg^Wm, Qxua, Qxua, Qxua, Qxua, Xv, Xv, Wwf, Hh^Fdf, Wwf, Wwf, Wwf, _off^_usr, Hhd, Re, Re, Re, Re, Ch, Ch, Ch, Re, Re, Re^Fmf, Re^Uf, Re^Fdf, Re, Wwf, Re, Wwf, Wwf, Re, Hhd, Hhd^Uf, Xv, Xv, Xv, Xv, Ql, Ql, Ql, Xv, Xv, Xv, Xv, Xv
Iwr, Iwr, Iwr, Iwr, Qxua, Qxua, Qxua, Qxua, Qxua, Xv, Xv, Wwf, Re^Fp, Wwf, Re, Re, Re, _off^_usr, _off^_usr, Re, Re, Re, Re, Re, Re, Re, Re, Re, Re, Hh, Re, Re, Wwf, Wwf, Re, Re, Re, Re, Re, Re^Fmf, Xv, Xv, Xv, Xv, Xv, Xv, Xv, Xv, Xv, Xv, Xv
Iwr, Iwr, Qxua, Qxua, Qxua, Qxua, Gs, Qxua, Qxua, Xv, Wo, Wwf, Re, Re, Re, Re, Re, Re, Re^Fmf, _off^_usr, Re^Fdf, Re, Hh, Re, Wwf, Wwf, Wwf, Chr, Ch, Re, Re, Re, Wwf, Re^Vct, Re, Re, Re, Re, Re^Vct, Re, Re^Fp, Xv, Xv, Xv, Xv, Xv, Dd, Dd^Edp, Dd, Dd, Dd
Qxua, Qxua, Qxua, Qxua, Gg, Gs, Gg, Gg, Qxua, Xv, Wwf, Wwf, Re, Re, Re^Vct, Re, Re, Re, Re, Xv, _off^_usr, Hh^Fp, Mm^Xm, Hh^Fdf, Chw^Xo, Chw^Xo, Chw^Xo, Chw, Chw, 1 Kh, Wwf, Wwf, Re, Re, Re, Re, Re^Fdf, Hh, Re, Re, Re^Uf, Xv, Xv, Xv, Dd, Dd, Dd, Dd, Dd, Dd^Edp, Dd
Qxua, Qxua, Qxua, Gg, Gg, Gg, Gs, Gs, Qxua, Xv, Wwf, Re^Uf, Re, Re, Hh^Uf, Hh, Mm, Re, Re, Wo, Wwf, Mm^Xm, Xv, Chw^Xo, Xv, Xv, Xv, Chw^Xo, Mm, Wwf, Re, Re, Re, Re, Kh, Re, Re, Re^Uf, Re, Re, Mm, Xv, Xv, Xv, Dd, Dd, Dd, Dd, Ko, Dd, Dd
Qxua, Qxua, Gg, Gg, Gd, Gd, Gs, Qxua, Xv, Xv, Mm, Re^Fmf, Re, Re, Re, Hh^Fmf, Re, Re, Re, Re, Hhd^Fmf, Wwf, Re^Uf, Xv, Xv, Xv, Xv, Xv, Hh^Uf, Wo, Re, Re, Re^Fdf, Ch, Chr, Ch, Re, Re, Re, Hh, Hh^Fp, Xv, Xv, Dd, Dd^Edp, Dd, Ko, Ko, Ko, Ko, Dd
Qxua, Qxua, Qxua, Gs, Gs, Gs, Qxua, Qxua, Qxua, Xv, Hh^Fmf, Re, Re, Re, Re, Re, Chr, Re, Re^Fdf, Re, Re, Wwf, Hh^Uf, Xv, Xv, Ds, Xv, Xv, Re^Uf, Wwf, Hh^Fmf, Re, Re, Re, Re, Re, Re, Re, Re, Re, Mm, Xv, Xv, Dd, Dd, Dd^Edp, Ko, Ko, Ko, Ko, Dd
Qxua, Qxua, Qxua, Gs, Qxua, Qxua, Qxua, Qxua, Qxua, Xv, Mm, Hh, Re, Re, Re, Ch, Kh, Ch, Re, Re, Re, Wo, Mm, Xv, Xv, Xv, Xv, Xv, Xv, Wwf, Wwf, Re, Re, Re, Mm, Hh^Fmf, Hh^Uf, Re, Re, Re^Fmf, Wwf, Xv, Xv, Dd, Dd, Dd, Dd, Ko, Ko, Ko, Dd
Qxua, Qxua, Gs, Gs, Qxua, Qxua, Xv, Qxua, Xv, Xv, Re^Uf, Re, Re, Re^Uf, Re^Fdf, Re, Re, Re, Re, Re, Wwf, Wwf, Chw, Chw^Xo, Chw^Xo, Xv, Chw^Xo, Chw^Xo, Mm^Xm, Mm^Xm, _off^_usr, Wo, Re, Re, Re, Hh, Re^Vct, Re, Re, Re^Uf, Wwf, Xv, Xv, Xv, Dd, Dd, Dd, Dd, Dd, Dd, Dd
Gs, Gs, Qxua, Qxua, Qxua, Qxua, Xv, Xv, Xv, Xv, Re^Fp, Re, Re^Vct, Hh, Re, Re, Re, Re, Wwf, Wwf, Re, 2 Kh, Ch, Chw, Wwf, Chw^Xo, Wwf, Hh^Fdf, Hh, Hh^Fmf, Re^Fdf, Xv, Re^Fmf, Re, Re, Re, Re, Re, Re, Re, Wo, Xv, Xv, Xv, Xv, Dd, Dd, Dd, Dd, Dd, Hd
Qxua, Qxua, Qxua, Qxua, Xv, Xv, Xv, Xv, Xv, Xv, Xv, Re, Re, Re, Re, Re, Re, Re^Vct, Wwf, Re, Re, Re, Re, Chr, Re, Wwf, Re, Re, Re, Re, Re, _off^_usr, _off^_usr, Re, Re, Re, Re, Re, Re^Fdf, Wwf, Xv, Xv, Xv, Xv, Xv, Dd, Dd, Dd, Dd^Edp, Hd^Edp, Hd
Xv, Xv, Xv, Xv, Xv, Xv, Xv, Xv, Xv, Xv, Xv, Re^Fmf, Hhd^Uf, Re, Re, Re, Wwf, Wwf, Wwf, Re, Re^Fp, Hh, Re^Fmf, Re, Re, Re, Ch, Re, Re, Re, Re, Re, Hhd, _off^_usr, Wwf, Re, Wwf, Wwf, Wwf, Wwf, Xv, Xv, Xv, Xv, Xv, Xv, Dd, Dd, Dd, Hd, Dd
Rb^Gvs, Rb^Gvs, Rb^Gvs, Xv, Rb^Fds, Rb^Fds, Rb^Fds, Xv, Xv, Xv, Xv, Xv, Md, Hhd, Wwf, Wwf, Re, Re, Wwf, Re, Re, Re^Uf, Re, Re, Kh, Ch, Re, Ch, Re, Re, Re, Re, Re, _off^_usr, _off^_usr, Wwf, Hh^Fmf, Hh^Fdf, Hh, Xv, Xv, Xv, Xv, Xv, Xv, Xv, Xv, Dd, Xv, Xv, Xv
Rb^Fds, Rb^Gvs, Rb^Gvs, Rb^Gvs, Rb^Gvs, Rb^Fds, Rb^Fds, Xv, Xv, Xv, Xv, Xv, Xv, Hhd^Fmf, Wwf, Chw, Re, Re, Re^Fdf, Wwf, Re, Re, Re, Re, Re, Re, Re, Re, Re, Re^Fdf, Mm, Re, Re, Re, Re, _off^_usr, _off^_usr, Mm, Xv, Xv, Xv, Xv, Xv, Xv, Xv, Xv, Xv, Xv, Qxu, Xv, Xv
Rb^Gvs, Rb^Gvs, Wwt, Wwt, Rb^Gvs, Rb^Gvs, Rb^Gvs, Rb^Fds, Rb^Fds, Xv, Xv, Xv, Xv, Wwf, Re^Uf, Chw, Chr, Re, Re, Wwf, Re, Re, Re, Re^Vct, Re, Re, Hh^Fdf, Re, Re, Hh^Fmf, Re, Re, Re, Ss^Vhs, Wwf, Ww, Wo, _off^_usr, Xv, Xv, Xv, Xv, Qxu, Xv, Xv, Xv, Qxu, Qxu, Wog^Edp, Qxu, Qxu
Rb^Gvs, Wwt, Rb^Gvs, Rb^Gvs, Rb^Fds, Rb^Gvs, Rb^Gvs, Rb^Gvs, Rb^Fds, Xv, Xv, Xv, Xv, Xv, Xv, Kh, Kh, Re, Re^Vct, Wwf, Hh, Re, Re, Re, Re^Uf, Mm, Hh, Re, Re, Re, Re, Re, Re, Hh^Uf, Ww, Wo, Xv, Xv, Xv, Xv, Qxu, Xv, Qxu, Qxu, Qxu, Qxu, Uu, Cud^Fet, Wog^Edp, Kud, Uu
Rb^Gvs, Rb^Gvs, Rb^Fds, Rb^Gvs, Rb^Gvs, Rb^Gvs, Rb^Gvs, Rb^Gvs, Rb^Gvs, Rb^Fds, Xv, Xv, Xv, Xv, Xv, Xv, Xv, Re, Re, Wwf, Wwf, Ss, Re^Fmf, Re, Re, Re^Fmf, Re, Re^Vct, Hh^Fmf, Re, Re, Re, Re^Fdf, Mm, Xv, Xv, Xv, Xv, Xv, Qxu, Qxu, Qxu, Qxu, Qxu, Qxu, Qxu, Qxu, Uu^Uf, Cud^Fet, Uu, Qxu
Rb^Gvs, Rb^Gvs, Rb^Gvs, Rb^Gvs, Rb^Gvs, Rb^Gvs, Chw, Chw, Rb^Gvs, Rb^Fds, Rb^Fds, Rb^Fds, Rb^Fds, Xv, Xv, Xv, Xv, Xv, Xv, Re^Fdf, Wwf, Hh^Fmf, Mm, Re, Re, Re, Re, Re, Hh, Re, Re, Re, Xv, Xv, Xv, Xv, Xv, Xv, Qxu, Qxu, Kud^Fet, Uu, Qxu, Qxu, Kud, Qxu, Qxu, Uu, Uu, Uu, Qxu
Rb^Gvs, Rb^Gvs, Rb^Gvs, Rb^Gvs, Wwt, Wwt, Rb^Gvs, Rb^Gvs, Rb^Gvs, Rb^Gvs, Rb^Fds, Rb^Gvs, Rb^Gvs, Rb^Fds, Xv, Xv, Xv, Xv, Xv, Xv, Xv, Hh, Xv, Re^Fdf, Xv, Re, Xv, Re, Xv, Re^Fdf, Xv, Xv, Xv, Xv, Xv, Xv, Xv, Qxu, Qxu, Wog^Edp, Wog^Edp, Qxu^Bs\, Uu, Uu, Uu, Wog^Edp, Qxu^Bs/, Qxu^Bs/, Qxu^Bs|, Wog^Edp, Wog^Edp
Rb^Gvs, Rb^Gvs, Rb^Gvs, Rb^Gvs, Rb^Gvs, Rb^Gvs, Rb^Fds, Rb^Gvs, Rb^Gvs, Rb^Gvs, Rb^Gvs, Rb^Gvs, Wwt, Rb^Fds, Rb^Fds, Xv, Xv, Xv, Xv, Xv, Xv, Xv, Xv, Xv, Xv, Xv, Xv, Xv, Xv, Xv, Xv, Xv, Xv, Xv, Xv, Xv, Xv, Qxu, Qxu, Qxu, Qxu, Qxu, Wog^Edp, Wog^Edp, Cud^Fet, Uu, Qxu, Qxu, Uu, Kud, Wog^Edp
Rb^Gvs, Rb^Gvs, Rb^Gvs, Rb^Gvs, Rb^Gvs, Rb^Gvs, Rb^Gvs, Rb^Gvs, Wwt, Wwt, Chw, Chw, Rb^Gvs, Rb^Gvs, Rb^Gvs, Rb^Fds, Rb^Fds, Xv, Xv, Xv, Xv, Xv, Xv, Xv, Xv, Xv, Xv, Xv, Xv, Xv, Xv, Xv, Xv, Xv, Xv, Xv, Qxu, Qxu, Wog^Edp, Qxu, Qxu, Qxu, Qxu^Bs/, Uu, Qxu, Qxu^Bs|, Qxu, Qxu, Qxu, Uu, Qxu
Rb^Fds, Rb^Gvs, Rb^Gvs, Rb^Gvs, Rb^Gvs, Rb^Gvs, Rb^Gvs, Wwt, Rb^Gvs, Rb^Gvs, Rb^Gvs, Rb^Gvs, Rb^Gvs, Rb^Gvs, Rb^Gvs, Rb^Gvs, Rb^Fds, Xv, Xv, Xv, Xv, Xv, Rb^Fds, Xv, Xv, Xv, Xv, Xv, Xv, Xv, Xv, Xv, Xv, Xv, Xv, Xv, Qxu, Cud^Fet, Kud, Wog^Edp, Uu, Qxu^Bs/, Qxu, Qxu, Qxu, Cud^Fet, Qxu^Bs\, Qxu, Qxu, Qxu^Bs|, Qxu
Rb^Gvs, Rb^Gvs, Wwt, Wwt, Rb^Gvs, Rb^Gvs, Rb^Gvs, Rb^Gvs, Rb^Gvs, Rb^Gvs, Rb^Gvs, Rb^Gvs, Wwt, Rb^Gvs, Rb^Gvs, Rb^Gvs, Wwt, Rb^Fds, Rb^Fds, Rb^Fds, Rb^Fds, Rb^Fds, Rb^Gvs, Rb^Fds, Rb^Fds, Xv, Xv, Xv, Xv, Xv, Xv, Xv, Xv, Xv, Xv, Qxu, Qxu, Qxu, Uu^Uf, Uu, Qxu, Qxu, Qxu, Qxu, Qxu, Qxu, Uu, Uu, Uu, Qxu^Bs|, Qxu
Chw, Wwt, Rb^Gvs, Rb^Gvs, Rb^Fds, Rb^Gvs, Rb^Gvs, Rb^Gvs, Wwt, Rb^Gvs, Rb^Gvs, Wwt, Rb^Gvs, Rb^Gvs, Rb^Fds, Wwt, Rb^Gvs, Rb^Gvs, Rb^Gvs, Rb^Gvs, Rb^Gvs, Rb^Gvs, Chw, Chw, Rb^Gvs, Rb^Fds, Xv, Xv, Xv, Xv, Xv, Xv, Xv, Xv, Xv, Xv, Xv, Qxu, Qxu, Qxu, Qxu, Qxu, Uu^Uf, Qxu, Qxu^Bs/, Qxu^Bs/, Uu^Uf, Wog^Edp, Wog^Edp, Uu^Uf, Qxu
Rb^Gvs, Rb^Gvs, Rb^Gvs, Rb^Gvs, Rb^Gvs, Rb^Gvs, Wwt, Wwt, Rb^Gvs, Rb^Gvs, Rb^Gvs, Rb^Gvs, Rb^Gvs, Rb^Gvs, Rb^Gvs, Rb^Gvs, Rb^Fds, Rb^Gvs, Rb^Gvs, Rb^Gvs, Wwt, Wwt, Rb^Gvs, Rb^Gvs, Rb^Fds, Rb^Fds, Xv, Xv, Xv, Xv, Xv, Xv, Xv, Xv, Xv, Xv, Xv, Qxu, Qxu, Qxu, Wog^Edp, Uu, Uu, Qxu^Bs/, Qxu, Qxu, Qxu, Cud^Fet, Qxu, Qxu, Qxu
Rb^Gvs, Rb^Gvs, Rb^Gvs, Rb^Gvs, Chw, Chw, Rb^Gvs, Rb^Gvs, Rb^Gvs, Rb^Gvs, Rb^Gvs, Rb^Fds, Wwt, Chw, Rb^Gvs, Rb^Fds, Rb^Gvs, Rb^Gvs, Rb^Gvs, Wwt, Rb^Gvs, Rb^Gvs, Rb^Gvs, Rb^Gvs, Wwt, Rb^Fds, Rb^Fds, Xv, Xv, Xv, Xv, Xv, Xv, Xv, Xv, Xv, Xv, Xv, Qxu, Uu, Wog^Edp, Kud^Fet, Cud, Uu, Cud^Fet, Qxu, Qxu, Qxu, Uu, Uu, Uu
Rb^Gvs, Rb^Gvs, Rb^Fds, Rb^Gvs, Rb^Gvs, Rb^Gvs, Rb^Fds, Rb^Gvs, Rb^Gvs, Rb^Gvs, Chw, Wwt, Rb^Gvs, Rb^Gvs, Rb^Gvs, Rb^Gvs, Rb^Gvs, Rb^Gvs, Rb^Fds, Rb^Gvs, Rb^Gvs, Rb^Gvs, Wwt, Wwt, Rb^Fds, Rb^Gvs, Rb^Gvs, Rb^Fds, Xv, Xv, Xv, Xv, Xv, Xv, Xv, Xv, Xv, Xv, Qxu, Qxu, Qxu, Wog^Edp, Cud^Fet, Uu, Qxu, Qxu, Qxu, Qxu, Uu, Wog^Edp, Wog^Edp
