Rr, Gg, Gg, Hh, Hh, Hh^Fds, Hh^Fms, Rr, Rr, Wwf, Wwf, Ww, Wwf, Ww, Ww, Ww, Ww, Ww, Ww, Wwf, Gg, Gg, Gs^Fms, Gs^Fp, Hh^Fds, Hh^Fms, Mm, Hh^Fms, Gg^Fp, Gg, Rr, Rr, Hh^Fp, Hh, Wwf, Wwf, Ww, Wo, Wo, Wo, Ww, Wwf, Wwf, Gg, Hh, Mm, Hh, Gg, Gg
Hh, Rr, Rr, Gg, Gs^Fds, Mm, Mm, Mm, Gg^Fms, Rr, Rr, Wwf, Gg, Wwf, Wwf, Ww, Wwf, Ww, Wwf, Wwf, Gs^Fms, Gg^Fp, Hh, Mm, Hh, Gs^Fds, Gg, Gg, Rr, Rr, Gg, Hh, Gg, Mm, Wwf, Ww, Wo, Wo, Wo, Wo, Ww, Wwf, Gg, Gs^Fms, Gs, Hh^Fp, Gs, Gs^Fds, Gs^Fds
Gg^Fet, Gg, Rr, Gg, Gg, Hh, Gs, Hh^Fp, Gg, Gg, Rr, Gg, Hh^Fms, Gg, Gg, Wwf, Mm, Wwf, Gg, Gg, Gg, Gg^Efm, Gg, Hh^Fms, Rr, Gg, Rr, Rr, Hh^Uf, Gs, Gs^Fms, Gg, Wwf, Wwf, Ww, Ww, Wo, Wo, Ww, Ww, Wwf, Wwf, Hh^Fms, Gg^Efm, Gg^Efm, Gs, Gg, Gg, Gg
Mm, Gg^Fp, Hh^Fds, Rr, Rr, Gg, Gg, Gg, Gg, Gg, Rr, Gg^Fms, Hh, Gg^Efm, Gg, Gs^Uf, Gs^Fp, Hh, Hh, Gg^Fet, Gg, Gg^Uf, Rr, Rr, Gg, Rr, Gg^Fet, Mm, Hh, Hh, Hh^Uf, Wwf, Ww, Ww, Wo, Wo, Wo, Ww, Wwf, Wwf, Mm, Mm, Mm, Gs^Fp, Hh, Hh, Gg^Fet, Gg, Gg
Mm, Hh, Mm, Gg^Efm, Rr, Gg^Vc, Gs^Fp, Gg^Efm, Gg^Uf, Gg, Gg, Rr, Rr, Gg, Gg, Gg^Efm, Gs^Fds, Mm, Gs^Fp, Gg, Rr, Rr, Gg^Uf, Gg, Gs^Fds, Gg, Gs, Gs^Fp, Gg, Gg^Efm, Gg, Wwf, Ww, Ww, Ww, Ww, Ww, Ww, Wwf, Hh, Gs^Fp, Mm, Gs^Fms, Gs^Uf, Gs, Gs^Fp, Gg, Gg, Rr
Gs, Gs^Fp, Gg^Fet, Gg^Uf, Rr, Gg, Hh, Mm, Gs^Fp, Gg, Gg, Gg, Rr, Gg, Gg, Gg, Gg, Hh, Gg, Gg, Rr, Gg, Hh, Mm, Hh, Gs, Gg, Gg, Gg, Gg^Vc, Wwf, Wwf, Wwf, Ww, Wwf, Wwf, Wwf, Wwf, Hh, Gg^Uf, Gs^Efm, Hh, Gs^Fds, Hh, Rr, Gg, Rr, Rr, Gg
Gg, Gs^Fds, Gg, Rr, Gg, Gg, Gg, Hh, Gs, Gs, Gg, Gg^Uf, Gg, Rp^Vhc, Rr, Rr, Rr, Gg, Rr, Rr, Gg, Gg, Gg, Gs^Fp, Gs, Gg^Efm, Gg, Gg, Gg, Gg, Wwf, Wwf, Gg, Wwf, Mm, Hh, Gg, Gg^Fet, Gg, Gs^Fp, Gg, Gg, Rr, Rr, Gg, Rr, Gg^Fet, Gg, Wwf
Gg, Gs, Gg, Rr, Rr, Gg, Gg, Gg, Gs, Gs, Hh, Gg, Gg^Efm, Gg, Gg, Gg, Gg, Rr, Gg, Gg, Gg, Gg, Gg, Gg, Gs, Hh, Hh, Gg, Wwf, Wwf, Gg, Gg, Gs, Gg, Gg, Gg, Gg, Gg, Rr, Gg, Rr, Rp^Vhc, Gg, Gg, Gg, Gg, Wwf, Wwf, Gg
Gs, Gs^Fp, Hh, Gg, Rr, Gg, Kud, Gg, Gg, Gs, Gs^Fp, Mm, Gs^Fms, Gg^Uf, Gg, Gg, Gg, Gg, Cud, Gg, Gg^Uf, Gg, Gg, Gg, Gg, Gs^Fp, Gg, Gg, Wwf, Wwf, Gg, Gs, Gs, Gs, Gg, Gs^Fds, Rr, Rr, Gg, Rr, Gg, Gg, Mm, Hh, Gg^Fms, Wwf, Gg^Uf, Gg, Gg
Gg^Fet, Hh, Mm, Gs^Fp, Rr, Cud, Cud, Gg, Gg, Gg, Gg, Gs^Fds, Gs, Gg, Gg, Gg, Kud, Cud, Xos, Cud, Kud, Xos, Xos, Gg, Cud, Gg, Cud, Wwf, Cud, Wwf, Cud, Gg, Kud, Gg, Cud, Rr, Kud, Gg, Gg, Gg, Gg, Hh, Gg^Efm, Gs^Fp, Wwf, Wwf, Gg, Gg, Gg
Gg, Gg^Fet, Gg^Uf, Gg, Rr, Cud, Gg, Cud, Cud, Gg, Gg, Gg, Gg, Gg, Cud, Cud, Xos, Xos, Ur, Ur, Xos, Cud, Xos, Cud, Xos, Cud, Xos, Cud, Wwf, Cud, Uu^Vud, Cud, Xos, Cud, Xos, Cud, Xos, Cud, Cud, Gg, Gg, Gg, Gg, Gg, Wwf, Gg, Gs, Gg, Gg
Rr, Rr, Rr, Rr, Gg, Gg, Gg, Gg, Gg, Cud, Cud, Gg, Cud, Cud, Rr, Xos, Ur^Uf, Ur, Ur, Ur, Ur^Dr, Xos, Ur, Xos, Ur, Xos, Wwf, Gs^Fp, Wwf, Rr, Ur, Xos, Ur, Xos, Ur^Dr, Xos, Ur^Uf, Ur, Cud, Cud, Cud, Gg, Wwf, Wwf, Gg, Gg^Efm, Gs^Fds, Gs, Gg
Gg^Uf, Gg, Gg, Rr, Rr, Gg^Uf, Gs^Fds, Gg, Gg, Gg, Gg, Kud, Xos, Rr, Ur, Uu^Vud, Ur, Ur, Xos, Ur, Ur, Ur, Ur, Ur, Ur, Ur, Gs^Fp, Wwf, Rr, Rr, Ur, Ur, Ur, Ur, Ur, Uu^Vud, Ur, Ur, Cud, Cud, Kud, Wwf, Cud, Gg, Gg, Gs^Fp, Mm, Mm, Gg
Gs, Gs, Mm, Gg, Rr, Gg, Gg^Efm, Gg^Efm, Gg, Gg, Gg, Cud, Xos, Xos, Ur, Ur, Ur, Xos, Ur, Ur, Ur, Ur, Ur, Xos, Ur, Ur, Xos, Wwf, Rr, Ur, Xos, Ur^Dr, Xos, Ur, Ur, Ur, Xos, Ur, Wwf, Wwf, Cud, Cud, Cud, Gg, Gg, Gs, Hh, Hh, Gg
Gg, Gs^Fp, Hh, Hh, Gg, Rr, Gg, Gs^Fp, Hh, Gg, Gg, Cud, Xos, Ur^Dr, Ur, Ur, Xos, Ur, Ur, Xos, Ur, Ur, Ur, Ur, Xos, Xos, Ur, Wwf, Rp^Vhc, Ur, Ur, Xos, Ur^Dr, Xos, Ur, Xos, Wwf, Wwf, Cud, Cud, Mm, Hh^Uf, Gs^Fds, Gs^Fp, Gg, Gs, Gg^Efm, Gs^Fp, Gg
Gg, Gg^Fet, Gs, Gs^Fp, Gg, Rr, Gg^Uf, Hh, Mm, Gg, Gg, Cud, Ur, Ur, Xos, Ur, Xos, Xos, Ur, Xos, Ur, Xos, Ur, Uh, Ur^Dr, Xos, Ur, Wwf, Wwf, Rr, Rr, Ur, Ur, Xos, Wwf, Wwf, Ur, Wwf, Wwf, Cud, Cud, Hh, Cud, Hh, Gg, Gg, Gg, Gg^Fet, Gg
Gg, Gg, Gg, Gg^Efm, Gg, Rr, Rr, Gs^Fp, Gs, Gs, Gg, Cud, Ur, Ur, Xos, Ur, Ur, Ur, Xos, Ur, Xos, Ur, Ur^Dr, Xos, Xos, Ur, Ur, Xos, Wwf, Xos, Rr, Xos, Wwf, Wwf, Xos, Gs^Fp, Ur, Xos, Xos, Wwf, Wwf, Kud, Cud, Gg, Gg, Gg, Wwf, Gg, Wwf
Gg, Gg, Gg^Uf, Mm, Hh, Gg, Rr, Gg, Gg, Gg, Cud, Kud, Xos, Xos, Ur, Ur, Xos, Xos, Ur, Ur, Xos, Kud, Cud, Xos, Cud, Ur, Xos, Xos, Wwf, Xos, Wwf, Xos, Wwf, Gs^Fms, Ur, Ur, Xos, Ur, Ur, Xos, Rr, Cud, Wwf, Wwf, Wwf, Wwf, Gg, Wwf, Gg
Gg, Gg, Gs, Gs^Fp, Rr, Rr, Gg, Gg, Cud, Cud, Xos, Xos, Ur, Ur, Xos, Uh, Ur, Ur, Xos, Ur, Ur, Xos, Xos, Cud, Xos, Wwf, Wwf, Xos, Wwf, Wwf, Gs^Fp, Wwf, Xos, Ur, Xos, Ur^Dr, Xos, Ur, Ur, Xos, Rr, Cud, Gg, Gg, Gg, Gg, Gg^Uf, Gg, Gg
Gg, Gs, Gs^Fds, Gg, Rr, Gg, Gg, Gg, Cud, Rr, Ur, Ur, Xos, Ur, Ur, Ur, Xos, Xos, Ur^Uf, Xos, Xos, Ur, Rr, Uh, Gs^Fms, Wwf, Wo, Wwf, Xos, Xos, Ur, Ur, Xos, Ur, Ur, Xos, Ur, Ur, Ur, Ur, Rr, Kud, Gg, Mm, Hh, Gg, Gs^Fp, Gs, Gg
Gg, Gg^Efm, Rr, Rr, Gs^Fp, Gg, Gg, Kud, Xos, Ur, Xos, Xos, Ur, Uu^Vud, Ur, Xos, Ur, Xos, Xos, Ur, Rr, Xos, Gg, Hh^Fp, Hh, Gg^Uf, Ww, Xos, Xos, Rr, Rr, Xos, Xos, Xos, Ur^Uf, Uu^Vud, Xos, Ur, Xos, Xos, Rr, Cud, Gg, Gs^Fp, Gg, Gg^Efm, Mm, Gs^Fp, Gg^Fet
Mm, Hh, Rr, Gs^Fp, Mm, Hh, Gg, Cud, Xos, Ur, Ur, Ur, Xos, Ur, Ur, Ur, Ur^Dr, Ur, Rr, Xos, Gg, Gg, Gg, Gg, Gg, Wwf, Wwf, Gs^Fds, Gg, Gg, Gg^Vc, Rr, Xos, Ur, Ur, Ur, Xos, Ur, Ur, Rr, Rr, Cud, Gg, Gg, Gg, Hh, Hh, Hh, Gs
Gg^Fet, Mm, Rr, Gg^Uf, Gs, Gs, Gg, Cud, Rr, Xos, Ur, Xos, Ur, Ur, Ur, Xos, Xos, Xos, Hh, Gg, Gg^Vc, Gg, Gg, Gg, Gg^Uf, Wwf, Wwf, Gg, Gg, Gg, Gg, Gs^Fp, Rr, Ur, Ur, Ur, Xos, Xos, Xos, Rr, Rr, Cud, Gg, Gg, Gg, Gg, Gg, Gs^Fp, Gg
Rr, Rr, Gg, Gg, Gg, Gg^Vc, Gg, Cud, Rr, Ur, Xos, Ur, Xos, Ur, Ur, Ur, Wo, Gs^Fp, Gg, Gg, Gg, Gg, Hh, Gs^Fp, Wwf, Wwf, Mm, Hh, Gg, Gg, Gg, Rr, Cud, Cud, Kud, Cud, Cud, Cud, Kud, Cud, Cud, Cud, Kud, Cud, Cud, Cud, 1 Kud, Gg, Gg
Gg^Fet, Gg, 2 Kud, Gg, Cud, Gg, Kud, Cud, Cud, Cud, Kud, Cud, Cud, Cud, Kud, Cud, Cud, Ww, Gg, Gg, Gg, Gs^Fp, Mm, Hh^Uf, Wwf, Hh^Uf, Hh, Gs^Fp, Gg, Gg, Gg, Kud, Wo, Cud, Ur, Cud, Xos, Cud, Xos, Cud, Rr, Cud, Gg, Gg, Gg, Gg, Gg, Gg, Rr
Gg^Uf, Gg, Gg, Cud, Gg, Cud, Gg, Cud, Rr, Cud, Xos, Cud, Xos, Cud, Ur, Cud, Rr, Kud, Gg, Gg, Gg, Hh, Wwf, Wwf, Gg^Uf, Gs^Fp, Gg, Gg, Gg^Vc, Gg, Hh, Gs^Fp, Xos, Ur, Ur, Ur, Ur, Ur, Ur, Ur, Rr, Cud, Gg, Gg^Vc, Gg, Gg, Rr, Rr, Gg
Gg, Gg, Gg, Gg, Gg, Gg, Gg, Cud, Rr, Rr, Ur, Xos, Xos, Ur, Ur, Ur, Xos, Gs^Fp, Gg^Vc, Gg, Gg, Gg, Wwf, Wwf, Gg, Gg, Gg, Gg, Gg, Gg, Rr, Xos, Ur^Dr, Xos, Ur, Ur, Xos, Xos, Ur, Xos, Xos, Cud, Gg, Gg^Efm, Mm, Gg, Rr, Gg^Uf, Gg
Gg, Gg, Gs^Fp, Gg, Gg, Gg, Gg, Cud, Rr, Rr, Xos, Ur, Xos, Ur, Ur^Uf, Ur, Xos, Rr, Rr, Gg, Xos, Gs^Fds, Ww, Wwf, Hh, Gg, Gg, Gg, Rr, Xos, Xos, Ur, Ur, Ur, Ur, Ur, Ur, Ur, Xos, Ur, Xos, Cud, Gg, Hh, Gs^Fms, Gg^Fp, Rr, Gg, Gg
Mm, Mm, Hh, Gg^Efm, Gs^Fp, Hh, Gg, Cud, Rr, Xos, Ur, Ur, Ur, Uu^Vud, Ur, Xos, Xos, Xos, Ur, Rr, Xos, Xos, Wo, Gg^Uf, Gs^Fms, Hh^Fp, Rr, Xos, Xos, Ur, Ur^Uf, Xos, Xos, Xos, Ur, Uu^Vud, Xos, Xos, Ur, Ur, Cud, Kud, Gg, Gs, Gg, Rr, Gg^Fet, Gg, Mm
Gg^Fet, Hh, Gs^Fp, Gs, Gs, Mm, Gg, Kud, Rr, Ur, Ur, Ur, Xos, Xos, Xos, Ur, Xos, Ur, Gs^Fp, Xos, Wwf, Wwf, Wwf, Wwf, Xos, Uh, Xos, Ur, Ur, Xos, Xos, Xos, Ur, Ur, Xos, Ur, Ur, Ur, Xos, Ur, Cud, Gg, Gg, Gg, Gg, Rr, Gg, Gg, Hh^Fms
Gg^Efm, Gg^Uf, Gg, Gg, Gg, Gg, Wwf, Cud, Rr, Xos, Ur, Ur, Xos, Ur^Dr, Ur, Ur, Wwf, Wwf, Wwf, Wwf, Wwf, Xos, Xos, Wwf, Cud, Cud, Cud, Xos, Xos, Ur, Ur, Ur, Xos, Uh, Ur, Ur, Xos, Xos, Cud, Cud, Gg, Gg, Rr, Rr, Rr, Rr, Gg, Gg, Gg
Wwf, Gg, Wwf, Wwf, Wwf, Wwf, Cud, Cud, Wwf, Xos, Xos, Ur, Ur, Ur, Xos, Gs^Fp, Wwf, Xos, Rr, Xos, Wwf, Xos, Ur, Ur, Xos, Xos, Ur^Dr, Kud, Xos, Ur, Xos, Xos, Ur, Ur, Xos, Xos, Ur, Kud, Gg, Gg, Gg, Rr, Mm, Hh, Gg^Fp, Gg, Gs^Fds, Gg, Gg
Gg, Wwf, Gg^Fet, Gg, Gg, Gg, Cud, Kud, Cud, Wwf, Wwf, Xos, Ur, Gs^Fp, Wwf, Wwf, Ur, Xos, Rr, Xos, Wwf, Xos, Ur, Ur, Ur^Dr, Xos, Ur, Ur, Ur, Ur, Ur, Ur, Xos, Ur, Xos, Ur, Ur, Cud, Gg, Gg, Gg^Uf, Rr, Gg^Fms, Hh, Gg, Gg, Gg, Gg^Efm, Gg
Gg, Gg, Mm, Gs^Fp, Gg, Hh, Gs^Fds, Hh, Mm, Cud, Cud, Wwf, Wwf, Wwf, Ur, Xos, Ur^Dr, Ur, Ur, Rr, Rp^Vhc, Wwf, Ur, Xos, Xos, Uh, Ur, Xos, Ur, Xos, Ur, Xos, Xos, Ur, Ur, Ur, Xos, Cud, Gg, Gg, Gg, Rr, Rr, Gg, Gg, Gg, Gg^Efm, Gg^Fp, Gg^Fet
Gg, Gs, Gg^Efm, Hh, Gg, Gs^Fp, Cud, Hh^Uf, Cud, Cud, Wwf, Wwf, Xos, Xos, Ur, Xos, Xos, Xos, Xos, Ur, Rr, Wwf, Xos, Xos, Ur, Ur, Ur, Ur, Ur, Xos, Ur, Ur, Ur, Ur, Ur, Ur^Dr, Xos, Cud, Gg, Gg, Gg, Gg, Hh, Rr, Gg, Gs^Fp, Mm, Gg^Fp, Gg^Uf
Hh, Hh, Gs^Fp, Gg, Gg, Gg, Cud, Cud, Kud, Wwf, Cud, Ur, Ur, Ur, Ur, Ur, Ur, Ur^Dr, Ur, Ur, Rr, Wwf, Gs^Fp, Ur, Ur, Xos, Ur, Ur, Ur, Ur, Xos, Xos, Ur, Ur, Ur, Xos, Xos, Cud, Gg, Gg, Gg^Uf, Mm, Gg^Fp, Rr, Gg, Hh, Hh, Hh, Gg
Gs^Fp, Mm, Gg, Gg, Gg, Gg, Wwf, Wwf, Cud, Cud, Cud, Ur, Ur^Uf, Uu^Vud, Ur^Dr, Ur, Ur, Ur, Ur, Rr, Wwf, Wwf, Wwf, Ur, Ur, Ur, Ur, Ur, Ur^Dr, Ur, Ur, Ur, Ur^Uf, Uu^Vud, Rr, Rr, Cud, Kud, Cud, Gg, Gg, Gs^Fds, Gg, Rr, Rr, Gs^Fp, Gg, Gg^Efm, Gg^Fms
Gs, Gs^Fp, Gg, Gg, Wwf, Wwf, Gg, Gg, Gg, Cud, Cud, Ur, Xos, Xos, Xos, Xos, Xos, Xos, Uu^Vud, Rr, Wwf, Gs^Fp, Xos, Xos, Xos, Xos, Xos, Xos, Xos, Ur, Ur, Ur, Xos, Xos, Cud, Cud, Gg, Gg, Gg, Cud, Cud, Gg, Gg, Gg, Gg, Rr, Gg^Uf, Gg^Fp, Gs^Fms
Gs, Gs, Gg, Gg^Uf, Wwf, Gg^Efm, Gg^Fms, Gs, Gg, Gg, Gg, Cud, Kud, Cud, Cud, Cud, Kud, Cud, Cud, Cud, Cud, Cud, Cud, Cud, Cud, Cud, Xos, Cud, Kud, Ur, Xos, Xos, Kud, Cud, Gg, Gg, Gg, Gg, Gg, Gg, Gg, Cud, Cud, Cud, Rr, Rr, Mm, Gs^Fms, Hh^Fp
Gg^Fet, Gg, Gg, Wwf, Gg, Gs^Fp, Mm, Hh, Gg, Gg, Rr, Gg, Rr, Rr, Gg, Gg, Gg, Gg, Gg, Wwf, Wwf, Wwf, Gg, Gg, Gg, Gg, Gg, Xos, Gg^Uf, Cud, Cud, Cud, Gg, Gg, Gg, Gg, Gg^Fms, Gg^Fp, Gg^Fms, Gg, Gg, Gg, Kud, Cud, Rr, Gg^Fds, Hh, Hh, Mm
Gg, Gg, Wwf, Wwf, Gg, Hh, Gg, Gg, Rr, Rr, Gg, Rr, Gg, Gs^Fds, Gs, Gg, Gg, Gg, Gg, Wwf, Wwf, Gg, Hh, Gs^Fp, Gs, Gg, Gg, Gg, Gg, Gg, Gg, Gg, Gg, Gg, Gg, Gg^Uf, Gg^Efm, Mm, Hh, Gs, Gg, Gg, Gg, Gg, Gg, Rr, Rr, Gg^Fms, Mm
Wwf, Wwf, Gg, Gg^Fds, Gg, Gg, Rr, Rp^Vhc, Gg, Gg, Gs, Gg, Gg, Gs, Mm, Gg, Gg, Gg, Wwf, Wwf, Gg, Gg, Gs, Hh, Gg^Efm, Gg, Gg, Gg, Gg, Gg, Gg, Gg, Gg, Gg, Gg, Gg, Gg, Gg, Gg, Gs, Gs, Gs, Gs, Gg, Gg, Gg, Gg^Efm, Rr, Rr
Gg, Gg, Rr, Gg, Rr, Rr, Gg^Fms, Gg, Gg^Efm, Gg^Fp, Hh, Gg^Fms, Wwf, Hh, Wwf, Wwf, Wwf, Wwf, Wwf, Gg, Gg, Gg, Gg, Gs, Hh, Gg^Fms, Hh, Gg, Rr, Rr, Rr, Rr, Rr, Gg, Rr, Rp^Vhc, Rr, Gg^Uf, Rr, Gg, Gg^Fms, Hh, Hh, Gs, Gg, Gg, Gg^Fms, Gg^Fds, Rr
Rr, Rr, Gg, Rr, Gg^Efm, Hh, Gs^Fp, Hh, Gs^Fds, Gg^Uf, Wwf, Wwf, Ww, Wwf, Ww, Ww, Ww, Wwf, Gg, Gg^Vc, Gs, Gg, Gg, Gs, Gg^Fp, Mm, Gg^Uf, Rr, Gg, Gg, Gg^Fms, Hh, Gg^Fp, Rr, Gg, Gg, Gg, Rr, Gg, Rr, Gg^Uf, Mm, Gg^Fp, Gs, Gg, Gg^Uf, Mm, Gg^Fet, Mm
Gg, Gg, Gs^Fp, Gg^Fms, Hh, Gg^Uf, Mm, Mm, Mm, Hh, Wwf, Ww, Wo, Ww, Wo, Ww, Ww, Wwf, Hh^Uf, Gs, Hh, Gg^Fms, Gg^Fp, Gg, Gg, Gg^Efm, Rr, Rr, Gg, Gg^Efm, Hh, Mm, Gg^Fet, Gg^Efm, Gg, Gg, Hh, Gg, Gg, Rr, Rr, Gg^Efm, Rr, Gg^Vc, Gg, Gg^Efm, Hh^Fp, Hh, Hh
Gg, Gs, Gs, Hh, Gg^Efm, Gs^Fms, Hh^Fms, Mm, Wwf, Wwf, Ww, Ww, Wo, Wo, Ww, Ww, Wwf, Wwf, Gg^Fp, Hh, Hh^Uf, Mm, Rr, Gg, Rr, Rr, Gg, Gg^Uf, Gg, Gg^Fms, Wwf, Hh, Mm, Gg^Uf, Gg, Gg, Hh^Fms, Gg^Fms, Gs, Gg, Gg, Rr, Gg, Rr, Rr, Gg, Gg, Gs^Fms, Gs
Hh, Gg, Gg, Gg, Gg, Gg^Efm, Gg, Wwf, Ww, Ww, Wo, Wo, Wo, Ww, Wwf, Wwf, Gg, Gg, Gg, Gg, Rr, Rr, Gg, Rr, Hh, Hh^Fms, Hh, Gg, Gg^Fp, Wwf, Ww, Wwf, Wwf, Wwf, Wwf, Gg, Gg, Gs, Gg, Gs, Gg^Fp, Hh^Fms, Mm, Hh, Gg^Fms, Rr, Gg, Gs, Gg
Gs^Fp, Hh, Mm, Hh^Fds, Gs^Fp, Hh, Wwf, Wwf, Ww, Wo, Wo, Wo, Wo, Ww, Wwf, Mm, Hh^Fms, Hh, Rr, Rr, Hh^Fds, Mm, Hh^Fds, Gg^Fms, Gg^Fet, Mm, Gg^Uf, Gg^Fms, Wwf, Wwf, Ww, Ww, Ww, Ww, Ww, Wwf, Wwf, Wwf, Wwf, Gg, Gg^Fms, Mm, Mm, Mm, Gg^Uf, Rr, Uu^Uf, Gg^Efm, Gg^Fet
