Xu, Xu, Xu, Xu, Xu, Xu, Xu, Xu, Xu, Xu, Xu, Xu, Xu, Xu, Ql, Ql, Ql, Xu, Xu, Xu, Xu, Xu, Xu, Xu, Xu, Xu, Xu, Xu, Xu, Xu, Xu
Xu, Xu, Xu, Xu, Xu, Xu, Xu, Xu, Xu, Xu, Xu, Xu, Xu, Xu, Ql, Ql, Ql, Xu, Xu, Xu, Xu, Xu, Xu, Xu, Xu, Xu, Xu, Xu, Xu, Xu, Xu
Xu, Xu, Xu, Xu, Xu, Xu, Xu, Xu, Xu, Xu, Xu, Xu, Xu, Xu, Ur, 2 Kud, Uu, Ql, Ql, Xu, Xu, Xu, Xu, Xu, Xu, Xu, Xu, Xu, Xu, Xu, Xu
Xu, Xu, Xu, Xu, Xu, Xu, Xu, Xu, Xu, Xu, Uh^Emf, Wwf, Wwf, Rd, Rd, Cud, Ur, Uu^Uf, Ur^Emf, Xu, Xu, Xu, Xu, Xu, Xu, Xu, Xu, Xu, Xu, Xu, Xu
Xu, Xu, Xu, Xu, Xu, Xu, Xu, Xu, Xu, Xu, Ur, Uu^Vu, Wwf, Wwf, Rd, Cud, Cud, Ur, Ur, Hh, Ss, Xu, Xu, Xu, Xu, Xu, Xu, Xu, Xu, Xu, Xu
Xu, Xu, Xu, Xu, Xu, Xu, Rd, Xu, Wwf, Rd, Rd, Ur, Ur, Wwf, Wwf, Rd, Rd, Cud, Rp, Gs^Fp, Ss^Vhs, Ss, Rp, Xu, Xu, Xu, Xu, Xu, Xu, Xu, Xu
Xu, Xu, Xu, Xu, Ur, Ur, Ur, Rd, Rd, Wwf, Rd, Mm, Ur, Ur, Ur^Fp, Ur^Fp, Uh, Rd, Rd, Rp, Wwf, Rp, Hh, Rp, Uu^Vu, Xu, Xu, Xu, Xu, Xu, Xu
Xu, Xu, Xu, Ql, Uu^Uf, Xu, Ur, Xu, Xu, Wwf, Wwf, Rd, Ql, Ql, Ur, Uu^Uf, Ur, Rd, Rd, Hh, Gs^Fp, Rp, Xu, Rp, Wwf, Xu, Xu, Xu, Xu, Xu, Xu
Xu, Xu, Xu, Xu, Rd, Gs^Fp, Rd, Ur, Xu, Ww, Ww, Xu, Xu, Xu, Uu^Vu, Ur, Rd, Rd, Rd, Rd, Rd, Rd, Xu, Xu, Rp, Xu, Xu, Xu, Xu, Xu, Xu
Xu, Xu, Ql, Xu, Rd, Uu^Vu, Xu, Rd, Xu, Ww, Wwf, Uh, Rd, Rd, Rd, Ur^Fp, Uh, Rd, Rp, Mm, Wwf, Ss^Vhs, Rp, Rp, Gs^Fp, Xu, Xu, Xu, Xu, Xu, Xu
Xu, Xu, Xu, Rp, Xu, Xu, Uh, Gs^Fp, Xu, Wwf, Mm, Wwf, Rd^Uf, Hh^Fp, Hh, Rd, Rd, Rd, Rp, Hh, Wwf, Rp, Xu, Xu, Uh, Xu, Xu, Xu, Xu, Xu, Xu
Xu, Xu, Wwf, Wwf, Gs^Fp, Rd, Rd, Uu^Uf, Xu, Wwf, Wwf, Wwf, Ww, Ww, Hh, Rp, Rd, Rd, Rr^Uf, Gs^Fp, Hh, Wwf, Xu, Rp, Rd, Uu^Uf, Xu, Xu, Xu, Xu, Xu
Xu, Rp, Wwf, Rp, Rp, Rd, Xu, Ur, Xu, Wwf, Rr, Ww, Rp, Gs^Fp, Rp, Rp, Rd, Rd, Rd, Gs^Fp, Rp, Wwf, Uh, Gs^Fp, Rd, Rd, Uh, Xu, Wo, Xu, Xu
Xu, Xu, Wo, Ww, Uh, Uh, Rd, Xu, Uh, Wwf, Rp, Rp, Rd, Rp, Rd, Rd, Rp, Rp, Rp, Rp, Rr, Wwf, Xu, Xu, Xu, Uh, Rp, Ww, Wwf, Xu, Xu
Xu, Xu, Xu, Xu, Xu, Rd, Rd, Gs^Fp, Xu, Wwf, Hh, Gs^Fp, Rr^Uf, Rd, Rd, Rp, Hh, Gs^Fp, Ww, Ww, Wwf, Wwf, Xu, Rd, Rd, Rd, Gs^Fp, Rp, Wwf, Rp, Xu
Xu, Xu, Xu, Xu, Xu, Uu^Uf, Uh, Rp, Xu, Wwf, Wwf, Gs^Fp, Rp, Rd, Rd, Rp, Hh, Ww, Rd^Uf, Wwf, Mm, Wwf, Xu, Uu^Uf, Uh, Rd, Xu, Wwf, Xu, Xu, Xu
Xu, Xu, Xu, Xu, Xu, Xu, Gs^Fp, Xu, Rp, Rp, Wwf, Hh, Rp, Rd, Uh, Rd, Rd, Hh^Fp, Rd, Wwf, Wwf, Wwf, Xu, Gs^Fp, Xu, Xu, Rd, Rd, Ql, Xu, Xu
Xu, Xu, Xu, Xu, Xu, Xu, Rp, Rp, Xu, Ss^Vhs, Rd, Mm, Rd, Rd, Rd, Ur^Fp, Uu^Vu, Rd, Xu, Uh, Ww, Ww, Xu, Rd, Rd, Uu^Vu, Rd, Xu, Xu, Xu, Xu
Xu, Xu, Xu, Xu, Xu, Xu, Wwf, Xu, Xu, Rd, Rd^Fp, Rd, Rd, Rd, Ur, Ur, Ur, Xu, Ql, Xu, Wwf, Ww, Xu, Ur, Ur, Gs^Fp, Uu^Uf, Xu, Xu, Xu, Xu
Xu, Xu, Xu, Xu, Xu, Xu, Uu^Vu, Rp, Hh, Rp, Wwf, Hh, Rd, Rd, Uh, Uu^Uf, Ur^Fp, Ql, Ur, Rd, Rd, Wwf, Rd, Xu, Ur, Xu, Ur, Ql, Xu, Xu, Xu
Xu, Xu, Xu, Xu, Xu, Xu, Xu, Rp, Rp, Rp, Ss^Vhs, Rp, Rp, Rd, Rd, Ur^Fp, Wwf, Ur, Ur, Mm, Rd, Wwf, Wwf, Rd, Rd, Ur, Xu, Xu, Xu, Xu, Xu
Xu, Xu, Xu, Xu, Xu, Xu, Xu, Xu, Xu, Ss, Ss, Gs^Fp, Ur, Cud, Cud, Rd, Rd, Wwf, Wwf, Ur, Ur, Rd, Xu, Xu, Xu, Xu, Xu, Xu, Xu, Xu, Xu
Xu, Xu, Xu, Xu, Xu, Xu, Xu, Xu, Xu, Xu, Xu, Hh, Ur^Emf, Ur, Ur, Cud, Rd, Wwf, Wwf, Uu^Vu, Uh^Emf, Xu, Xu, Xu, Xu, Xu, Xu, Xu, Xu, Xu, Xu
Xu, Xu, Xu, Xu, Xu, Xu, Xu, Xu, Xu, Xu, Xu, Xu, Ql, Uu^Uf, Uu, Cud, Ur, Rd, Xu, Wwf, Xu, Xu, Xu, Xu, Xu, Xu, Xu, Xu, Xu, Xu, Xu
Xu, Xu, Xu, Xu, Xu, Xu, Xu, Xu, Xu, Xu, Xu, Xu, Xu, Ql, Ql, 1 Kud, Ql, Xu, Xu, Xu, Xu, Xu, Xu, Xu, Xu, Xu, Xu, Xu, Xu, Xu, Xu
Xu, Xu, Xu, Xu, Xu, Xu, Xu, Xu, Xu, Xu, Xu, Xu, Xu, Ql, Ql, Ql, Ql, Ql, Xu, Xu, Xu, Xu, Xu, Xu, Xu, Xu, Xu, Xu, Xu, Xu, Xu
