Ur, Ur, Ur, Ww, Wwf, Wwf, Wwf, Ww, Ww, Wo, Wo, Wo, Wo, Wo, Wo, Wo, Wo, Wo, Wo, Wo, Wo, Wo, Wo, Wo^_fme, Wo^_fme, Wo^_fme, Wo^_fme, Wo^_fme, Wo^_fme, Wo^_fme, Wo^_fme, Wo^_fme
Ww, Ur, Wwf, Wwf, Ur, Gs, Gs, Wwf, Wwf, Ww, Ww, Wo, Ww, Ww, Ww, Wo, Ww, Ww, Ww, Wo, Wo, Wo, Wo, Wo, Ww, Wo^_fme, Wo^_fme, Wo^_fme, Wo^_fme, Wo^_fme, Wo^_fme, Wo^_fme
Ww, Wwf, Mm, Mv^Xo, Mm, Ur^Ft, Hh, Gs, Gs, Wwf, Ww, Ww, Wwf, Wwf, Wwf, Ww, Hh^Uf, Ww, Ds, Ww, Ww, Ww, Ww, Ww, 1 Ce, Ww, Ww, Ww^_fme, Ww^_fme, Wo^_fme, Wo^_fme, Wo^_fme
Ww, Wwf, Ur, Mm, Uh, Uh^Uf, Wwf, Gs, Ss^Vhs, Wwf, Wwf, Wwf, Gs, Gs, Wwf, Hh, Gs^Uf, Ce, Ce, Ds, Ds, Ds, Ww^Bw/, Ww^Bw/, Ww, Ww^Bw\, Ww^Bw\, Ww, Ww, Ww^_fme, Wo^_fme, Wo^_fme
Ww, Ww^Vm, Ur^Uf, Ur^Ft, Mm^Xm, Wwf, Hh^Uf, Hh^Fds, Wwf, Ww, Gs, Gs, Hh, Gs, Gs, Wwf, Wwf, Wwf, Wwf, Ke, Ce, Ce, Ww, Ww, Ww, Ww, Ww, Ww^Bw\, Ww^Bw\, Ww, Ww, Wo^_fme
Mm^Xm, Ur, Mm^Xm, Mm^Xm, Mm^Xm, Mm^Xm, Ur, Gs, Wwf, Wwf, Ur^Uf, Ur, Ur^Ft, Gs^Ft, Ur, Gs, Wwf, Gs^Vht, Gs, Wwf, Wwf, Wwf, Wwf, Ww, Wwf, Gs, Gs^Ft, Wwf, Wwf, Ke, Ce, Ww
Mm^Xm, Mm^Xm, Hh, Mm, Hh, Ur, Wwf, Wwf, Wwf, Ur^Ft, Mm^Xm, Mv^Xo, Mm, Ur, Uu^Vud, Wwf, Gs, Hh, Hh^Fds, Wwf, Gs, Gs, Gs, Wwf, Gs, Gs, Uh, Ur^Uf, Ur^Ft, Wwf, Ce, Ds
Wo, Wwf, Wwf, Wwf, Wwf, Wwf, Gs^Uf, Gs, Wwf, Uh, Uh, Mm^Xm, Ur, Ur, Wwf, Wwf, Gs, Gs^Ft, Hh^Uf, Gs, Ke, Gs, Wwf, Wwf, Ur, Ur, Mm, Mv^Xo, Mm, Wwf, Ce, Ds
Ur^Ft, Ww, Wwf, Wwf, Gs^Uf, Gs^Ft, Gs^Fds, Gs, Wwf, Gs, Gd, Ur, Gd, Gs^Uf, Gs, Ww, Ww, Gs, Gs, Gd, Ce, Wwf, Gs, Gs, Gs^Uf, Ur^Ft, Uh, Mm^Xm, Wwf, Wwf, Ce, Ds
Mv^Xo, Ur, Ur^Uf, Wwf, Ww, Gs, Gs, Gs, Wwf, Gs, Ce, Ke, Gs, Gd, Gs^Ft, Gs, Gs, Wwf, Gs, Gs, Ce, Wwf, Hh^Fds, Gs, Gd, Gd, Gd, Uu^Vud, Wwf, Ce, Ds, Ds
Mm, Mm^Xm, Uh, Gs, Gs, Ww, Wwf, Wwf, Wwf, Gs^Ft, Hh, Ce, Wwf, Hh, Gs^Uf, Gs, Gs^Vht, Wwf, Wwf, Wwf, Wwf, Wwf, Ww, Gs, Gs^Ft, Gs, Gs, Gs^Uf, Wwf, Ce, Ww, Ww
Uh, Ur^Ft, Ur, Ur, Wwf, Wwf, Uh, Ur, Ur^Ft, Wwf, Wwf, Wwf, Gs, Ww, Wwf, Wwf, Wwf, Wwf, Gs, Gs, Gs, Gs, Gs, Wwf, Ww, Gs, Wwf, Wwf, Wo, Wwf, Ww, Wo
Ur, Ur, Wwf, Wwf, Gs^Vht, Uu, Mm, Mv^Xo, Mm, Ur^Uf, Gs, Wwf, Gs, Gs, Wwf, Gs, Gs^Ft, Gs^Fds, Ur^Uf, Gd, Hh, Gs, Ww, Wwf, Hh^Fms, Ww, Gs^Uf, Gs^Ft, Gs, Wwf, Wwf, Ww
Mm, Gs, Wwf, Gs^Uf, Gd, Ur^Ft, Uh, Mm^Xm, Ur, Ur, Gs, Wwf, Gs^Ft, Hh, Wwf, Gs, Ur, Uh, Mv^Xo, Ur, Ur, Wwf, Wwf, Gs, Gs, Gs, Gd, Gs, Hh, Gs, Wwf, Ww
Gs^Fds, Wwf, Wwf, Gs, Gs, Gs, Gs, Ur^Ft, Gs, Gs, Wwf, Wwf, Gs, Hh^Uf, Gs, Wwf, Ur, Mm, Mm^Xm, Mm^Xm, Ur, Ss^Vhs, Uu, Wwf, Gs, Gd, Gs^Vht, Gs^Ft, Mm, Mm^Xm, Wwf, Ww
Ww, Wwf, Gs^Fds, Wwf, Wwf, Hh, Ww, Gs, Wwf, Wwf, Gs^Uf, Gs, Gd, Hh^Fds, Gs, Wwf, Gs, Ur^Ft, Ur, Uh, Gs, Uu^Uf, Wwf, Wwf, Hh, Hh^Uf, Wwf, Wwf, Wwf, Gs^Fds, Wwf, Ww
Ww, Wwf, Hh, Gs^Uf, Wwf, Ww, Wwf, Wwf, Wo, Wwf, Ss^Vhs, Gs, Gd, Gd, Gs, Wwf, Wwf, Gs, Gs, Gd, Gs, Wwf, Gs, Gs, Gs, Wo, Gs^Uf, Gs, Gs, Ww, Wwf, Wo
Ww, Wwf, Wwf, Wwf, Ur, Gs, Gs, Gs, Gs, Wwf, Wwf, Gs, Gs, Gs, Wwf, Wwf, Gs^Vht, Wwf, Gs^Uf, Hh, Gs, Wwf, Wwf, Gs, Wwf, Ww, Wwf, Gs^Ft, Wwf, Wwf, Ur, Ww
Ww, Ce, Wwf, Uh, Mv^Xo, Ur^Ft, Ur, Gd^Uf, Gd, Gs, Gs, Ww, Wwf, Gs, Wwf, Gs, Gs, Wwf, Wwf, Gs^Ft, Gs, Gs, Wwf, Wwf, Gs, Gs, Wwf, Wwf, Ur^Uf, Ur^Ft, Mv^Xo, Ur
Ds, Ce, Wwf, Mm, Mm^Xm, Mm, Uh, Ur, Uu^Uf, Gd, Hh^Fds, Gs, Wwf, Wwf, Ce, Gs, Gd^Ft, Gs, Wwf, Gs, Ww, Wwf, Gs, Hh, Gs^Ft, Gs, Wwf, Uh, Ur^Ft, Mm^Xm, Mm^Xm, Mm
Ds, Ce, Ce, Wwf, Wwf, Ur^Ft, Gs, Uu^Vud, Gs, Gs, Gs^Uf, Hh, Wwf, Ce, Ur, Ur, Ur, Gs, Wwf, Ww, Wwf, Gs, Ke, Ce, Gd, Gs, Mm, Wwf, Wwf, Uh, Ww, Ww
Ww, Ds, Ds, Ce, Wwf, Wwf, Gs, Gs, Wwf, Wo, Wwf, Wwf, Gs, Ke, Ur^Ft, Uh, Mv^Xo, Ur^Uf, Uu^Vud, Wwf, Gs, Wwf, Wwf, Ce, Gs, Gs^Fds, Wwf, Wwf, Wwf, Wwf, Ur, Wo
Ww, Ww, Ds, Ce, Wwf, Gs, Gs, Gs^Fds, Wwf, Wwf, Gs, Hh, Gs^Fds, Gs, Ur^Ft, Mm, Mm^Xm, Mm^Xm, Ur, Wwf, Gs, Gs, Wwf, Wwf, Wwf, Wwf, Wwf, Hh, Mm, Hh, Mm^Xm, Ur
Wo, Ww, Ww, Ce, Ke, Wwf, Wwf, Gs, Wwf, Gs, Gs, Gs, Wwf, Wwf, Wwf, Ur, Ur^Ft, Uh, Wwf, Wwf, Gs^Fds, Gs, Wwf, Ww, Gs, Gs, Mm^Xm, Mm^Xm, Mm^Xm, Mm^Xm, Mm^Xm, Mm^Xm
Wo^_fme, Wo, Wo, Ww, Ww, Ww^Bw\, Ww^Bw\, Ww, Ww, Wwf, Wwf, Wwf, Ce, Ce, Ke, Wwf, Wwf, Wwf, Wwf, Hh, Gs, Gs, Wwf, Wwf, Hh^Fds, Hh^Uf, Ur, Ur^Ft, Ur, Mm^Xm, Ur, Ww
Wo^_fme, Wo^_fme, Wo^_fme, Wo, Ww, Ww, Ww, Ww^Bw\, Ww^Bw\, Ww, Ww^Bw/, Wwf^Bw/, Ds, Ds, Ds, Ce, Ce, Gs^Uf, Wwf, Gs^Vht, Wwf, Wwf, Wwf, Ss^Vhs, Gs, Ur, Mm, Mv^Xo, Mm, Ur^Uf, Ww^Vm, Ww
Wo^_fme, Wo^_fme, Wo^_fme, Wo^_fme, Wo^_fme, Ww, Ww, Ww, Ww, 2 Ce, Ww, Ww, Ww, Ww, Ww, Ds, Hh, Hh^Uf, Ww, Wwf, Ww, Ww, Wwf, Gs, Hh, Ur^Ft, Ur^Uf, Mm, Ur^Ft, Ur, Wwf, Ww
Wo^_fme, Wo^_fme, Wo^_fme, Wo^_fme, Wo^_fme, Wo^_fme, Wo^_fme, Wo, Wo, Ww, Wo, Wo, Wo, Wo, Wo, Ww, Ww, Ww, Wo, Ww, Wo, Ww, Wwf, Gs, Gs, Gs, Gs, Ur, Wwf, Wwf, Ur, Ww
Wo^_fme, Wo^_fme, Wo^_fme, Wo^_fme, Wo^_fme, Wo^_fme, Wo^_fme, Wo^_fme, Wo^_fme, Wo, Wo, Wo, Wo, Wo, Wo, Wo, Wo, Wo, Wo, Wo, Wo, Ww, Ww, Wwf, Wwf, Wwf, Wwf, Wwf, Wwf, Ur, Ur, Ur
