Wo, Wo, Wo, Wo, Wo, Wo, Wo, Wo, Wo, Wo, Wo, Wo, Wo, Ww, Ww, Wo, Xu, Wo, Ww, Ww, Wo, Wo, Wo, Wo, Wo, Wo, Wo, Wo, Wo, Wo, Wo
Wo, Wo, Wo, Wo, Wo, Wo, Wo, Wo, Ww, Wo, Ww, Ww, Ww, Ww, Uh, Xu, Uh, Xu, Xu, Ww, Hh, Wo, Ww, Wo, Wo, Wo, Wo, Wo, Wo, Wo, Wo
Wo, Wo, Wo, Wo, Wo, Wo, Wo, Ww, Ww, Ww, Gs^Fp, Ww, Xu, Xu, Gs^Fp, Uu^Uf, Gg, Uu^Uf, Uh, Gs^Fp, Mm, Gg^Fet, Ww, Ww, Ww, Ww, Ww, Wo, Ww, Wo, Wo
Wo, Wo, Wo, Wo, Wo, Wo, Ww, Ww, Hh, Gs, Gs^Efm, Gg, Gg, Uh, Gg, Gg^Efm, Wo, Gg, Gg, Gs^Efm, Gs, Gs, Gs, Gs^Fp, Hh, Mm, Gs^Fms, Ww, Ww, Wo, Wo
Wo, Wo, Wo, Wo, Ww, Wo, Ww, Mm, Gs^Fms, Gg^Ve, Gg, Gg, Wwf, Wwf, Wwf, Wwf, Wwf, Wwf, Wwf, Gg, Gg, Gg, Rr, Gg^Vc, Gg, Wwf, Chw, Hh, Gs^Fp, Ww, Wo
Wo, Wo, Wo, Wo, Ww, Ww, Gg, Wwf, Wwf, Wwf, Wwf, Wwf, Gs, Gs^Fp, Xu, Uh, Xu, Gs^Fp, Xu, Wwf, Wwf, Gg, Wwf, Wwf, Wwf, Chw, Rr, Rr, Wwf, Ww, Wo
Wo, Wo, Wo, Ww, Ww, Gs^Fp, Re, Ch, Kh, Chw, Gg, Gg, Re, Re^Uf, Uh, Xu, Ur, Xu, Xu, Re^Uf, Xu, Wwf, Wwf, Gg, Gg, Hh, Hh, Wwf, Ww, Ww, Xu
Wo, Wo, Wo, Wo, Gg, Gg^Efm, Hh, Mm, Gg, Chw, Re, Uu^Vud, Ur, Ur, Uu^Uf, Gs^Fp, Uu, Ur, Gs^Fp, Xu, Re, Gg, Wwf, Gg, Gg, Gg^Ve, Gs^Fet, Wwf, Gs^Fp, Ww, Xu
Wo, Wo, Ww, Ww, Ww, Gg^Ve, Wwf, Gg^Fet, Wwf, Wwf, Xu, Uu, Xu, Uu^Uf, Wwf, Wwf, Wwf, Uh, Xu, Re, Gg, Gg^Ve, Kh, Wwf, Gg, Gs, Xu, Wwf, Wwf, Xu, Xu
Wo, Wo, Ww, Ww, Gg, Wwf, Gg, Wwf, Xu, Xu, Gg, Xu, Gg, Gg, Ww, Ww, Ww, Gg, Gg, Xu, Gg, Gg, Ww, Chw, Ch, Gg, Xu, Xu, Uh, Xu, Xu
Ww, Ww, Ww, Gg, Gg, Gs^Fds, Gg, Re, Gs^Efm, Gg, Gg^Vc, Gg, Gs^Fms, Ww, Wo, Wo, Wo, Ww, Ww, Gg, Wwf, Wwf, Gg, Ww, Kh, Gg, Re, Gs^Fp, Re, Xu, Xu
Ww, Ww, Gg, Gg, 1 Kh, Gg, Re, Re, Mm, Gs^Fp, Gg, Gs, Ww, Ww, Wo, Wo, Wo, Wo, Ww, Wwf, Kh, Gs^Fms, Gg^Efm, Gg, Gg, Gg, Hh, Re, Gg, Xu, Xu
Ww, Ww, Gg^Efm, Gg, Ch, Ch, Gs, Gs, Gs, Hh, Gg, Gs^Fp, Ww, Wo, Wwf, Wo, Mm, Wo, Gs, Ss^Vhs, Kh, Gs, Hh, Gs^Fds, Gg, Mm, Gg, Gg, Ww, Gg, Gg
Ww, Gg, Gg, Re, Ch, Ch, Gg, Gg, Gg, Gg, Hh, Ww, Wwf, Wwf, Rrc, Hh^Uf, Rrc, Gs^Fp, Chw, Chw, Wwf, Gg, Gg, Gg, Wwf, Gg, Wwf, Gs^Fp, Ww, Ww, Ww
Ww, Wwf, Wwf, Wwf, Wwf, Ch, Kh, Wwf, Wwf, Gg, Wwf, Wwf, Chw, Rrc, Rrc, Rrc, Rrc, Rrc, Wwf, Wwf, Gs^Fp, Wwf, Wwf, Wwf, 2 Kud, Wwf, Gg, Wwf, Ww, Wo, Wo
Gs^Fds, Gs^Fms, Hh, Gg, Gg, Wwf, Wwf, Wwf, Gg, Wwf, Kh, Chw, Gs, Gs^Fp, Mm, Hh^Uf, Wwf, Wwf, Ww, Ww, Gg, Gg, Hh, Gg, Gg, Cud, Cud, Gg, Gg, Ww, Xu
Re, Re, Re, Gg, Re, Gg, Gs^Fp, Mm, Hh, Gg, Kh, Ss^Vhs, Ww, Wo, Wo, Wo, Wo, Wo, Ww, Ww, Gg, Gg, Gg, Mm, Gg, Kud, Cud, Re, Gg, Xu, Xu
Xu, Xu, Xu, Xu, Re, Re, Re, Re, Gg, Gg, Wwf, Wwf, Ww, Ww, Ww, Wo, Ww, Ww, Ww, Gs^Fms, Gg^Efm, Gg^Ve, Gs^Fds, Gg, Cud, Cud, Gg, Re, Xu, Xu, Xu
Xu, Xu, Uu^Uf, Uu^Uf, Uh, Gg, Kud, Gg, Wwf, Wwf, Xu, Ww, Hh, Gs^Fp, Wo, Ww, Gs^Fp, Hh, Ww, Gg, Hh, Hh, Xu, Re, Re, Gg, Re, Re, Gg, Uu^Uf, Uu^Uf
Xu, Xu, Cud, Wwf, Xu, Xu, Wwf, Cud, Kud, Xu, Xu, Xu, Xu, Cud, Xu, Wo, Xu, Cud, Xu, Xu, Xu, Xu, Gs^Fp, Gg, Re, Re, Gg, Gg, Gs^Fp, Xu, Xu
Xu, Xu, Cud, Wwf, Wwf, Ww, Gg, Cud, Re, Re, Uu^Vu, Ur, Uu^Uf, Uu^Uf, Wwf, Xu, Xu, Uu^Uf, Uu^Uf, Ur, Uu^Vu, Re, Re, Gg, Re, Gg, Uu^Vud, Uu^Uf, Cud, Xu, Xu
Wwf, Wwf, Wwf, Wwf, Gs^Fp, Gg^Vc, Re, Re, Xu, Ur, Ur, Uh, Uh, Wwf, Wwf, Xu, Wwf, Wwf, Uh, Uh, Ur, Ur, Xu, Re, Gg, Gg, Gg, Ur, Cud, Xu, Xu
Xu, Xu, Xu, Xu, Gg, Gg^Efm, Mm, Re, Re, Xu, Re, Xu, Wwf, Wwf, Gg^Efm, Wwf, Gg, Wwf, Wwf, Xu, Re, Xu, Re, Re, Kud, Gg, Xu, Xu, Xu, Xu, Xu
Xu, Xu, Xu, Xu, Xu, Hh, Gs^Fp, Gg, Gg, Re, Gg, Gg, Wwf, Mm, Hh^Fds, Wwf, Gg^Uf, Hh, Gg, Wwf, Gg, Re, Gg, Cud, Cud, Cud, Xu, Xu, Xu, Xu, Xu
Xu, Xu, Xu, Xu, Xu, Xu, Re^Uf, Gg, Gs^Fms, Gg^Ve, Gg, Wwf, Gg^Uf, Gg, Gg, Wwf, Wwf, Gg^Fms, Gg, Wwf, Gg, Gg^Ve, Gs^Fds, Re, Re^Uf, Xu, Xu, Xu, Xu, Xu, Xu
Xu, Xu, Xu, Xu, Xu, Xu, Ur, Xu, Xu, Gg^Efm, Gg, Wwf, Gg, Hh, Gg, Gg^Fp, Wwf, Gg, Hh, Wwf, Wwf, Gg^Efm, Xu, Xu, Ur, Xu, Xu, Xu, Xu, Xu, Xu
Xu, Xu, Xu, Xu, Xu, Xu, Ur, Xu, Rrc, Xu, Wwf, Wwf, Gs^Fp, Gg, Xu, Gg, Wwf, Mm, Gg^Efm, Gg, Wwf, Xu, Xu, Ur, Xu, Xu, Xu, Xu, Xu, Xu, Xu
Xu, Xu, Xu, Xu, Xu, Xu, Xu, Rrc, Wwf, Chw, Wwf, Rrc, Ur, Xu, Xu, Wwf, Xu, Xu, Ur, Chw, Rrc, Wwf, Wwf, Chw, Wwf, Xu, Xu, Xu, Xu, Xu, Xu
Xu, Xu, Xu, Xu, Xu, Xu, Xu, Wwf, Xu, Xu, Rrc, Rrc, Wwf, Uh, Wwf, Wwf, Wwf, Uu^Uf, Wwf, Rrc, Rrc, Rrc, Rrc, Wwf, Xu, Xu, Xu, Xu, Xu, Xu, Xu
Xu, Xu, Xu, Xu, Xu, Xu, Xu, Xu, Xu, Xu, Xu, Xu, Wo, Wwf, Ur, Chw, Wwf, Wwf, Wo, Xu, Xu, Xu, Xu, Xu, Xu, Xu, Xu, Xu, Xu, Xu, Xu
Xu, Xu, Xu, Xu, Xu, Xu, Xu, Xu, Xu, Xu, Xu, Xu, Xu, Xu, Xu, Ur, Wo, Uh, Xu, Xu, Xu, Xu, Xu, Xu, Xu, Xu, Xu, Xu, Xu, Xu, Xu
Xu, Xu, Xu, Xu, Xu, Xu, Xu, Xu, Xu, Xu, Xu, Xu, Xu, Xu, Xu, Wo, Wo, Xu, Xu, Xu, Xu, Xu, Xu, Xu, Xu, Xu, Xu, Xu, Xu, Xu, Xu
