Mm^Xm, Mm^Xm, Mm^Xm, Mm^Xm, Mm^Xm, Mm^Xm, Wwf, Mm^Xm, Hh, Wwf, Re, Re^Fms, Hh^Fms, Mm, Hh^Fms, Re^Fms, Re, Re, Wwf, Rr, Hh^Fp, Mm, Mm^Xm, Mm, Hh^Fms, Mm, Mm^Xo, Mm^Xo, Mm^Xo, Mm^Xo, Mm
Hh, Mm^Xm, Hh^Fms, Mm^Xm, Hh, Mm^Xm, Re^Fms, Wwf, Wwf, Wwf, Wwf, Re, Hh, Mm^Xm, Ch, Re, Wwf, Wwf, Rr, Rr, Rr, Mm^Xm, Kh, Mm^Xm, Rr, Rr, Rr^Uf, Mm^Xo, Mm^Xo, Mm^Xo, Mm
Hh^Fp, Mm, Rr, Hh, Hh^Uf, Kh, Re, Re, Re, Re, Re, Wwf, Wwf, Ch, Wwf, Wwf, Rr, Rr, Ch^Ecf, Rr, Ch^Ecf, Rr, Ch^Ecf, Rr, Ch^Ecf, Rr, Ch^Ecf, Ch, 2 Kh, Mm^Xo, Mm
Re^Fms, Re^Fp, Re, Rr^Vd, Re, Re, Re, Re, Re^Fp, Mm, Hh^Fms, Wwf, Re^Uf, Wwf, Rr, Wwf, Ss^Vhs, Ch^Ecf, Ch, Ch^Ecf, Ww, Ch^Ecf, Rr, Ch^Ecf, Rr, Ch^Ecf, Re, Ch, Ch, Ch^Ecf, Wwf
Re^Uf, Re, Chw, Re, Wwf, Re, Re, Re, Re, Hh, Wwf, Wwf, Hh, Re, Re, Rr, Wwf, Kh, Wo, Ww, Hh, Mm, Rr, Rr, Re, Re, Re, Re, Wwf, Ch^Ecf, Wwf
Wwf, Wwf, Kh, Wwf, Re, Wwf, Wwf, Re, Wwf, Wwf, Re, Re^Fms, Re, Re, Re, Rr, Rr, Wwf, Wwf, Ww, Re^Fms, Hh^Fms, Re, Rr^Vd, Re, Re, Wwf, Wwf, Re, Ch^Ecf, Rr
Re, Re, Ch^Ecf, Re, Re, Re, Wo, Wwf, Re^Uf, Re, Re, Re, Re, Re, Re^Uf, Re, Rr, Wwf, Re, Re, Re, Mm, Re, Re, Re, Re, Wwf, Re, Re, Ch^Ecf, Rr
Rr, Ch^Ecf, Ch^Ecf, Ch^Ecf, Re, Re, Wwf, Wwf, Hh, Re, Re, Re, Mm, Mm^Xm, Mm^Xm, Rr^Vd, Rr, Wwf, Re, Re, Re, Re, Ch, Re, Ss^Vhs, Ss, Wwf, Re, Rr^Vd, Ch^Ecf, Rr
Rr, Ch^Ecf, Ch^Ecf, Re, Re, Wwf, Ss^Vhs, Ss, Re^Fms, Hh, Re, Re, Re, Mm^Xm, Re^Fms, Rr, Wwf, Wwf, Re^Fp, Mm, Re, Re, Kh, Ch, Wwf, Wwf, Hh, Hh^Fp, Rr, Ch^Ecf, Rr
Wwf, Ch^Ecf, Ch^Ecf, Wwf, Wwf, Wwf, Re, Re^Fp, Re, Re, Re, Re^Uf, Re, Re, Re, Rr, Wwf, Re, Hh, Hh, Re, Re, Wwf, Wwf, Re, Re^Uf, Re^Fds, Mm, Rr, Ch^Ecf, Rr
Rr, Ch^Ecf, Hh, Re, Wwf, Re, Re, Re, Re, Re, Re, Re, Re, Re, Rr, Rr, Wwf, Re, Re, Re^Fms, Re, Re, Wwf, Re, Re, Re, Re, Re, Re, Ch^Ecf, Rr
Rr, Ch^Ecf, Re^Fp, Re^Uf, Wwf, Re^Fms, Re, Re, Rp^Vhc, Re, Re, Re, Mm, Re^Fms, Hh, Rr, Wwf, Wwf, Wwf, Rr^Vd, Rr, Wwf, Re, Re, Re^Uf, Re, Re, Re, Re, Ch^Ecf, Rr
Rr, Ch^Ecf, Kh, Wwf, Re, Re, Re, Rr, Rr, Hh, Re^Fms, Re, Rr, Ch, Wwf, Wwf, Wo, Wwf, Hh^Fms, Rr^Uf, Wwf, Wwf, Re, Re, Mm, Hh, Hh^Fds, Re, Kh, Ch^Ecf, Wwf
Rr, Ch^Ecf, Wwf, Wwf, Re, Re, Re^Fms, Re, Re, Re^Uf, Re, Re, Wwf, Wwf, Ww, Wo, Ww, Wwf, Wwf, Wwf, Re, Re, Re, Re^Fp, Re^Fms, Hh, Re, Re, Wwf, Ch^Ecf, Wwf
Wwf, Ch^Ecf, Kh, Re, Hh^Fds, Hh, Mm, Re^Fp, Re, Re, Wwf, Wwf, Hh^Fms, Wwf, Wo, Wo, Wwf, Wwf, Rr, Re, Re^Fms, Re^Uf, Rr, Re, Re, Re, Re, Wwf, Kh, Ch^Ecf, Rr
Wwf, Ch^Ecf, Re, Re, Re, Hh, Re^Uf, Re, Re, Wwf, Rr, Rr^Uf, Wwf, Wwf, Wwf, Wwf, Hh, Ch, Mm, Re, Re, Hh, Rp^Vhc, Rr, Re, Re, Wwf, Wwf, Re^Fp, Ch^Ecf, Rr
Rr, Ch^Ecf, Re, Re, Re, Re, Re, Re, Wwf, Wwf, Re, Rr^Vd, Re, Wwf, Wwf, Rr, Rr, Re^Fms, Re, Re, Re, Re, Re, Re, Re, Re^Fms, Wwf, Re^Uf, Hh, Ch^Ecf, Rr
Rr, Ch^Ecf, Rr, Re, Re^Fds, Re, Re, Re, Wwf, Re, Re, Re^Fms, Hh, Re, Wwf, Rr, Re, Re, Re, Re, Re, Re, Re, Re, Re, Re, Wwf, Re, Ch^Ecf, Ch^Ecf, Wwf
Rr, Ch^Ecf, Rr, Mm, Hh, Re^Uf, Wwf, Wwf, Kh, Re, Re, Hh, Re^Fp, Re, Wwf, Rr, Re^Fms, Re, Re, Re^Uf, Re, Re, Re^Fms, Re^Fp, Ss^Vhs, Wwf, Re, Wwf, Ch^Ecf, Ch^Ecf, Rr
Rr, Ch^Ecf, Rr^Vd, Hh^Fp, Wwf, Wwf, Ss^Vhs, Ch, Ch, Re, Re, Mm, Re, Wwf, Rr, Rr, Mm^Xm, Mm^Xm, Mm, Re, Re, Hh, Hh, Ss, Wwf, Wwf, Re, Re, Ch^Ecf, Ch^Ecf, Rr
Rr, Ch^Ecf, Re, Re, Wwf, Ss, Re, Re, Re, Re, Re, Re, Re, Wwf, Rr, Rr^Vd, Re^Uf, Mm^Xm, Re, Re, Re, Re, Re^Uf, Wwf, Wo, Re, Re, Ch^Ecf, Ch^Ecf, Ch^Ecf, Re
Rr, Ch^Ecf, Re, Re, Wwf, Re, Re, Re, Re, Re, Re^Fms, Re, Wwf, Wwf, Rr, Re, Re, Re, Re, Re, Re, Re, Wwf, Wwf, Wwf, Re, Re, Re, Kh, Re, Wwf
Wwf, Ch^Ecf, Wwf, Wwf, Re, Re, Re, Rr^Vd, Rr, Hh^Fms, Hh, Ww, Wo, Wwf, Wwf, Rr, Re, Re, Hh, Re^Fms, Wwf, Wwf, Re, Re, Re, Wwf, Wwf, Wwf, Chw, Wwf, Re^Uf
Wwf, Ch^Ecf, Ch, Re, Re, Re, Rr, Rr, Rr, Mm, Ww, Ww, Ch, Kh, Ss^Vhs, Rr, Rr, Re, Re^Uf, Wwf, Hh^Fms, Hh, Re^Fms, Re, Re, Re, Re, Re, Re, Re, Re^Fms
Mm^Xo, Ch^Ecf, 1 Kh, Ch, Ch^Ecf, Ch^Ecf, Ch^Ecf, Ch^Ecf, Ch^Ecf, Ch^Ecf, Ch^Ecf, Ch^Ecf, Ch^Ecf, Ch^Ecf, Rr, Wwf, Wwf, Wwf, Wwf, Wwf, Re, Mm, Re, Re, Re, Re, Hh^Uf, Rr^Vd, Rr, Re^Fp, Hh^Fp
Mm, Mm^Xo, Mm^Xo, Ch, Rr^Uf, Rr, Rr, Rr, Kh, Rr, Rr, Rr, Rr, Rr, Wwf, Wwf, Ch, Ch, Hh, Wwf, Wwf, Re, Wwf, Re, Re^Fms, Kh, Hh, Hh, Hh^Fms, Mm, Hh
Mm, Mm^Xo, Mm, Mm^Xo, Mm^Xo, Mm^Xo, Mm, Mm^Xm, Mm^Xm, Mm^Xm, Mm^Xm, Wwf, Wwf, Wwf, Mm^Xm, Re^Fp, Mm, Mm^Xm, Hh^Fms, Re^Fms, Re^Fms, Wwf, Hh, Wwf, Wwf, Hh^Fms, Mm^Xm, Mm^Xm, Mm^Xm, Mm^Xm, Mm^Xm
