Rrc, Rrc, Rrc, Rrc, Xos, Gd, Gd, Gd^Ft, Gd, Xos, Rrc, Rrc, Gs^Ft, Gs^Ft, Gs^Ft, Rrc, Xos, Gd^Efm, Gd^Efm, Gd^Fet, Gd^Efm, Gd^Efm, Xos, Xos, Xos, Rrc, Rrc, Gs^Ft, Rrc, Gs^Ft, Rrc, Rrc, Rrc, Gs^Ft, Rrc, Gs^Ft, Rrc, Rrc, Xos, Xos, Wwg, Wwg, Wwg, Wwg, Wwg
Rrc, Rrc, Xos, Xos, Ds^Ft, Xos, Xos, Gd, Xos, Xos, Rrc, Gs^Ft, Gs^Efm, Gs^Efm, Gs^Efm, Rrc, Xos, Gd^Efm, Xos, Xos, Xos, Xos, Wwg, Wwg, Wwg, Xos, Xos, Rrc, Xos, Rrc, Xos, Xos, Xos, Rrc, Xos, Rrc, Xos, Xos, Wwg, Wwg, Wwg, Wwg, Rrc, Wwg, Wwg
Rrc, Xos, Gd, Gd^Efm, Rrc, Ds, Wwg, Xos, Wog, Wwg, Rrc, Hh, Gs^Efm, Gs^Ft, Mm, Rrc, Wwg, Xos, Wwg, Gs^Ft, Wwg, Wwg, Rrc, Xol, Xol, Wwg, Wwg, Xos, Wwg, Xos, Gs^Ft, Gs^Efm, Hh, Xos, Gd, Xos, Ds, Rrc, Wwg, Wwg, Rrc, Rrc^Xo, Wwg, Wwg, Wwg
Rrc, Xos, Gd, Md, Rrc, Dd^Vda, Wwg, Wog, Wog, Wwg, Rrc, Gs, Gs, Md, Rrc, Rrc, Ww^Vm, Wwg, Rrc, Wwg, Rrc, Rrc, Rrc^Es, Rrc, Rrc, Xol, Wwg, Wog, Wwg, Gs^Ft, Gg^Efm, Gs^Efm, Gs^Efm, Md, Gd, Ds, Ds, Rrc, Wwg, Wwg, Wwg, Wwg, Wwg, Wwg, Xos
Xos, Xos, Gd^Ft, Gd^Efm, Gd^Efm, Rrc, Hhd^Ft, Wwg, Wwg, Wwg, Rrc^Vda, Rrc, Rrc, Rrc, Wwf^Bw/, Wwf^Bw/, Rrc, Rrc, Rrc, Rrc, Rrc, Rrc, Rrc, Rrc, Rrc^Vda, Wwg, Rrc, Wwg, Rrc, Wwg, Wwg, Cd, Cd, Gs, Gs, Gd, Hd^Vda, Rrc, Rrc, Wwg, Wwg^Bw|r, Wwg, Rrc, Xos, Iwr
Rrc, Xos, Gd, Gd^Ft, Rrc, Rrc, Wwf^Bw/, Wwf^Bw/, Rrc, Rrc, Gs^Ft, Wwf^Bw\, Cd, Wwf^Bw/, Rrc, Rrc, Rrc, Rrc, Hh^Ft, Rrc, Rrc, Xol, Xol, Rrc, Rrc, Rrc, Gs^Ft, Rrc, Rb, Rrc, Rrc, Wwg^Bsb/, Wwg, Kd, Rrc, Gs^Dr, Rrc, Gd, Gd, Rrc, Rrc, Rrc, Hh^Fds, Xos, Iwr
Xos, Rrc, Rrc, Rrc, Cd, Wwf^Bw/, Rrc, Rrc, Gs^Efm, Gs^Efm, Gs^Efm, Kd, Cd, Rrc, Rrc, Rrc^Dr, Gs^Efm, Gs^Efm, Rrc, Rrc, Rrc, Rrc, Rrc^Dr, Rrc, Wwf, Wwf^Bw|, Rb, Rrc, Rb, Gg^Vda, Wwg, Wwg, Wwg^Ewl, Wwg, Rrc, Gs, Rrc, Gd, Gd^Ft, Rrc, Cd, Rrc, Rrc, Xos, Iwr
Rrc, Xos, Rrc, 2 Kd, Cd, Rrc, Gs^Ft, Gs, Gs^Es, Hh, Gs^Ft, Gs^Efm, Wwg, Rrc, Rrc, Gs^Ft, Rrc, Rrc, Rrc, Rrc^Vda, Rrc, Rrc, Gs^Efm, Gs, Wwf, Wwf^Bw|, Rrc, Rrc, Gs^Ft, Gg, Wwg, Wwg, Wwg^Ewl, Wwg, Rrc, Gs, Rrc, Mm, Rrc, Rrc, Cd, 4 Kd, Rrc, Xos, Iwr
Gs^Fds, Xos, Rrc, Cd, Kd, Gs, Gs^Ft, Md, Md, Gs, Gs^Efm, Gs^Efm, Rrc, Wwg^Bsb/, Wwg, Rrc, Gs, Xol, Xol, Rrc, Rrc, Gs, Hh^Ft, Gs^Ft, Wwf, Wwf^Bw|, Rrc, Mm, Mm, Gg, Ss, Wwg, Wwg, Wwg, Rrc^Vda, Gs^Efm, Gs^Efm, Rrc, Gs, Gs, Kd, Cd, Rrc, Xos, Iwr
Wwg, Xos, Rrc, Cd, Rrc, Gs, Gs^Efm, Hh, Gs^Efm, Gs^Efm, Gs^Efm, Gs^Vda, Rrc, Rrc, Wwg, Rrc, Mm, Gs, Gs, Xol, Rrc, Gs^Efm, Gs^Es, Hh, Wwf, Ss^Bw|, Rrc, Gs^Efm, Gs^Efm, Rb, Ss, Ss, Rrc, Rrc, Rrc, Wwf^Bw\, Wwf^Bw\, Gs^Efm, Wwf^Bw/, Wwf^Bw/, Gs, Cd, Rrc, Xos, Iwr
Wwg, Xos, Rrc^Dr, Rrc, Rrc, Gs, Gs, Gs^Efm, Gs^Efm, Gs^Efm, Gs^Dr, Gs, Rrc, Wwg^Bsb\, Rrc, Rrc, Kdr, Gs^Ft, Gs, Xol, Rrc, Gs, Wwf, Wwf, Wwf^Bw/, Ss^Vhs, Rrc, Re, Hh, Rb, Wwg^Bsb/, Rrc, Gs, Gs^Es, Gs^Efm, Rrc, Rrc, Ss^Bw|, Xol, Gs, Gs, Rrc, Gs^Dr, Xos, Xos
Gs, Xos, Rrc, Rrc, Rrc^Dr, Wwg, Wwg, Gs^Ft, Gs^Efm, Gs^Efm, Xol, Xol, Rrc, Wwg^Ewl, Gg, Gg, Gg^Efm, Gg^Efm, Gg, Rrc, Gs^Efm, Mm, Wwf^Bw|, Wwf^Bw/, Mm, Gs, Gs, Rrc, Rrc, Rrc, Wwg, Gs, Mm, Hh, Gs^Efm, Gs^Efm, Rrc, Rrc, Rrc^Vda, Xol, Rrc, Rrc, Gs^Efm, Gs^Efm, Gs^Efm
Gs^Fds, Xos, Rrc, Rrc, Rrc, Wwg, Wwg, Wwg, Wwf^Bw\, Xol, Rrc, Rrc, Rrc, Wwg, Hh, Gg, Ss, Rr^Vd, Gg, Rrc, Hh, Gg, Wwf^Bw|, Gs^Ft, Hh, Gs, Rrc, Rrc, Xol, Gg, Wwg, Gs, Gs^Efm, Gs^Efm, Gs^Ft, Gs, Rrc, Rrc, Gs^Fds, Rrc, Rrc, Gs, Gs^Fds, Gs^Fds, Gs^Fds
Gs, Xos, Gs^Ft, Rrc, Rrc, Wwg, Rrc^Vda, Rrc, Rrc, Wwf^Bw\, Wwf^Bw\, Rrc, Gs, Kdr, Ss, Ss, Ss, Gg^Em, Rrc, Rrc, Rrc, Gg^Efm, Rrc^Vda, Hh^Ft, Gg^Efm, Gs^Efm, Rrc, Xol, Gg, Gs, Kdr, Gs, Gs, Gs^Efm, Rrc^Uf, Rrc, Rrc, Gs^Efm, Rrc, Rrc, Rrc, Gs, Gs^Fds, Xos, Gs^Fds
Rrc, Xos, Gs, Rrc, Rrc, Rrc, Gs, Gs, Gs, Xol, Wwg, Wwg, Gg^Efm, Gs^Efm, Gs, Gg^Em, Wwf^Bw|, Wwg^Bw\, Wwg^Bw\, Xol, Xol, Rrc, Wwg, Rrc, Rrc, Gg^Uf, Rrc, Gg, Gg^Vc, Wwf^Bw/, Gs, Wwf^Bw\, Wwf^Bw\, Rrc, Ww^Vm, Xol, Gs^Ft, Rrc, Ce, Gs, Gs^Fet, Rrc, Gs^Efm, Gs^Fds, Gs^Efm
Xos, Xos, Gs, Ket, Ce, Gs, Hh, Hh, Ce, Ce^Xo, Ce, Wwg, Gg^Efm, Mm, Hh, Gs^Efm, Wwf^Bw|, Hh, Rb, Wwg^Bw\, Wwg, Wwg, Wwg^Ewf, Wwg, Wwg, Rrc, Rb, Gg^Ft, Wwf^Bw|, Gg, Hh, Gg, Gg^Efm, Wwf^Bw\, Ce, Xol, Ce, Ce, Hh, Ce, Ce, Rrc, Gs, Gs^Efm, Xos
Gs^Efm, Gs^Efm, Gs^Efm, Rrc, Gs^Fet, Ce, Ce, Ce, Gs^Ft, Xol, Ww^Vm, Wwf^Bw\, Wwf^Bw\, Gg, Gs, Gg, Gg^Vc, Gg^Ft, Rrc, Rrc, Rrc, Wwg, Wwg, Wwg, Xol, Wwg^Bw\, Wwg^Bw\, Hh, Wwf^Bw|, Gs^Efm, Gs, Md, Gg^Efm, Wwg, Wwg, Ce^Xo, Gs, Hh, Gs, Gs, Rrc, Ket, Gs, Xos, Rrc
Gs^Fds, Gs^Fds, Gs^Fds, Rrc, Rrc, Gs, Rrc, Rrc, Rrc, Xol, Rrc^Uf, Rrc, Gs, Wwf^Bw\, Kdr, Wwf^Bw/, Gg, Gg, Rrc, Gg^Uf, Gg^Efm, Rrc, Rrc^Vda, Rrc, Rrc, Xol, Rrc, Wwg^Bw\, Ss, Gg^Em, Ss, Gs^Efm, Gs, Wwg, Wwf^Bw\, Xol, Rrc, Gs, Rrc^Vda, Rrc, Rrc, Rrc, Gs^Ft, Xos, Gs
Gs^Fds, Xos, Gs^Fds, Gs, Rrc, Rrc, Gs^Fds, Gs^Efm, Rrc, Rrc, Gs^Ft, Gs^Efm, Gs^Efm, Gs, Wwg, Gs, Xol, Xol, Rrc, Gs^Efm, Hh, Hh^Ft, Wwf^Bw|, Gg^Efm, Hh, Rrc, Gg, Gg^Em, Ss, Ss, Hh, Kdr, Rrc, Rrc, Rrc, Wwf^Bw\, Wwf^Bw\, Rrc, Wwg, Wwg, Rrc, Rrc, Rrc, Xos, Gs^Fds
Gs^Efm, Gs^Fds, Gs^Efm, Gs, Rrc, Rrc, Rrc^Vda, Rrc, Rrc, Gs, Gs^Efm, Gs^Efm, Mm, Gs, Wwg, Gg, Rrc, Rrc, Gs, Gs, Mm, Gs^Ft, Wwf^Bw|, Gg^Efm, Gs^Efm, Rrc, Gg, Rr^Vd, Gg^Efm, Gg, Gg, Wwg, Rrc, Rrc, Xol, Xol, Gs^Efm, Wwg, Wwg, Wwg, Rrc^Dr, Rrc, Rrc, Xos, Gs
Xos, Gs^Efm, Gs^Dr, Rrc, Gs, Xol, Xol, Rrc, Rrc, Gs^Efm, Gs^Efm, Hh, Gs, Gs, Wwg^Bsb/, Rrc, Hh, Rrc, Rrc, Gs, Wwf^Bw/, Wwf^Bw/, Wwf, Mm, Rrc, Rrc, Gs, Gg^Efm, Kdr, Gg, Rrc, Wwg^Ewl, Rrc, Xol, Gs^Dr, Gs^Efm, Gs^Efm, Gs^Ft, Gs, Wwg, Rrc, Rrc, Rrc^Dr, Xos, Wwg
Iwr, Xos, Rrc, Rrc, Gs, Gs, Wwf^Bw/, Ss^Bw|, Wwf^Bw\, Rrc, Rrc, Gs^Es, Rrc, Rrc, Ss, Rb, Gs^Efm, Re, Rrc, Ss^Vhs, Wwf, Wwf, Gs^Es, Gs, Rrc, Xol, Gs, Gs^Ft, Mm, Rrc, Wwg, Wwg^Bsb\, Rrc, Gs, Gs^Efm, Gs^Efm, Gs^Efm, Gs^Efm, Gs^Efm, Gs, Rrc, Rrc, Rrc, Xos, Wwg
Iwr, Xos, Rrc, Cd, Kd, Wwf^Bw/, Gs, Gs^Efm, Gs^Efm, Wwf^Bw\, Rrc^Vda, Rrc, Wwg, Ss, Ss, Rb, Mm, Gs^Efm, Rrc, Ss^Bw|, Wwf, Hh, Hh^Ft, Gs^Efm, Rrc, Xol, Xol, Gs, Gs, Rrc, Wwg, Rrc, Rrc, Gs^Vda, Gs^Efm, Gs^Efm, Md, Hh, Gs^Ft, Gs, Kd, Cd, Rrc, Xos, Gs^Fds
Iwr, Xos, Rrc, Cd, Cd, Gs, Rrc, Rrc, Rrc, Gs^Efm, Rrc, Wwg, Wwg^Ewl, Wwg, Wwg, Gg, Gs^Ft, Mm, Rrc, Wwf^Bw|, Wwf, Gs^Ft, Gs^Efm, Gs, Rrc, Rrc, Rrc, Xol, Rrc, Rrc, Rrc, Wwg^Bsb/, Wwg, Gs^Efm, Gs^Ft, Gs, Gs^Es, Md, Gs^Ft, Gs, Cd, Cd, Rrc, Xos, Rrc
Iwr, Xos, Rrc, 3 Kd, Cd, Rrc, Gd^Ft, Mm, Rrc, Gs, Rrc, Wwg, Wwg^Ewl, Wwg, Wwg, Gg, Rb, Rrc, Rb, Wwf^Bw|, Wwf, Gs, Rrc^Dr, Rrc, Rrc, Rrc^Vda, Rrc, Rrc, Gs^Efm, Gs^Ft, Rrc, Rrc, Cd, Gs^Efm, Gs^Efm, Hh, Gs^Efm, Gs, Rrc, Rrc, Cd, 1 Kd, Rrc, Xos, Xos
Iwr, Xos, Hh^Fds, Rrc, Rrc, Rrc, Gd, Gd, Rrc, Gs, Rrc, Wwg, Wwg, Wwg, Rrc, Gg^Vda, Rb, Rrc, Gs^Ft, Wwf^Bw|, Rrc, Rrc, Xol, Rrc, Rrc, Rrc, Hh^Ft, Gs^Efm, Rrc, Rrc^Dr, Rrc, Rrc, Cd, Kd, Gs^Ft, Gs^Efm, Rrc, Rrc, Wwf^Bw/, Wwf^Bw/, Rrc, Rrc, Gd, Rrc, Rrc
Iwr, Xos, Rrc, Rrc, Wwf^Bw|r, Rrc, Rrc, Gd, Hd^Vda, Gs^Dr, Gs, Kd, Cd, Wwg^Bsb/, Wwg, Rrc, Rrc, Rrc, Rrc, Rrc, Rrc^Vda, Rrc, Rrc, Xol, Rrc, Rrc, Rrc, Rrc, Rrc, Rrc, Wwf^Bw/, Wwf^Bw/, Rrc, Wwf^Bw\, Rrc^Vda, Rrc, Wwg, Wwf^Bw/, Hhd^Ft, Rrc, Gd^Efm, Gd^Ft, Gd^Ft, Xos, Xos
Xos, Xos, Wwg, Wwg, Wwg, Wwg, Wwg, Rrc, Ds, Gd, Gd, Gs, Gs^Efm, Cd, Gg^Efm, Wwg, Wwg, Wwg, Wwg, Wwg, Rrc, Rrc, Rrc^Es, Rrc, Rrc, Rrc, Rrc, Rrc, Ww^Vm, Wwf^Bw/, Rrc, Rrc, Gs, Rrc, Rrc, Wwg, Wog, Wwg, Wwg, Rrc, Rrc, Gd^Efm, Gd, Xos, Rrc
Wwg, Wwg, Wwg, Wwg, Rrc, Wwg, Wwg, Rrc, Ds, Ds, Gd, Md, Hh, Gs^Efm, Gs^Ft, Gs^Ft, Wwg, Wog, Wwg, Xol, Xol, Rrc, Rrc, Rrc, Wwg, Wwg, Wwg, Wwg, Wwg, Rrc, Mm, Md, Gs^Efm, Gs, Rrc, Wwg, Wog, Wog, Wwg, Dd^Vda, Rrc, Md, Gd, Xos, Rrc
Wwg, Wwg, Rrc, Rrc^Xo, Wwg, Wwg, Wwg, Rrc, Xos, Xos, Xos, Xos, Xos, Gs^Efm, Xos, Xos, Xos, Xos, Xos, Wwg, Wwg, Xol, Wwg, Wwg, Xos, Gs^Ft, Xos, Xos, Xos, Rrc, Gs^Efm, Gs^Ft, Gs^Efm, Hh, Rrc, Wwg, Xos, Xos, Xos, Ds, Ds^Ft, Gd^Efm, Xos, Xos, Rrc
Wwg, Wwg, Wwg, Wwg, Wwg, Wwg, Xos, Xos, Rrc, Rrc, Rrc, Rrc, Rrc, Xos, Rrc, Rrc, Rrc, Rrc, Rrc, Xos, Xos, Wwg, Xos, Xos, Gd^Efm, Xos, Gd^Efm, Gd^Efm, Xos, Rrc, Xos, Gs^Efm, Xos, Gs^Ft, Xos, Xos, Gd, Gd, Gd, Xos, Xos, Xos, Rrc, Rrc, Rrc
Wwg, Wwg, Wwf^Bw|r, Wwg, Xos, Xos, Rrc, Rrc, Gs^Ft, Gs^Ft, Gs^Ft, Gs^Ft, Gs^Ft, Rrc, Gs^Ft, Gs^Ft, Gs^Ft, Gs^Ft, Gs^Ft, Rrc, Rrc, Xos, Gd^Efm, Gd^Efm, Gd^Efm, Gd^Fet, Gd^Efm, Gd^Efm, Xos, Rrc, Rrc, Gs^Ft, Gs^Ft, Gs^Ft, Xos, Gd, Gd^Ft, Gd^Ft, Gd^Ft, Gd, Xos, Rrc, Rrc, Rrc, Rrc
