Xv, Xv, Xv, Xv, Xv, Xv, Xv, Xv, Xv, Xv, Xv, Xv, Xv, Xv, Xv, Xv, Xv, Xv, Ha, Ha, Ms^Xm, Ha, Qxu, Qxu, Qxu, Ha, Ms^Xm, Ha, Aa, Aa, Aa, Ha, Ha, Xv, Xv, Xv, Xv, Xv, Xv, Xv, Xv, Xv, Xv, Xv
Xv, Xv, Xv, Xv, Xv, Xv, Xv, Xv, Xv, Xv, Xv, Xv, Xv, Xv, Xv, Xv, Gs, Gs, Aa, Ms^Xm, Ms^Xm, Ms^Xm, Qxu, Qxu, Qxu, Ms^Xm, Ms^Xm, Ms^Xm, Aa, Aa^Fda, Ha^Fda, Ms^Xm, Aa, Aa, Aa^Fpa, Xv, Xv, Xv, Xv, Xv, Xv, Xv, Xv, Xv
Xv, Xv, Xv, Xv, Xv, Xv, Xv, Xv, Xv, Xv, Xv, Xv, Xv, Xv, Gs, Gs, Aa^Fpa, Gs, Gs^Fda, Ha^Fda, Cea, Cea, Aa, Ww, Aa, Cea, Cea, Aa^Fda, Aa, Aa, Aa, Ha^Fda, Aa, Aa, Gs, Aa^Fpa, Aa, Xv, Xv, Xv, Xv, Xv, Xv, Xv
Xv, Xv, Xv, Xv, Xv, Xv, Xv, Xv, Xv, Xv, Xv, Xv, Gs, Gs, Aa, Aa^Fpa, Gs, Gs, Hh, Aa, Ai, Ai, Ww, Ww, Ww, Ai, Ai, Aa, Aa^Fpa, Aa, Re, Aa, Gs, Gs, Ha^Fma, Gs, 2 Kha, Aa, Gs, Xv, Xv, Xv, Xv, Xv
Xv, Xv, Xv, Xv, Xv, Xv, Xv, Xv, Xv, Xv, Gs, Gs^Fp, Gs, Gs, Gs, Aa, Gs, Aa, Re, Gs, Cea, Ww, Ww, Ww, Ww, Ww, Cea, Aa, Re, Re, Aa, Rr^Vhc, Aa, Aa, Aa, Cha, Cha, Cha, Gs, Gs, Hh, Xv, Xv, Xv
Xv, Xv, Xv, Xv, Xv, Xv, Xv, Xv, Aa^Fpa, Aa, 4 Kha, Gs, Aa, Aa, Re, Hh, Re, Re, Ms, Re, Kea, Ww, Ww, Ww, Ww, Ww, Kea, Wwf^Bw/, Wwf, Aa, Ha, Wwf, Aa^Fpa, Ms, Aa, Gs, Gs^Uf, Ww, Ww, Gs, Hh^Fmw, Mm^Xm, Mm^Xm, Xv
Xv, Xv, Xv, Xv, Xv, Xv, Aa, Aa, Re, Cha, Cha, Cha, Re, Re, Wwf, Rr^Vhc, Aa, Ms, Ha, Aa, Aa^Fpa, Cea, Cea, Ww, Cea, Cea, Re, Aa, Re, Wwf, Wwf, Wwf, Aa, Aa^Fpa, Gs, Gs, Ww, Ww, Ww, Gs, Gs, Mm^Xm, Mm^Xm, Xv
Xv, Xv, Xv, Xv, Ha, Ha, Re, Re, Aa, Wwf, Re, Aa, Wwf, Wwf, Aa, Wwf, Wwf, Aa^Fpa, Aa, Aa, Wwf, Wwf, Aa^Fpa, Cea, Ha, Wwf, Aa, Re, Gs, Aa, Aa, Wwf, Wwf, Re, Rr^Vhc, Hh, Gs, Ww, Gs, Ww, Re^Fmw, Gs, Gs, Xv
Xv, Xv, Aa, Aa, Aa, Aa^Fpa, Rr^Vhc, Aa, Wwf, Wwf, Wwf^Bw|, Wwf, Aa, Re, Wwf, Wwf, Aa^Fpa, Wwf, Wwf, Wwf, Aa, Ha, Aa, Cea, Aa^Fpa, Wwf, Wwf, Aa, Aa^Fpa, Gs, Ha, Ha, Wwf, Re, Aa, Gs, Gs, Gs, Wwf, Wwf^Bw\, Rr^Vhc, Gs, Wwf, Xv
Xv, Aa, Ms, Aa, Aa^Fpa, Aa, Wwf^Bw|, Wwf, Aa^Fpa, Wwf, Re, Ha, Ha, Re, Wwf, Gs, Re, Re, Wwf, Ha^Fma, Ms, Aa, Re, Cea, Aa^Fpa, Re, Wwf, Aa, Aa^Fpa, Gs, Re, Re, Wwf, Aa^Fpa, Re, Gs^Uf, Gs, Gs, Wwf, Gs, Wwf^Bw|, Wwf, Gs, Xv
Xv, Ha, Aa^Fpa, Ms, Wwf, Wwf, Re, Ha, Aa, Wwf, Re, Re^Fp, Wwf, Wwf, Aa, Re, Ql, Re, Wwf, Re, Aa, Aa, Cea, Cea, Cea, Aa, Wwf, Ha^Fpa, Wwf, Rr^Vhc, Wwf, Wwf, Ms^Xm, Wwf, Wwf, Gs, Aa^Fpa, Ch, Wwf, Wwf, Gs, Gs, Aa, Xv
Xv, Aa, Wwf, Wwf, Re, Re, Re, Aa, Wwf, Wwf, Rr^Vhc, Wwf, Ha^Fpa, Aa, Aa^Fpa, Ql, Re, Rr^Vhc, Re, Wwf, Wwg^Bw/, Re, Cea, Ms^Xm, Ww, Aa, Wwf, Ha, Wwf, Wwf, Ms^Xm, Ms^Xm, Aa, Ms, Wwf, Gs, Wwf, Wwf, Ha, Gs, Gs, Aa, Ql, Xv
Xv, Aa, Wwf, Re, Uu, Uh^Uf, Xuc, Re, Wwf^Bw/, Gs, Aa, Wwf, Aa, Aa^Fpa, Gs, Gs, Ha, Aa, Re^Uf, Re, Xu, Wwf, Wwf, Kea, Ww^Bw\, Wwf, Aa, Wwf, Wwf, Re, Ql, Ql, Re, Re^Fp, Wwf, Wwf^Bw|, Gs, Ms, Re, Re, Re^Fp, Aa, Ql, Xv
Xv, Wwf, Wwf, Re, Re, Uu, Xuc, Re, Wwf, Aa, Wwf, Wwf, Wwf, Ms, Aa, Re, Re, Aa^Fpa, Re, Xu, Wwf, Wwf, Xu, Ww^Bw|, Ww, Re, Re, Aa^Fpa, Wwf, Re, Re, Re, Aa^Fpa, Re, Wwf, Rr^Vhc, Gs, Re, Ww, Gs, Re, Ha, Ha, Xv
Xv, Re^Fp, Re, Wwf^Bw|, Wwf, Xuc, Gs, Re, Ha, Wwf, Ha, Re, Aa^Fpa, Wwf, Re, Re, Re, Aa^Fpa, Wwf, Wwf, Re, Re, Uh, Re, Wwf, Wwf, Wwf, Rr^Vhc, Re, Wwf^Bw/, Re, Gs, Re, Wwf, Aa, Re, Gs, Ww, Ww, Hh^Fp, Ms^Xm, Ms^Xm, Ms^Xm, Xv
Xv, Aa, Aa, Rr^Vhc, Gs, Wwf^Bw/, Gs, Gs, Gs, Ha, Aa^Fpa, Re, Wwf, Wwf, Wwf, Rr^Vhc, Wwf, Wwf, Re, Re, Ms^Xm, Uu, Uu, Re, Wwf, Hhd^Fmw, Re, Re, Aa^Fpa, Wwf, Wwf, Aa^Fpa, Wwf, Wwf, Wwf, Ha^Fpa, Ms, Gs, Re, Re, Ms^Xm, Ms^Xm, Ha, Xv
Xv, Ql, Aa, Gs, Gs, Wwf, Ha, Aa, Re, Re, Re, Wwf, Re, Aa^Fpa, Wwf, Wwf, Aa, Wwf, Re, Ha^Uf, Ms^Xm, Aa, Re, Re, Re, Aa, Re, Aa, Wwf, Wwf, Aa, Ms, Aa, Wwf, Ha, Wwf, Re, Re, Ql, Ms^Xm, Ms^Xm, Ha, Ha, Xv
Xv, Ql, Ms^Xm, Aa, Gs, Wwf, Wwf, Aa^Fpa, Cha, Re, Wwf^Bw\, Wwf, Wwf, Aa, Ms, Aa, Aa^Fpa, Wwf, Re, Ha^Uf, Ms^Xm, Ha^Fpa, Ql, Rr^Vhc, Gs, Re, Re, Re, Ha, Wwf, Aa^Fpa, Re, Re, Aa, Re, Wwf, Re, Rr^Vhc, Ql, Ms^Xm, Ms^Xm, Ms^Xm, Ha, Xv
Xv, Ms^Xm, Ms^Xm, Ms^Xm, Ql, Re, Re, Wwf, Wwf, Wwf, Re, Rr^Vhc, Aa, Wwf, Wwf, Ms, Re, Re, Re, Ql, Ql, Ms^Xm, Ms^Xm, Ql, Ql, Re, Re, Re, Ms, Wwf, Wwf, Aa, Rr^Vhc, Re, Wwf, Wwf, Wwf, Re, Re, Ql, Ms^Xm, Ms^Xm, Ms^Xm, Xv
Xv, Ha, Ms^Xm, Ms^Xm, Ms^Xm, Ql, Rr^Vhc, Re, Wwf, Re, Aa, Re, Re, Aa^Fpa, Wwf, Ha, Re, Re, Re, Gs, Rr^Vhc, Ql, Ha^Fpa, Ms^Xm, Ha^Uf, Re, Wwf, Aa^Fpa, Aa, Ms, Aa, Wwf, Wwf, Wwf^Bw\, Re, Cha, Aa^Fpa, Wwf, Wwf, Gs, Aa, Ms^Xm, Ql, Xv
Xv, Ha, Ha, Ms^Xm, Ms^Xm, Ql, Re, Re, Wwf, Ha, Wwf, Aa, Ms, Aa, Wwf, Wwf, Aa, Re, Aa, Re, Re, Re, Aa, Ms^Xm, Ha^Uf, Re, Wwf, Aa, Wwf, Wwf, Aa^Fpa, Re, Wwf, Re, Re, Re, Aa, Ha, Wwf, Gs, Gs, Aa, Ql, Xv
Xv, Ha, Ms^Xm, Ms^Xm, Re, Re, Gs, Ms, Ha^Fpa, Wwf, Wwf, Wwf, Aa^Fpa, Wwf, Wwf, Aa^Fpa, Re, Re, Hhd^Fmw, Wwf, Re, Uu, Uu, Ms^Xm, Re, Re, Wwf, Wwf, Rr^Vhc, Wwf, Wwf, Wwf, Re, Aa^Fpa, Ha, Gs, Gs, Gs, Wwf^Bw/, Gs, Rr^Vhc, Aa, Aa, Xv
Xv, Ms^Xm, Ms^Xm, Ms^Xm, Hh^Fp, Ww, Ww, Gs, Re, Aa, Wwf, Re, Gs, Re, Wwf^Bw/, Re, Rr^Vhc, Wwf, Wwf, Wwf, Re, Uh, Re, Re, Wwf, Wwf, Aa^Fpa, Re, Re, Re, Wwf, Aa^Fpa, Re, Ha, Wwf, Ha, Re, Gs, Xu, Wwf, Wwf^Bw|, Re, Re^Fp, Xv
Xv, Ha, Ha, Re, Gs, Ww, Re, Gs, Rr^Vhc, Wwf, Re, Aa^Fpa, Re, Re, Re, Wwf, Aa^Fpa, Re, Re, Ww, Ww^Bw|, Xu, Wwf, Wwf, Xu, Re, Aa^Fpa, Re, Re, Aa, Ms, Wwf, Wwf, Wwf, Aa, Wwf, Re, Xu, Uu, Re, Re, Wwf, Wwf, Xv
Xv, Ql, Aa, Re^Fp, Re, Re, Ms, Gs, Wwf^Bw|, Wwf, Re^Fp, Re, Ql, Ql, Re, Wwf, Wwf, Aa, Wwf, Ww^Bw\, Kea, Wwf, Wwf, Xu, Re, Re^Uf, Aa, Ha, Gs, Re, Aa^Fpa, Aa, Wwf, Aa, Gs, Wwf^Bw/, Re, Xu, Uh^Uf, Uu, Re, Wwf, Aa, Xv
Xv, Ql, Aa, Gs, Gs, Ha, Wwf, Wwf, Gs, Wwf, Ms, Aa, Ms^Xm, Ms^Xm, Wwf, Wwf, Ha, Wwf, Aa, Ww, Ms^Xm, Cea, Re, Wwg^Bw/, Wwf, Re, Rr^Vhc, Gs, Ql, Aa^Fpa, Aa, Ha^Fpa, Wwf, Rr^Vhc, Wwf, Wwf, Aa, Re, Re, Re, Wwf, Wwf, Aa, Xv
Xv, Aa, Gs, Gs, Wwf, Wwf, Ch, Aa^Fpa, Gs, Wwf, Wwf, Ms^Xm, Wwf, Wwf, Rr^Vhc, Wwf, Ha^Fpa, Wwf, Aa, Cea, Cea, Cea, Aa, Aa, Re, Wwf, Re, Ql, Re, Aa, Wwf, Wwf, Re^Fp, Re, Wwf, Aa, Ha, Re, Wwf, Wwf, Ms, Aa^Fpa, Ha, Xv
Xv, Gs, Wwf, Wwf^Bw|, Gs, Wwf, Gs, Gs, Gs^Uf, Re, Aa^Fpa, Wwf, Re, Re, Gs, Aa^Fpa, Aa, Wwf, Re, Aa^Fpa, Cea, Re, Aa, Ms, Ha^Fma, Wwf, Re, Re, Gs, Wwf, Re, Ha, Ha, Re, Wwf, Aa^Fpa, Wwf, Wwf^Bw|, Aa, Aa^Fpa, Aa, Ms, Aa, Xv
Xv, Wwf, Gs, Rr^Vhc, Wwf^Bw\, Wwf, Gs, Gs, Gs, Ha, Re, Wwf, Ha, Ha, Gs, Aa^Fpa, Aa, Wwf, Wwf, Aa^Fpa, Cea, Aa, Ha, Aa, Wwf, Wwf, Wwf, Aa^Fpa, Wwf, Wwf, Re, Aa, Wwf, Wwf^Bw|, Wwf, Wwf, Aa, Rr^Vhc, Aa^Fpa, Aa, Aa, Aa, Xv, Xv
Xv, Gs, Gs, Re^Fmw, Ww, Gs, Ww, Gs, Hh, Rr^Vhc, Re, Wwf, Wwf, Aa, Aa, Gs, Re, Aa, Wwf, Ha, Cea, Aa^Fpa, Wwf, Wwf, Aa, Aa, Aa^Fpa, Wwf, Wwf, Aa, Wwf, Wwf, Aa, Re, Wwf, Aa, Re, Re, Ha, Ha, Xv, Xv, Xv, Xv
Xv, Mm^Xm, Mm^Xm, Gs, Gs, Ww, Ww, Ww, Gs, Gs, Aa^Fpa, Aa, Wwf, Wwf, Wwf, Re, Aa, Re, Cea, Cea, Ww, Cea, Cea, Aa^Fpa, Aa, Ha, Ms, Aa, Rr^Vhc, Wwf, Re, Re, Cha, Cha, Cha, Re, Aa, Aa, Xv, Xv, Xv, Xv, Xv, Xv
Xv, Mm^Xm, Mm^Xm, Hh^Fmw, Gs, Ww, Ww, Re^Uf, Gs, Aa, Ms, Aa^Fpa, Wwf, Ha, Aa, Wwf, Wwf^Bw/, Kea, Ww, Ww, Ww, Ww, Ww, Kea, Re, Ms, Re, Re, Hh, Re, Aa, Aa, Gs, 3 Kha, Aa, Aa^Fpa, Xv, Xv, Xv, Xv, Xv, Xv, Xv, Xv
Xv, Xv, Xv, Hh, Gs, Gs, Cha, Cha, Cha, Aa, Aa, Aa, Rr^Vhc, Aa, Re, Re, Aa, Cea, Ww, Ww, Ww, Ww, Ww, Cea, Gs, Re, Aa, Gs, Aa, Gs, Gs, Gs, Gs^Fp, Gs, Xv, Xv, Xv, Xv, Xv, Xv, Xv, Xv, Xv, Xv
Xv, Xv, Xv, Xv, Xv, Gs, Gs, 1 Kha, Gs, Ha^Fma, Gs, Gs, Aa, Re, Aa, Aa^Fpa, Aa, Ai, Ai, Ww, Ww, Ww, Ai, Ai, Aa, Hh, Gs, Gs, Aa^Fpa, Aa, Gs, Gs, Xv, Xv, Xv, Xv, Xv, Xv, Xv, Xv, Xv, Xv, Xv, Xv
Xv, Xv, Xv, Xv, Xv, Xv, Xv, Aa, Aa^Fpa, Gs, Aa, Aa, Ha^Fda, Aa, Aa, Aa, Aa^Fda, Cea, Cea, Aa, Ww, Aa, Cea, Cea, Ha^Fda, Gs^Fda, Gs, Aa^Fpa, Gs, Gs, Xv, Xv, Xv, Xv, Xv, Xv, Xv, Xv, Xv, Xv, Xv, Xv, Xv, Xv
Xv, Xv, Xv, Xv, Xv, Xv, Xv, Xv, Xv, Aa^Fpa, Aa, Aa, Ms^Xm, Ha^Fda, Aa^Fda, Aa, Ms^Xm, Ms^Xm, Ms^Xm, Qxu, Qxu, Qxu, Ms^Xm, Ms^Xm, Ms^Xm, Aa, Gs, Gs, Xv, Xv, Xv, Xv, Xv, Xv, Xv, Xv, Xv, Xv, Xv, Xv, Xv, Xv, Xv, Xv
Xv, Xv, Xv, Xv, Xv, Xv, Xv, Xv, Xv, Xv, Xv, Ha, Ha, Aa, Aa, Aa, Ha, Ms^Xm, Ha, Qxu, Qxu, Qxu, Ha, Ms^Xm, Ha, Ha, Xv, Xv, Xv, Xv, Xv, Xv, Xv, Xv, Xv, Xv, Xv, Xv, Xv, Xv, Xv, Xv, Xv, Xv
