Mm^Xm, Mm^Xm, Mm^Xm, Mm, Hh, Hh, Gs^Fp, Gs^Fp, Wwf, Mm, Hh^Uf, Mm, Ss, Hh, Mm, Gg, Gg, Hh, Hh, Ss, Hh, Hh, Gg^Uf, Hh, Hh, Gg, Mm, Hh, Hh^Uf, Ss, Ss, Hh, Hh, Hh, Hh, Mm, Mm
Mm^Xm, Mm^Xm, Mm^Xm, Mm, Hh, Hh, Gs^Fms, Gs^Fp, Wwf, Hh, Hh, Hh, Gg^Uf, Hh, Gs^Fp, Hh, Gg, Hh, Hh, Hh, Hh, Gs^Fp, Gg, Hh, Hh, Hh, Hh, Hh, Hh, Hh, Hh, Gs^Fp, Hh, Hh, Hh^Vhh, Hh, Hh
Mm^Xm, Mm^Xm, Mm, Hh, Gs^Fp, Gg^Vh, Hh, Gg, Wwf, Gg, Gs^Fp, Hh, Gg, Hh, Gg, Gg, Gg^Ve, Gg, Gs^Fp, Gg^Uf, Hh, Gg, Gg, Gg, Gg, Gg, Gs^Fp, Gs^Fp, Ss, Ss, Gs^Fms, Gs^Fp, Gg, Re, Gs^Fp, Gs, Gg^Uf
Mm^Xm, Mm^Xm, Mm, Mm, Gg, Gg, Gg, Gg, Wwt, Gg, Gg, Gg, Gg, Gg, Re, Re, Re, Re, Re, Gg, Re, Gg, Re, Re, Re, Re, Re, Gg, Gg, Hh, Re, Re, Re, Re, Gs, Gll, Gs
Hh, Hh, Gs^Fp, Gg, Ch, Gs^Fp, Wwt, Wwt, Wo, Wwt, Ss, Ss, Gg, Re, Gg, Gg, Gg, Gg, Gg, Re, Gg, Re, Gg, Gg^Vh, Gs^Fp, Mm, Hh, Re, Re, Re, Ch, 2 Kh, Ch, Gg, Hh, Hh, Hh
Gs^Fp, Gs^Fms, Gg, 4 Kh, Ch, Wwt, Wwt, Wo, Wwt, Wwt, Ss, Gg, Re, Re, Gs^Fms, Gs^Fp, Hh^Uf, Hh, Gs^Fp, Hh, Hh, Gg, Mm, Hh, Gg, Gs^Fms, Gg, Gg, Gg, Ch, Wwt, Ch, Rr, Gg, Gs^Fms, Mm, Mm
Gg^Uf, Gg, Gg, Ch, Rr, Ch, Hh, Wwt, Gg, Wwt, Wwt, Ss^Vhs, Re, Gg, Hh, Hh, Mm, Mm, Gs^Fms, Hh^Uf, Gs^Fp, Gg, Gg, Gs^Fp, Gg, Gg, Gs^Fms, Gg, Wwt, Wwt, Wwt, Wwt, Gs^Fp, Rr, Rr, Gs^Fp, Gs^Fp
Gs^Fp, Gs^Fp, Rr, Rr, Gg, Re, Re, Gg, Re, Gg, Re, Ww^Bw/, Gg, Gs^Fp, Gs^Fp, Mm, Gg, Gs^Fp, Gg, Gg, Gg, Gg, Gg, Gg, Gg, Hh, Hh^Uf, Gg, Wwt, Wo, Wwt, Gg, Hh, Mm, Rr, Gg, Gg^Uf
Hh, Hh, Rr, Gs^Fp, Wwt, Gg, Gs^Fp, Re, Gg^Vh, Re, Gg, Wwt, Wwt, Wwt, Wwt, Wwt, Wwt, Hh, Gg, Gg, Gg, Gg, Hh^Vhh, Gg, Gg, Mm, Mm, Gg, Wwt, Wo, Wwt, Gs^Fms, Gg^Vh, Gg, Rr, Gg, Gs
Hh, Hh, Rr, Gg, Gs^Fms, Wwt, Wwt, Hh, Gs^Fp, Gs^Fp, Mm, Gg, Gg, Mm, Gs^Fp, Gs^Fp, Gg, Wwf, Wwf, Gg, Gs^Fp, Hh, Gs^Fms, Gg, Gs^Fp, Gg, Hh, Gg, Wwt, Wwt, Hh, Gs^Fp, Rr, Rr, Gg, Gs^Fms, Gs^Fp
Gg, Gg, Gg^Vh, Rr, Gs^Fp, Wwt, Hh^Uf, Hh, Gg, Mm, Mm, Mm, Gs, Gg, Rb, Gg^Uf, Rb, Gg, Wwf, Gg, Gg^Uf, Mm, Hh, Gg, Hh, Gg, Gg, Gg, Wwt, Wwt, Gs^Fms, Gg, Rr, Gg, Gs^Fp, Gg, Gg
Gg^Uf, Gg, Rr, Rr, Gs, Hh, Rb, Gs^Fp, Rb, Gg^Uf, Rb, Rb, Rb, Rb, Hh, Rb, Hh, Gg, Wwr, Gs^Fp, Mm, Gs^Fp, Rb, Gg, Gg^Ve, Gs^Fms, Rb, Gs^Fp, Ss, Wwt, Mm, Gg, Rr, Gg, Mm, Hh, Hh
Gs^Fp, Gs^Fp, Rr, Hh, Gll, Gs, Gs, Rb, Gg, Rb, Gs^Fp, Gs^Fp, Gg^Vh, Gg, Gs^Fp, Gs^Fp, Wwt, Wwt, Ss^Vhs, Gg, Rb, Rb, Gg, Rb, Rb, Rb, Hh, Rb, Ww^Bw\, Ss, Hh, Rr, Gs^Fp, Gg, Hh, Hh, Hh
Gs^Fp, Gs^Fp, Rr, Hh, Gs, Gd, Gs^Fp, Hh^Vhh, Gs, Gg, Wwt, Hh, Wwt, Wwt, Wwt, Wwt, Wwt, Ss, Ss, Rb, Gg, Gs^Fp, Gs^Fp, Hh, Gg, Gg, Gs^Fp, Ss, Ss, Rb, Gs, Rr, Rr, Gg, Gg^Vh, Gg, Gg
Hh, Hh, Ch, Rr, Ch, Gs^Fms, Mm, Hh, Wwt, Wwt, Wwt, Wwt, Wwt, Wwt, Wwt, Wwt, Hh, Wwt, Ww^Bw/, Rb, Hh, Gg, Wwt, Hh, Wwt, Wwt, Wwt, Wwt, Wwt, Gs^Fp, Mm, Hh, Ch, Rr, Ch, Gs^Fp, Gs^Fp
Gs^Fp, Gs^Fms, Gg^Vh, Rr, Rr, Hh, Gs, Gs^Fp, Ss, Wwt, Gs^Fp, Wwt, Gg, Hh, Gs^Fp, Gg, Gg, Rb, Ss, Wwt, Wwt, Wwt, Wwt, Wwt, Wwt, Wwt, Wwt, Wwt, Gg, Hh, Gs^Fms, Gs^Fp, Gg, Rr, Rr, Hh, Hh
Gg^Uf, Gg, Hh, Gg, Gs^Fp, Rr, Hh, Rb, Ww^Bw\, Ss, Hh, Gg, Rb, Hh, Gg, Gs^Fp, Rb, Rb, Ss^Vhs, Ss, Wwt, Wwt, Gs^Fp, Wwt, Gg^Vh, Hh, Gs^Fp, Gg, Gg, Hh^Vhh, Gg, Gg, Gg, Hh, Rr, Gs^Fms, Gs^Fms
Ss, Hh, Mm, Gg, Rr, Rr, Mm, Ss, Ss, Rb, Rb, Rb, Gg^Ve, Rb, Rb, Rb, Mm, Gg, Wwr, Wwt, Hh, Gs^Fms, Hh, Gg, Rb, Gs^Fms, Rb, Rb, Rb, Rb, Rb, Gs, Gll, Hh, Rr, Gs^Fp, Gs^Fp
Hh, Hh, Gs^Fms, Gg, Rr, Gg, Gs^Fp, Wwt, Wwt, Gs^Fp, Gg, Gs^Fp, Hh, Gg, Hh, Gs^Fp, Gg^Uf, Gs^Fp, Wwf, Gg, Rb, Rb, Rb, Rb, Gg, Rb, Mm, Gg^Uf, Gg, Gs^Fp, Hh^Uf, Hh, Gs^Fp, Rr, Gg^Vh, Gg, Gg
Gs, Gg, Gg, Gg, Rr, Gg, Hh, Wwt, Wwt, Gg, Hh, Gg, Gs^Fms, Gg, Gs^Fp, Mm, Gs^Fp, Gg, Wwf, Gg, Gg, Gg^Uf, Gs^Fp, Gg, Gg, Mm, Mm, Mm, Gs^Fp, Hh, Wwt, Wwt, Gs^Fms, Rr, Rr, Gg, Gs
Gs^Fp, Gs^Fp, Rr, Rr, Gg^Vh, Gs^Fms, Wwt, Wwt, Wwt, Gg, Mm, Gg, Gg, Gg, Hh^Vhh, Hh, Gg, Gg, Gg, Wwf, Wwt, Gs^Fp, Wwt, Mm, Wwt, Gg, Gg, Gs^Fp, Gg^Vh, Hh, Gs^Fp, Wwt, Wwt, Gg, Rr, Hh, Hh
Gg, Gg, Rr, Gg, Hh, Gs^Fp, Wwt, Wo, Wwt, Gg, Hh^Uf, Mm, Gg, Gg, Gg, Gg, Gg, Gg, Gg, Hh, Gg, Wwt, Gs^Fp, Wwt, Gg, Wwt, Re, Re, Re, Re, Re, Gg, Gg, Gs^Fms, Rr, Hh, Hh
Gg^Uf, Gg, Rr, Mm, Gs^Fms, Gg, Wwt, Wo, Wwt, Gg, Gs^Fp, Hh, Gg, Gg, Gg, Gg, Gs^Fp, Gg, Gs^Fp, Gs^Fp, Mm, Mm, Hh, Gs^Fp, Re, Ww^Bw/, Wwt, Gg, Gg, Gg, Hh, Re, Rr, Rr, Gg, Gs^Fp, Gs^Fp
Gs^Fp, Gs^Fp, Gs^Fms, Rr, Rr, Wwt, Wwt, Wwt, Gg, Gg, Gg, Gg, Gg, Gs^Fp, Mm, Gg, Hh, Hh^Uf, Gs^Fms, Mm, Hh^Uf, Hh, Gs^Fp, Gg, Re, Ss^Vhs, Ss, Wwt, Wwt, Wwt, Wwt, Ch, Ch, Ch, Gg, Gg, Gg^Uf
Mm, Mm, Hh, Gg, Ch, Ch, Ch, Ch, Re, Gg, Hh, Gs^Fms, Gs^Fp, Hh, Gg, Gg, Gg, Hh, Gg, Hh, Gg, Gs^Fms, Gg, Re, Gg, Gg, Ss, Wwt, Wo, Wo, Wwt, Wwt, Ch, 3 Kh, Gs^Fp, Gs^Fp, Gs^Fp
Hh, Hh, Gg, Gg, Re, 1 Kh, Re, Re, Gg, Re, Re, Mm, Re, Gg^Vh, Re, Re, Re, Re, Re, Gg, Re, Gg, Re, Re, Gg, Ss, Gg, Wwt, Wwt, Wwt, Gg, Gs^Fms, Gg, Gg, Mm, Hh, Hh
Gg, Gg, Gs^Fp, Re, Gg, Re, Gs^Fp, Hh, Ss, Gg, Gs^Fp, Re, Gg, Re, Gg, Gg, Hh, Gg, Gs^Fp, Re, Gg^Ve, Re, Gg, Gg, Gg, Gg, Gs^Fp, Gg, Wwf, Gg, Hh, Gg, Gs^Fp, Mm, Mm, Mm^Xm, Mm^Xm
Gs, Gg, Hh^Vhh, Re, Hh, Gs^Fp, Hh, Ss, Hh, Gs^Fp, Hh, Gg, Hh, Gg, Gg, Gg, Hh, Gg^Uf, Hh, Gg, Gg, Gg, Gs^Fms, Hh, Gg^Uf, Hh, Hh, Gg, Wwf, Gg, Gs^Fp, Gg^Vh, Hh, Hh, Mm^Xm, Mm^Xm, Mm^Xm
Gs, Gg^Uf, Hh, Re, Hh, Gg^Uf, Hh^Fms, Ss, Hh^Fms, Gs^Fp, Hh, Gg^Uf, Ss, Gs, Gs, Hh^Fms, Hh, Mm, Hh, Gs, Gs, Gg, Gs^Fp, Ss, Hh, Hh, Ss, Gg^Uf, Wwf, Gg, Gs^Fp, Gg^Uf, Hh, Mm, Mm^Xm, Mm^Xm, Mm^Xm
