Gs^Fdf, Mm, Hh^Fdw, Wwf, Gs^Fmf, Hh, Hh, Gs^Fdw, Gs^Fdw, Hh, Mm, Mm, Gs^Fmf, Gs^Ft, Mm, Mm, Gs^Fdf, Gg^Efm, Gg^Fdw, Gs^Fmf, Hh, Hh, Mm, Hh, Gs^Fmf, Hh, Hh, Mm, Gs^Fds, Gg, Gg^Fdw, Gg^Fdw, Gs^Fmf, Hh, Hh, Wwf, Gg^Efm, Gg^Uf, Gs^Fdf, Hh, Mm, Mm
Mm, Gs^Fdf, Hh, Wwf, Gs^Fmf, Hh, Hh, Gg, Gg, Hh, Gs^Fmf, Hh, Gs^Fmw, Hh, Hh^Fdf, Mm, Gs^Fmf, Gg^Efm, Gg^Efm, Gs^Fdf, Rp^Vhc, Hh, Hh, Hh, Gs^Fdw, Hh, Hh, Mm, Gs^Fdf, Gg^Efm, Gg, Gs^Fmf, Gs^Fdw, Hh, Hh, Wwf, Gg, Gg^Efm, Gs^Fmf, Hh, Mm, Mm
Hh, Hh, Gs^Fmf, Wwf, Ch, Ch, Ch, Gg, Gg, Rp^Vhc, Re, Hh, Gg, Rp, Rp, Gs^Fmf, Rp, Rp, Rp, Rp, Rp, Rp, Rp, Rp, Rp, Rp^Vhc, Rp, Gs^Fmf, Re^Uf, Gg^Efm, Gg^Efm, Gg, Gg, Gg, Wwf, Wwf, Ch, Hh, Hh, Ww, Hh^Uf, Hh
Gs^Fdw, Gg, Gg, Wwf, Ch, 2 Kh, Ch, Gg, Rp, Rp, Re, Re, Re, Re, Re^Gvs, Rp, Rp, Re^Gvs, Hh, Gs, Gs, Gs, Gs^Fmw, Gs, Gs, Rp, Gg, Gg, Gg, Gg, Gg^Efm, Gg, Wwf, Wwf, Gg, Ch, 5 Kh, Ch, Gs^Fdw, Hh, Mm, Mm
Gs^Fdw, Gg^Vc, Gg^Efm, Wwf, Wwf, Ch, Rp, Rp, Hh^Uf, Mm, Mm, Gs^Fdw, Re, Re^Gvs, Gg^Vc, Re^Gvs, Re^Gvs, Re^Gvs, Gs, Gs, Ww, Wwf, Wo, Ww, Ww, Gs, Hh, Gg, Gg^Efm, Gg^Efm, Gg, Wwf, Gg^Efm, Rp^Vhc, Rp, Ch, Ch, Ch, Gs^Fmw, Gs^Fmf, Hh, Hh
Rd, Gg, Gs^Fmw, Hh, Wwf, Gg, Rp, Hh, Mm, Gs^Fmf, Hh, Mm, Re, Re^Gvs, Gs^Fmw, Hh, Wwf, Wwf, Wwf, Wwf, Wwf, Ww^Vm, Wwr, Ww, Ds, Ss, Ss^Vhs, Gs, Gg^Efm, Gg^Efm, Hh, Wwf, Gg, Rp, Gs^Fmw, Rp, Rp, Gg, Gg, Gs^Fdw, Hh, Hh
Wwf, Rd^Uf, Gs^Fmf, Mm, Wwf, Gg, Rp, Gs^Fmw, Gs^Fdw, Ww, Ww, Gs^Fmw, Re, Re^Gvs, Re^Gvs, Wwf, Gs, Gs, Hh, Mm, Gs, Wwf, Wwf, Wwf, Gs, Gs^Fmw, Gs, Gs, Gg, Gs^Fmw, Gs^Fmf, Wwf, Gg^Efm, Rp, Mm, Mm^Uf, Hh, Rp, Gg, Hh^Vc, Hh, Hh
Mm, Wwf, Wwf, Wwf, Gg, Rp^Vhc, Rp, Hh, Re^Gvs, Gs^Fmw, Mm, Gs^Fdf, Gs^Fmf, Re, Wwf, Wwf, Gs, Gg^Uf, Gs^Fmw, Hh, Gs^Fmf, Gs, Gs, Gs, Gs, Gs, Gs, Gg^Efm, Hh, Gg^Efm, Wwf, Wwf, Gg, Rp, Hh, Gs^Fmw, Rp^Vhc, Rp, Gg, Gg, Gs^Fdw, Gs^Fdw
Gs^Ft, Hh, Gs^Fmf, Wwf, Wwf, Gg, Gg, Rp, Rp^Vhc, Re^Gvs, Re^Gvs, Hh^Uf, Mm, Hh, Wwf, Gs, Mm, Gg^Efm, Gg, Gg^Vc, Gg^Efm, Gg, Gg, Gg^Efm, Gg^Vc, Gg^Fet, Gs, Gs, Gs^Fmf, Mm, Wwf, Rp, Rp, Rp, Gs^Fmf, Gg, Rp, Rp, Rp^Vhc, Gg, Gs^Fmw, Gs^Fmf
Re^Gvs, Gg^Efm, Gg, Gg^Efm, Ch, Wwf, Wwf, Wwf, Wwf, Wwf, Wwf, Re^Gvs, Ss, Ss, Wwf, Mm, Mm, Mm, Gs, Gg, Gg, Gs^Uf, Wwf, Gg, Gs^Fmw, Gg^Efm, Gg^Efm, Gs, Wwf, Wwf, Gg^Efm, Gg, Hh, Gs^Fdf, Mm, Gg, Rp, Gg, Ww, Ww, Ww, Ww
Re^Gvs, Gg^Vc, Gg, Ch, 6 Kh, Ch, Gg^Efm, Rp, Gg, Gg, Gg, Ww, Gg, Ss, Gg^Vc, Wwf, Gs, Gs, Mm, Hh, Hh^Fmf, Gg, Ww, Gs^Fmf, Mm, Hh^Uf, Hh, Gs, Wwf, Gg^Efm, Gs^Fmw, Hh^Uf, Mm, Mm, Hh, Gg, Ch, Ch, Ch, Ww, Hh, Hh
Gg^Uf, Re^Gvs, Hh, Ch, Ch, Ch, Rp, Rp, Rp, Rp, Rp, Gg, Rp, Re^Gvs, Re^Gvs, Wwf, Wwf, Hh^Fmf, Gs^Fmw, Hh, Gg, Wwf, Gg, Ww, Hh, Mm, Gg, Gs, Wwf, Gg^Efm, Rp, Gg, Gg, Gs^Fmw, Hh, Gg, Ch, 1 Kh, Ch, Wwf, Hh, Hh
Hh, Hh, Mm, Gs^Fdw, Gs^Fmw, Rp, Re^Gvs, Re^Gvs, Rp^Vhc, Re^Gvs, Gs^Fmf, Rp, Gg^Efm, Rp, Rp, Re^Gvs, Wwf, Gs, Gg^Efm, Gg, Mm, Hh^Fmf, Hh, Wwf, Gg, Gg, Gg^Vc, Gs, Wwf, Rp, Gg, Rp, Rp, Rp, Rp, Gg, Rp, Ch, Wwf, Wwf, Gg, Gg^Uf
Mm, Mm, Mm, Mm, Hh, Rp, Re^Gvs, Gs^Fmf, Hh^Uf, Gs^Fdw, Mm, Mm, Mm, Gs^Fmw, Ss^Vhs, Rp, Wwf, Gs, Gg^Efm, Gs^Uf, Gs^Fmf, Gg^Efm, Gg, Gg, Gs^Fmw, Gg^Efm, Gg^Efm, Gs, Gs, Wwf, Gg^Efm, Gg, Hh, Rp^Vhc, Gs^Fmf, Rp, Gg^Uf, Wwf, Gg, Gs^Fmf, Hh^Vc, Hh
Hh, Hh, Re^Gvs, Re^Uf, Gs^Fdw, Rp, Gg, Hh, Hh, Gs^Fmw, Gg, Mm, Gg, Hh, Ss, Ss, Gs^Fmf, Gs, Gg, Gg^Efm, Gg, Gg, Gs, Gs, Gs^Fmf, Gs, Gs, Gg^Efm, Gs, Wwf, Gg^Uf, Gg, Wwf, Gg, Wwf, Rp, Wwf, Wwf, Wwf, Hh, Hh, Hh
Re^Uf, Re^Gvs, Hh, Re^Gvs, Gg, Rp, Rp, Hh^Vc, Gg, Gg, Wwf, Gg, Wwf, Gg, Ww, Ss, Mm, Gs, Rp, Rp, Rp, Gs, Wo, Hh, Ww, Ww, Ss, Gs, Gs^Fmw, Wwf, Ss, Ss, Hh, Wwf, Gg, Wwf, Gg^Efm, Gg^Efm, Re^Gvs, Wwf, Hh, Hh
Re^Uf, Re^Uf, Gs^Fmf, Gs^Fmw, Hh, Hh, Rp, Gg, Gg, Wwf, Gg^Efm, Wwf, Gg^Efm, Wwf, Hh, Hh, Gs^Fmw, Gs, Rp, Rp^Vhc, Wwf, Wwf, Ww^Vm, Wwr, Ww, Ww, Ww, Ss^Vhs, Ss, Ss, Ss, Gs^Fmw, Gs^Fmf, Hh, Gg, Rp, Re^Gvs, Gg^Vc, Wwf, Wwf, Gg^Vc, Gg
Re^Gvs, Re^Gvs, Re^Gvs, Gg^Efm, Ch, Ch, Ch, Rp, Rp, Wwf, Gg, Hh^Uf, Gs^Fmf, Gg, Gg^Efm, Gs^Fmf, Gg^Efm, Gg^Efm, Gg^Efm, Rp, Mm, Wwf, Wwf, Wwf, Gg, Ds, Gg, Ss, Gg, Gg, Gg, Wwf, Gg, Gg, Rp, Rp, Ch, Re^Gvs, Wwf, Gg, Gs^Fmw, Gs^Fdf
Re^Uf, Gg^Vc, Gs^Fdw, Re^Gvs, Ch, 3 Kh, Ch, Gg^Efm, Wwf, Wwf, Rp, Rp, Rp, Gg, Rp, Gg^Efm, Rp, Gg, Gg, Rp, Rp, Hh, Hh, Hh, Gs^Fmw, Gg, Rp, Gg, Rp, Rp, Wwf, Wwf, Rp^Vhc, Gg, Rp, Ch, 4 Kh, Ch, Wwf, Gg^Uf, Hh, Hh
Hh, Hh, Gs^Fmf, Re^Gvs, Re^Gvs, Ch, Wwf, Gg^Efm, Wwf, Rp^Vhc, Rp, Gg, Gg, Rp, Gg^Efm, Rp, Rp^Vhc, Rp, Cv, Gg^Efm, Rp, Rp, Rp, Rp, Rp, Rp, Gs^Fmf, Rp, Hh, Mm, Wwf, Rp, Gg^Efm, Rp, Gg^Uf, Ch, Ch, Ch, Gs^Fmf, Wwf, Mm, Mm
Mm, Gs^Fdw, Mm, Hh, Mm, Wwf, Hh, Wwf, Hh, Rp, Gs^Fdw, Gg^Efm, Hh, Hh, Hh, Gs^Fmw, Hh, Rp, Rp, Rp, Gs^Uf, Gs^Fdw, Gs^Fdw, Hh^Vc, Hh, Hh, Mm, Mm, Hh, Gs^Fmw, Wwf, Gg^Efm, Hh, Gs^Fmf, Hh, Hh, Hh, Gs^Fmw, Hh, Mm, Mm^Xm, Mm^Xm
Mm, Mm, Mm, Hh, Mm, Wwf, Gs^Fdw, Wwf, Mm, Re^Uf, Gs^Fdf, Gg^Efm, Hh, Mm, Hh, Gs^Fmf, Hh, Re^Uf, Re^Uf, Re, Gs^Fmw, Gs^Fmf, Gs^Fmw, Gg, Hh, Hh, Mm, Gs^Fdw, Hh, Gs^Fdw, Wwf, Gg^Uf, Hh, Gs^Fdf, Hh, Hh, Hh, Gs^Fdf, Hh, Mm, Mm^Xm, Mm^Xm
