Gg^Fet, Gg^Fet, Mm, Hh, Gg^Fet, Gg^Fet, Gg, Hh, Hhd^Fp, Hhd, Dd^Gvs, Hd, Dd, Dd, Dd, Hd, Dd, Hd, Md, Hhd, Mm, Mm, Mm, Hh, Hh, Re, Gd, Gs, Wwf, Wwf, Gg, Hh, Hh, Gs^Fp, Gd, Gs^Fp, Gs^Fp, Gs^Fp, Hhd^Emf, Hhd^Emf, Mm, Mm
Gg^Fet, Gg^Fet, Hh, Hh, Gg^Fet, Gg^Fet, Gg, Hh, Mm, Mm, Gd^Ftd, Hd, Dd^Do, Hd, Md, Hd, Dd, Hd, Dd^Do, Dd^Edpp, Mm, Mm, Mm, Hh, Hh, Re, Gs, Gg, Wwf, Wwf, Gg, Gs^Fp, Gs, Gs, Gs, Hhd, Gs^Fp, Mm, Hhd, Hhd^Emf, Mm^Vhh, Mm
Re, Re, Re, Re, Re, Re, Re, Gg, Hh, Mm, Gd^Gvs, Dd, Dd, Dd, Dd, Dd, Dd^Edpp, Dd, Dd, Hhd, Ww, Mm, Gs^Fp, Gs^Fp, Re, Re, Ds, Ds, Wwt, Wwf, Hh, Gg, Wwt, Ds, Gg, Gd, Gd, Gd, Gd^Fdw, Rb^Fdw, Rb, Rb
Gg^Efm, Gg^Ve, Gs, Gs, 2 Kv, Cv, Cv, Re, Gs^Fet, Hhd, Gs, Gd^Gvs, Rd, Rd, Rd, Rd, Rd, Rd, Rd, Gd, Gs, Gs, Re, Re, Gs^Fp, Gg^Ve, Hh, Wwt, Wo, Wwt, Wwt, Wwt, Wwt, Wwt, Wwt, Gs, Ce, Ce, Ce, Rb, Hhd, Hhd
Wwt, Gg^Efm, Wwt, Cv, Cv, Cv, Re, Re, Re, Gg^Ve, Gd, Rd, Hd, Dd, Hd, Dd^Vda, Rd, Md, Gd, Gll, Re, Re, Gs, Hh, 3 Kh, Gs^Fp, Wwt, Wwt, Wo, Wwr, Wo, Wo, Wo, Ww^Vm, Wwt, Ds, Ce, 6 Ke, Ce, Rb, Rb^Fdw, Rb^Fdw
Gg^Fet, Wwt, Wwt, Cv, Re, Re, Gg^Efm, Gg, Gs^Fet, Re, Gs, Gd, Md, Dd, Dd, Dd, Rd, Hd, Dd, Gs, Re, Gs, Hh, Ch, Ch, Ch, Wwt, Wwt, Ww^Vm, Wo, Wo, Wo, Wo, Wwt, Wwt, Ds, Rd, Ce, Re, Rb, Rb, Ss
Gg^Fet, Wwt, Ss, Gg^Efm, Re, Gs, Gs^Fet, Hh, Mm, Re, Gs, Gs, Dd, Dd^Edpp, Hd, Rd, Dd^Edp, Dd, Dd, Gd, Re, Gs^Fp, Gs^Fp, Ch, Ch, Ch, Wwf, Wwt, Wwt, Wwt, Wo, Wo, Wwt, Wwt, Gg, Gs, Gs^Vc, Re, Gd, Gd^Fdw, Gd^Fdw, Rb^Fdw
Wwt, Wwt, Ss, Gs, Gs^Efm, Re, Hh, Mm, Mm, Mm, Gs, Gd, Dd, Dd^Edp, Dd, Rd, Dd^Vda, Dd^Edpp, Dd, Gd, Hhd, Re, Re, Wwf, Wwf, Rr, Rr, Gg, Gg^Efm, Wwt, Wwt, Wwt, Gg^Efm, Gg^Efm, Gs^Fms, Gs, Re, Re, Gs^Fp, Gll, Gd, Ss
Wwt, Wwt, Wwt, Ss, Ss^Vhs, Re, Re, Gs^Ft, Wwt, Mm, Gs, Gll, Gd, Hd, Dd, Rd, Hd, Hd, Dd, Hhd, Gs^Fdw, Gs^Vh, Re, Wwf, Gs^Fp, Gs, Gd, Rp, Rr, Gg^Efm, Wwt, Wwt, Gg^Efm, Hh, Hh, Re, Gs, Hh, Mm, Gll, Gs, Ss
Wwr, Wwr, Wwr, Wwt, Wwt, Gd^Ft, Re, Gg, Hh, Hh, Gd, Gll, Hhd, Rd, Rd, Rd, Gd, Hd, Mm, Mm, Gs^Fp, Re, Wwf, Wwf, Mm, Mm, Mm, Gs, Rr^Vhc, Rr, Ww^Bsb\, Wwt, Gg, Mm, Gs^Fms, Re, Hh, Mm, Gs^Fp, Gd, Gs^Vc, Gd
Wo, Wo, Wo, Wwt, Wwt, Gs, Re, Gs, Mm, Gg^Fet, Gd, Gs, Hhd^Vc, Gs^Fds, Gll, Hhd, Gll, Mm, Gs, Hh, Gs, Re, Wwf, Gs^Fds, Hh, Mm, Gs^Fds, Gg, Wwt, Wwt, Wwt, Rr, Rr, Hh, Rp, Gd, Gll, Gs, Gd, Gll, Gll^Fp, Gll^Fp
Wo, Wo, Wwt, Wwt, Gg^Efm, Gg, Re, Gs, Gll, Gs^Fp, Gs, Gd, Gd, Gs, Gd, Gd, Gs, Gd, Gs^Fds, Gd, Re, Re, Re, Gg, Gg, Gs^Fds, Wwr, Wwt, Ww, Wo, Wwt, Gg, Gs, Rp, Gs^Fms, Gs, Hh, Gll, Gll, Hh, Mm, Mm
Wwt, Wwt, Ds, Wwt, Re, Re, Gg^Ve, Gs, Gs, Gll, Mm, Gd, Gs, Gs, Gs^Fds, Hh, Gs, Gs^Vc, Hh, Mm, Wwf, Gll, Gs^Fds, Re, Gd, Wwt, Ww, Ww, Gg^Efm, Ww, Ww, Ss, Ss, Gg^Vc, Hh, Mm, Gs, Gd, Gll, Hh, Mm, Mm
Ds, Ds, Re, Ww^Bsb/, Wwt, Gg, Gs^Fms, Hh, Gs^Fms, Gd, Hh, Gs^Fms, Gs, Gs, Gs^Fds, Mm, Gg, Gg, Ds, Ww, Wwr, Wwf, Hh, Gg^Vh, Wwt, Ww^Bsb\, Re, Gg^Efm, Gs, Ss, Ss, Ww, Ww, Gs, Gg, Gs^Fms, Rp, Gs, Gll, Gs^Fp, Hh, Hh
Gg^Efm, Gg^Efm, Re, Gg^Efm, Wwt, Gg^Fet, Hh, Mm, Hh^Emf, Gs^Fms, Gs, Gs^Vc, Gll, Gg, Hh, Hh, Gg, Gg, Wwf, Ww, Ww^Vm, Gs^Fds, Mm, Gg^Efm, Wwt, Ww, Gg^Efm, Re, Re, Ss^Vhs, Hh, Gg^Efm, Gg^Efm, Wwf, Wwf, Rr, Gg, Gs, Gg^Vct, Re, Gs^Fp, Gs^Fp
Gg, Gg, Re, Gg^Efm, Gs^Fds, Wwt, Wwt, Ds, Gg, Gs, Gd, Gll, Gd, Re, Mm, Ds, Wwf, Wwf, Wwf, Ww, Wo, Wwt, Wwt, Gg^Efm, Wwf, Ww, Ds, Hh^Emf, Re, Gs^Fds, Gs^Fds, Gg, Rp, Rr, Wwf, Gg^Efm, Mm, Gs^Fds, Hh, Re, Gg, Gg
Gg, Gs, Re, Hh, Gs^Fds, Mm, Gg^Efm, Wwf, Rr, Rp, Gg, Gs^Fds, Gs^Fds, Re, Hh^Emf, Ds, Ww, Wwf, Gg^Efm, Wwt, Wwt, Wo, Ww, Wwf, Wwf, Wwf, Ds, Mm, Re, Gg, Gd, Gll, Gg, Gg, Ds, Wwt, Wwt, Gs^Fds, Gg, Re, Gg, Gg
Gll^Fp, Gll^Fp, Re, Gg^Vc, Gg, Gg, Rr, Wwf, Wwf, Gg^Efm, Gg^Efm, Hh, Ss^Vhs, Re, Re, Gg^Efm, Ww, Wwt, Gg^Efm, Mm, Gs^Fds, Ww^Vm, Ww, Wwf, Gg, Gg, Gg, Gg, Gg, Gll, Gs^Vc, Gg, Gs^Fms, Hh^Emf, Mm, Hh, Gg^Fet, Wwt, Gg^Efm, Re, Gg^Efm, Gg
Hh, Hh, Gs^Fp, Gd, Rp, Rp, Gs^Fms, Gg, Gs, Ww, Ww, Ss, Ss, Gs, Gg^Efm, Re, Ww^Bsb\, Wwt, Gg^Vh, Hh, Wwf, Wwr, Ww, Ds, Gg, Gg, Mm, Gs^Fds, Gg^Efm, Gll, Gs^Fp, Hh, Gs, Gs^Fms, Hh, Gs^Fms, Gg^Efm, Wwt, Ww^Bsb/, Re, Ds, Ds
Mm, Mm, Hh, Gs, Gd, Gs, Mm, Hh, Gs^Vc, Ss, Ss, Ww, Ww, Gg^Efm, Ww, Ww, Wwt, Re, Re, Gs^Fds, Gll, Wwf, Mm, Hh, Gs^Vc, Gs, Hh, Gs^Fds, Gg, Gs, Gg, Mm, Gll, Gd, Gs, Gg^Ve, Re, Re, Wwt, Ds, Wwt, Wwt
Mm, Mm, Hh, Gg, Gll, Hh, Gs, Gs^Fms, Rp, Gs, Gg, Wwt, Wo, Ww, Wwt, Wwr, Gs^Fds, Gg, Gg, Re, Re, Re, Gs, Gs^Fds, Gs, Gd, Gd, Gg, Gll, Gd, Gd, Gs, Gs^Fds, Gll, Gg, Re, Gg, Gg^Efm, Wwt, Wwt, Wo, Wo
Gll^Fp, Gll^Fp, Gs, Gd, Gs, Gll, Gd, Rp, Hh, Rp, Rr, Wwt, Wwt, Wwt, Gg, Gs^Fds, Mm, Hh, Gs^Fp, Wwf, Re, Gs, Hh, Gd, Mm, Gs, Hhd, Gll, Gs^Fds, Hhd^Vc, Gs, Gg, Gg^Fet, Mm, Gg, Re, Gs, Wwt, Wwt, Wo, Wo, Wo
Gd, Gs^Vc, Gd, Gs^Fms, Mm, Hh, Re, Gs^Fms, Gg, Gg, Wwt, Ww^Bsb\, Rr, Rr^Vhc, Gs, Mm, Mm, Mm, Hh, Wwf, Re, Gs^Fp, Mm, Mm, Hd, Gd, Rd, Rd, Rd, Hhd, Gll, Gs, Hh, Hh, Gs, Re, Gs^Ft, Wwt, Wwt, Wwr, Wwr, Wwr
Ss, Gs, Mm, Mm, Hh, Gs, Re, Hh, Gg^Efm, Wwt, Wwt, Wwt, Gg, Rr, Rp, Gd, Gs, Gs^Fp, Wwf, Wwf, Gs^Vh, Gs^Fdw, Hhd, Dd, Hd, Hd, Rd, Dd, Hd, Gd, Gs, Re, Mm, Wwt, Gs^Ft, Re, Re, Ss^Vhs, Ss, Wwt, Wwt, Wwt
Ss, Gd, Gll, Gs^Fms, Re, Re, Gs, Gs^Fms, Gg^Efm, Wwt, Wwt, Gg^Efm, Gg^Efm, Gg, Gg, Rr, Rr, Wwf, Wwf, Re, Re, Hhd, Gd, Dd, Dd^Edp, Dd^Vda, Rd, Dd, Dd, Dd, Gs, Re, Mm, Mm, Mm, Hh, Re, Gs, Gg^Efm, Ss, Wwt, Wwt
Gd^Fdw, Gd^Fdw, Gd^Fdw, Gd, Re, Gs^Vc, Gs, Gg^Efm, Wwt, Wwt, Wo, Wwt, Wwt, Wwt, Wwt, Wwf, Ch, Ch, Ch, Gs^Fp, Gs^Fp, Re, Gd, Dd, Dd, Dd^Edpp, Rd, Hd, Dd^Edp, Dd, Gd, Re, Re, Mm, Hh, Gg^Fet, Gg, Re, Gg^Efm, Ss, Wwt, Gg^Fet
Ss, Rb, Rb, Re, Ce, Rd, Ds, Wwt, Wwt, Wo, Wo, Wo, Wo, Ww^Vm, Wwt, Wwt, Ch, Ch, Ch, Hh, Gs, Re, Gs, Dd, Hd, Rd, Dd, Dd, Dd^Edpp, Md, Gd, Gs, Re, Gs^Fet, Gs, Gg^Efm, Re, Re, Cv, Wwt, Wwt, Gg^Fet
Rb^Fdw, Rb^Fdw, Rb, Ce, 5 Ke, Ce, Ds, Wwt, Ww^Vm, Wo, Wo, Wo, Wwr, Wo, Wwt, Wwt, Gs^Fp, 4 Kh, Hh, Gs, Re, Re, Gll, Gd, Md, Rd, Dd^Vda, Hd, Dd, Hd, Rd, Gd, Gg^Ve, Re, Re, Re, Cv, Cv, Cv, Wwt, Gg^Efm, Wwt
Hhd, Hhd, Rb, Ce, Ce, Ce, Gs, Wwt, Wwt, Wwt, Wwt, Wwt, Wwt, Wo, Wwt, Hh, Gs^Vh, Gs^Fp, Re, Re, Gs, Gd, Gd, Rd, Rd, Rd, Rd, Rd, Rd, Rd, Gd^Gvs, Gs, Hhd, Gs^Fet, Re, Cv, Cv, 1 Kv, Gg^Efm, Gg, Gg^Ve, Gg
Rb, Rb, Rb^Fdw, Gd^Fdw, Gd, Gd, Gs, Gg, Ds, Wwt, Gg, Hh, Wwf, Wwt, Ds, Ds, Re, Re, Gs^Fp, Gs^Fp, Mm, Ww, Hhd, Dd, Dd, Dd^Edpp, Dd, Dd, Dd, Dd, Dd, Gd^Gvs, Hhd, Hhd, Gg^Efm, Re, Re, Re, Re, Re, Re, Re
Mm, Mm^Vhh, Hhd^Emf, Hhd^Emf, Mm, Gs^Fp, Hhd, Gs, Gs, Gg, Gs^Fp, Gg, Wwf, Wwf, Gg, Gs, Re, Hh, Hh, Mm, Mm, Mm, Hhd, Dd^Do, Hd, Dd, Hd, Md, Hd, Dd^Do, Hd, Dd^Gvs, Mm, Mm, Hh, Gg, Gg^Fet, Gg^Fet, Hh, Hh, Gg^Fet, Gg^Fet
Mm, Mm, Hhd, Hhd^Emf, Gs^Fp, Gs^Fp, Hhd, Gd, Gg, Gd, Gs^Fp, Gg, Wwf, Wwf, Gs, Gd, Re, Hh, Hh, Mm, Mm, Mm, Hhd, Gd^Ftd, Hd, Dd^Edpp, Hd, Dd, Hd, Dd^Edp, Hd, Mm, Mm, Mm, Hh, Gg^Efm, Hh, Gg^Fet, Hh, Hh, Gg^Fet, Gg^Fet
