Ai, Ai, Ha, _s, Ms, Ha, Aa, Aa, Aa, Ai, Ai, Ai, Ai, Ai, Aa, Ai, Mm^Xm, _s, Ai, Ai, Ai
Ai, Ww^Vm, Ai, Aa^Fpa, Mm, Ha, Aa^Fpa, Aa, Aa^Fpa, Ai, Ss, Ai, Ai, Aa, Aa, Ai, Mm^Xm, Xu, Xu, Ai, Ai
Ha, Ai, Ai, Mm, Mm, Mm, Re, Re, Aa, Ss^Vhs, Aa^Fpa, Aa^Fpa, Aa, Aa, Aa, Ai, Mm^Xm, Xu, Cud, Xu, Ai
Ha, Mm, Aa^Fpa, Ai, Ai, Aa, Gg, Re, Aa, Ha, Aa^Fpa, Ha, Aa, Aa^Vha, Aa, Aa, Mm^Xm, Xu, Cud, Xu, Ai
Gg, Ha, Aa, Aa^Fpa, Aa, Ai, Ai, Gg, Gg, Ha, Aa, Gg, Aa, Gg, Aa, Aa, Mm^Xm, Xu, Cud, Xu, Ai
Re, Gs^Vht, Re, Aa, Aa^Fpa, Aa, Ss^Vhs, Aa, Ha, Gg, Gg, Gg, Re, Re, Ch, Ch, Mm^Xm, Xu, Cud, Xu, Ai
Aa, Re, Re, Aa, Aa^Fpa, Aa, Ai, Ai, Aa, Aa, Re, Re, Ch, Ch, Re, Ch, Mm^Xm, Xu, Cud, Xu, Ai
Aa, Aa, Ha, Re, Re, Ha, Aa^Fpa, Ai, Gg, Gg, Re, Ch, Aa, Re, Aa, Kh, Mm^Xm, Xu, Cud, Xu, Ai
Aa, Aa, Aa^Vha, Aa, Re, Aa, Gg, Gg, Ai, Aa, Aa, Aa^Vea, Re, Aa, Re, Aa^Vha, Mm^Xm, Xu, Cud, Xu, Ai
Aa, Gg, Aa^Fpa, Ha, Re, Re, Aa, Mm, Ai, Aa, Re, Ch, Ch, Re, Aa, Kh, Mm^Xm, Xu, Cud, Xu, Ai
Aa, Gg, Gg, Gg, Mm, Re, Aa, Aa, Ai, Aa^Fpa, Gg, Re, Re, Ch, Ch, Ch, Mm^Xm, Xu, Cud, Xu, Ai
Aa, Aa, Gg, Aa^Fpa, Ha, Re, Aa^Vea, Aa^Fpa, Mm, Ai, Gg, Aa, Aa^Fpa, Aa, Aa, Ch, Mm^Xm, Xu, Cud, Xu, Ai
Aa, Aa, Aa^Fpa, Gg, Aa, Re, Re, Aa, Aa^Fpa, Ai, Gg, Aa^Fpa, Gg, Aa, Aa, Aa, Mm^Xm, Xu, Cud, Xu, Ai
Aa^Fpa, Aa^Fpa, Ha, Aa, Aa, Aa, Aa, Re, Ss^Bw\, Ai, Gg, Gg, Ha, Gg, Gg, Ha, Mm^Xm, Xu, Cud, Xu, Ai
Aa, Aa, Md, Dd^Do, Dd, Dd, Aa, Aa^Fpa, Ai, Re, Aa, Mm, Ai, Ai, Gg, Ha, Mm^Xm, Xu, Xu, Xu, Ai
Ms, Md, Dd^Dc, Hd, Dd, Dd^Vda, Aa^Fpa, Ha, Ai, Aa, Aa, Mm, Ai, Aa^Vha, Aa^Fpa, Aa^Fpa, Mm^Xm, Xu, Ai, Ai, Ai
Md, Md, Dd, Dd, Dd, Dd, Gg, Aa^Fpa, Ai, Aa, Aa, Ai, Ai, Ai, Aa^Fpa, Aa^Fpa, Mm^Xm, Ai, Ai, Ai, Ai
