Gs^Fds, Gs^Fds, Gs^Fds, Gs^Fds, Gs^Fds, Gg, Gg, Ww, Ww, Gg, Gg, Gg, Gg^Efm, Gg, Gg, Gg, Gll^Fms, Gs^Fds, Gs^Fds, Gs^Fds, Gs^Fds, Gs^Fds
Gs^Fds, Gll^Fds, Gs^Fms, Gs^Fds, Gs^Fds, Gg, Gg, Ww, Ww, Gg^Fet, Gg, Gs, Gg^Efm, Gg, Gg, Gg, Gs^Fds, Gll^Fms, Gll^Fms, Gs^Fms, Gll^Fds, Gs^Fds
Gs^Fms, Gll^Fms, Gll^Fds, Gg^Fet, Gs, Gg, Gg, Gg, Ww, Ww^Ewf, Gs, Gs, Gg, Gg, Gg, Gg, Gg, Gg, Gs^Fds, Gll^Fds, Gs^Fms, Gll^Fms
Gs^Fms, Gll^Fds, Gg, Gs, Gg, Gg, Gg^Efm, Gg, Gg, Ww, Gg^Ve, Gs, Gg, Gg, Gg, Gg^Efm, Gg^Efm, Gg, Gg, Gg, Gs^Fms, Gll^Fds
Gs^Fds, Gll^Fms, Gs, Gs, Gg, Gg, Gg^Efm, Gg, Gg^Efm, Ww, Ww, Gg, Gg, Gg, Gg, Gg, Gg^Efm, Gg, Gg, Gg, Gs^Fds, Gll^Fds
Gs^Fds, Gll^Fds, Gg, Gs^Fds, Gg, Gs, Gg, Gg, Gg, Gg, Re, Ww^Bw/, Gg, Gg, Gg^Efm, Gg, Gg, Gg, Gg, Gg, Gg, Gg
Gs^Fds, Gs^Fds, Gs^Fds, Gg, Gs, Gg, Gg, Gg, Gg, 1 Kh, Ch, Ww, Ww, Gg, Gs, Gg, Gg, Gg, Gg, Gg, Gg, Gg
Gs^Fds, Gs^Fms, Gg, Gg, Gg, Gg, Gg, Gg, Gg, Ch, Re^Es, Gg^Ve, Ww^Bw/, Gg, Gs^Efm, Gg^Efm, Gg, Gg, Gg, Gg, Gg, Gg
Gs^Fds, Gll^Fds, Gg, Gg, Gg, Gg, Gs, Gg, Gg, Gg, Re, Re, Ww, Gg, Gg^Efm, Gs, Gg, Gg^Efm, Gg^Efm, Gg, Gll^Fds, Gs^Fds
Gs^Fds, Gll^Fds, Gll^Fds, Gg, Gs, Gg, Gs, Gg, Re, Re, Gg, Gg, Gg, Ww, Ww, Gg, Gg, Gg, Gg, Gg, Gll^Fds, Gll^Fds
Gs^Fds, Gs^Fms, Gll^Fms, Gs^Fms, Gs^Fds, Gs, Gs, Gs, Re, Gs, Gs, Gg, Gg, Gg, Ww, Gg, Gs, Gs, Gs, Gll^Fds, Gs^Fds, Gs^Fms
Gs^Fms, Gll^Fds, Gll^Fms, Gs^Fms, Gs^Fds, Gg, Gs, Gg, Re, Gs, Gs, Gg, Gg, Gg, Ww, Gs, Gg, Gg, Gs^Fds, Gs^Fms, Gs^Fms, Gs^Fms
Gs^Fds, Gs^Fms, Gs^Fds, Gs^Fds, Gs^Fds, Gg, Gg, Re, Gg, Gs, Gg, Gg, Gg, Gg, Ww, Gg, Gg, Gg, Gs^Fds, Gs^Fds, Gs^Fds, Gs^Fms
