Mm, Mm, Mm, Mm, Mm, Mm, Mm, Mm, Mm, Mm, Mm, Mm, Mm, Mm, Mm, Mm, Mm, Mm, Hh, Mm, Hh, Hh^Fms, Hh^Fms, Hh^Fms, Hh^Fms, Gs^Fms, Gll, Gll^Fms, Gs^Fms, Gll^Fp, Gs^Fp, Gll, Hh, Mm, Mm, Mm, Mm, Mm, Hh, Mm, Hh, Hh, Gg, Ww, Gg, Gg, Hh, Hh, Hh, Mm, Mm, Mm, Mm, Mm, Mm, Mm, Mm, Mm, Mm, Mm, Mm, Mm
Mm, Mm, Mm^Vhh, Mm, Mm, Mm, Mm, Mm, Mm, Mm, Mm, Mm, Mm, Mm, Mm, Mm, Mm, Mm, Hh, Mm, Hh, Hh^Fms, Hh, Hh^Fms, Gll^Fms, Gs^Fms, Gll, Gll^Fms, Gll^Fms, Gll^Fp, Gll^Fp, Gll, Hh, Mm, Mm, Mm, Mm, Mm, Hh, Mm, Hh, Hh, Gs, Ww, Ww, Gg, Hh, Hh, Hh, Mm, Mm, Mm, Mm, Mm, Mm, Mm, Mm, Mm, Mm, Mm, Mm, Mm
Mm, Mm, Mm, Mm, Mm, Mm, Mm, Mm, Mm, Mm, Mm, Mm, Mm, Mm, Mm, Mm, Mm, Mm, Hh, Hh, Gs, Gg, Gll, Gll^Fds, Gll, Gg, Gll^Fds, Gs^Fds, Gll^Fms, Gll^Em, Gg, Gg, Gg, Hh, Hh, Hh, Hh, Hh, Hh, Hh, Gs, Gg, Gs, Gs, Ww, Gg, Gg, Hh, Mm, Hh, Mm, Mm, Mm, Mm, Mm, Mm, Mm, Mm, Hh, Mm, Mm, Mm
Mm, Mm, Mm, Mm, Mm, Mm, Mm, Mm, Mm, Mm, Mm, Mm, Mm, Mm, Mm, Mm, Mm, Hh, Gg, Gll, Gll^Fms, Gll^Fds, Gll^Fds, Gll, Gs^Fms, Gll, Gll, Gll^Fds, Gll^Fms, Gll, Gs, Gs, Gg^Vh, Gg, Gg, Gg, Gs, Gg, Gg, Gg, Gs, Gd, Gg, Ww, Ww, Gs, Hh, Hh, Mm, Mm, Mm, Mm, Mm, Mm, Mm, Mm, Mm, Mm, Mm, Hh, Mm, Mm
Mm, Mm, Mm, Mm, Mm, Mm, Mm, Mm, Mm, Hh, Hh, Mm, Mm, Mm, Mm^Vhh, Mm, Mm, Hh, Hh, Gll^Em, Hh^Fms, Gll^Fms, Gll^Fms, Gll^Fds, Gll^Vh, Gll^Fds, Gg, Gll, Gg, Gg, Gg, Gg, Gll, Gg, Gg, Gg, Gs, Gg^Es, Gg, Hh, Hh, Gg, Ww, Ww, Gg, Gs, Mm, Mm, Mm, Hh, Hh, Mm, Mm, Mm, Hh, Hh, Mm, Mm, Mm, Mm, Mm, Mm
Mm, Mm, Hh, Mm, Hh, Mm, Mm, Mm, Hh, Hh, Hh, Mm, Mm, Mm, Mm, Mm, Mm, Mm, Mm, Hh^Fms, Hh^Fms, Gs^Fds, Gll, Gll, Gg, Gll^Efm, Gg, Gg, Gs, Gg, Gg, Gll, Gll^Fds, Gll^Fds, Gll, Gg, Gg, Gg^Eff, Gg^Eff, Hh, Hh, Gg, Ww, Ww, Gg, Hh, Mm, Mm, Hh, Mm^Vhh, Hh, Hh, Hh, Hh, Mm^Vhh, Mm, Mm, Mm, Mm, Mm, Mm, Mm
Mm, Mm, Mm, Hh, Hh, Hh, Hh, Hh, Gs, Hh, Hh, Mm, Hh, Hh, Mm, Mm, Hh, Hh, Mm, Mm, Hh, Hh^Fms, Gg, Gg, Gs^Es, Gg, Gg^Efm, Gg, Gs, Gs, Gg^Gvs, Gll, Gll^Fds, Gll^Fds, Gg, Gg, Gs, Gg^Eff, Gs^Eff, Gg, Gg, Gg, Ww, Gs, Gg, Hh, Hh, Hh, Gs, Hh, Ss, Ss, Hh, Hh, Hh, Mm, Mm, Mm, Mm, Mm, Mm, Mm
Mm, Mm, Hh, Hh, Hh, Hh, Gg, Gs, Gg^Es, Gs, Gs, Hh, Gg, Hh, Hh, Hh, Mm, Mm, Mm, Mm, Mm, Hh, Hh, Gg, Gg, Gg, Gll, Gg, Gg^Gvs, Gg^Gvs, Gg, Gg, Gs, Gll, Gs, Gg, Gg, Gs^Eff, Gs^Eff, Gg, Gg, Gg, Ww, Ds, Gs, Gs, Sm, Ds, Ce, Gs, Ss, Ds, Gs^Vc, Hh, Hh, Hh, Mm, Mm, Mm, Mm, Mm, Mm
Mm, Mm, Hh, Hh, Gg, Hh, Gg, Gg^Vh, Gg, Gg, Gg, Gs, Gd, Gg, Gs, Hh, Hh, Mm, Hh, Mm, Hh, Hh, Hh, Gg, Gg, Gll^Fds, Gll^Fms, Gll, Gg^Gvs, Gg^Gvs, Gg, Gs, Gg, Gs, Gg, Gs, Gs^Eff, Gg^Eff, Gg, Gd, Gs, Gs, Ww, Ss, Gs, Sm, Sm, Ds, 4 Ke, Ce, Sm, Sm, Ss, Ds, Hh, Hh, Hh, Mm, Mm, Mm, Hh, Hh
Mm, Mm, Hh, Hh, Gg, Gg, Gs, Gs, Gg, Gg, Gg, Gs, Gg, Gg^Es, Gg, Gs, Gs, Hh, Gg, Hh, Gg, Hh, Gg, Gg^Efm, Gg, Gg, Gs^Fds, Gll^Fms, Gll, Gg^Gvs, Gg, Gg, Hh, Hh, Gg, Gs, Gs^Vh, Gg, Gg, Gg, Gs, Ds, Ww, Sm, Ds, Ds, Rb, Ce, Ce, Ce, Ss, Sm, Gs, Ss, Gs^Vht, Ss, Ss, Hh, Hh, Hh, Mm, Mm
Mm, Mm, Hh, Hh, Gs, Gg, Gg, Gs^Efm, Gg, Gg^Efm, Gg, Gs^Efm, Gg, Gg, Gg, Gs, Gg, Gg, Gg, Gs, Gs, Gg, Gg, Gg, Gs, Gll, Ce, Gg^Vh, Gg, Gg, Gg^Es, Gg, Hh, Hh, Gg, Gs, Rb, Gs, Gg, Gg, Rb, Rb, Ww^Bw\, Sm, Rb, Rb, Ss, Rb, Gs, Ss, Ds, Ss, Gs, Ds, Hh, Hh, Ds, Hh, Hh, Hh, Mm, Mm
Hh, Hh, Gg, Gd, Gg^Es, Gs, Gg^Efm, Gg, Gg^Efm, Gg, Gg, Gs, Gg, Hh, Hh, Gg, Re, Gg, Re, Re, Re, Re, Gg, Gg^Efm, Gg, Ce, 3 Ke, Ce, Gg, Gg, Gg, Gg, Gg, Gg, Rb, Rb, Gg, Rb, Gg, Rb, Ds, Ww, Sm, Rb, Ds, Ds, Ss, Ss, Rb, Gs^Vht, Gs, Sm, Sm, Ss, Ss, Ss, Ss, Hh, Hh, Mm, Hh, Hh
Re, Re, Gg, Gg, Re, Gg, Gg, Gs, Gs, Gg, Re, Gg, Re, Re, Re, Re, Gg, Gg, Gg^Vh, Gg, Gg, 1 Gs, Gg, Rb, Re, Ce, Ce, Ce, Rb, Re, Re, Rb, Rb, Gg, Gg, Gg^Es, Gs, Gs, Ww, Gs, Ww, Ss, Gs, Gs, Gs, Gs, Ss, Ds, Rb, Gg, Ds, Gs, Ds, Gg, Gs, Ss, Gs, Ss, Gs, Hh, Ss, Ss
Gs, Gs, Gg, Re, Gg, Re, Ce, Re, Re, Re, Gg, Gs^Vh, Gg, Gg, Gs, Gg, Ww, Ww, Ww, Gg, Ww, Gg, Gg, Hh, Hh, Re, Rb, Gg, Gs, Gs, Gg, Gs, Gs^Gvs, Gs, Gg^Gvs, Gg, Ww, Ww, Ss, Ww, Ss, Ss, Ds, Ds, Ss, Ss, Ds, Ds, Gll, Rb, Rb, Ds, Rb, Rb, Ss, Rb, Rb, Rb, Ss, Rb, Rb, Rb
Ww, Ww, Ww, Gg^Vh, Gg, Ce, 2 Ke, Ce, Gg, Gs, Gs, Gg, Ww, Ww, Ww, Ww, Hh, Hh, Mm, Ww, Ww, Ww, Ww, Hh, Gg, Gg, Gg^Efm, Gg, Gg, Gs, Gg^Vwm, Gs^Gvs, Gg^Gvs, Gg^Gvs, Gg^Gvs, Gs, Ww, Ss, Ds, Ss, Ds, Ds, Ds, Gg, Sm, Ss, Gll^Fds, Gll^Fms, Gll^Fds, Gs, Gs^Vht, Gg, Sm, Sm, Ss, Gs^Vc, Ss, Ss, Hh, Ss, Hh, Hh
Gg, Gg, Gg, Ww, Ww, Ce, Gg, Ce, Ww, Ww, Ww, Ww, Gg, Gg, Hh, Hh, Mm, Mm, Mm, Hh, Hh, Gg, Gg, Ww, Ww, Ww, Ww, Ww, Ww, Gg, Gs, Gs, Gs, Gg^Gvs, Gg, Ww, Ss, Ss, Ds, Ds, Ds, Gs, Ss, Ss, Sm, Gll, Gll^Fds, Gll^Fms, Gll^Fms, Ds, Ds, Gs^Fms, Ss, Sm, Ss, Ss, Ss, Hh, Mm, Hh, Mm, Mm
Hh, Hh, Mm, Hh, Gg^Vh, Ww, Ww, Ww, Gg, Gg^Vh, Gg, Hh, Mm, Hh, Hh, Mm, Mm, Mm, Mm, Mm, Mm, Hh, Hh, Hh, Hh, Hh, Gg, Gg, Gg, Ww, Ww, Ww, Ww, Gs, Ww, Ww, Ss, Ss, Ds, Gs, Ds, Gs, Ds, Gll, Gll^Fms, Gll, Gs^Fms, Gll^Fds, Gll^Fds, Gll^Fms, Ss, Gll^Fms, Gs^Fds, Ss, Gll^Fds, Ds, Ss, Hh, Hh, Mm, Mm, Mm
Mm, Mm, Mm^Vhh, Hh, Mm, Hh, Hh, Gg^Efm, Hh, Hh, Mm, Mm, Mm, Mm, Mm, Mm, Mm, Mm, Mm^Vhh, Mm, Mm, Hh, Mm, Mm, Mm, Hh, Hh, Hh, Hh, Gs, Gs, Ww, Ww, Ww, Ww, Ww, Ss, Ds, Gs, Gs, Ds, Ds, Hh, Hh, Hh, Gs^Fms, Hh^Fms, Gll^Fds, Gll^Fds, Ss, Gs^Fms, Gll^Fds, Gll^Fds, Ss^Fms, Gll^Fms, Ss^Fms, Gll^Fds, Hh, Hh, Mm, Mm, Mm
Mm, Mm, Mm, Mm, Mm, Hh, Mm, Hh, Mm, Hh, Mm, Mm, Hh, Hh, Mm, Hh, Mm, Mm, Mm, Mm, Mm, Mm, Mm, Mm, Mm, Mm, Mm, Hh, Mm, Hh, Hh, Hh, Gs, Ww, Ss, Ww, Ss, Ss, Ds, Ds, Hh, Gs^Vc, Mm, Mm, Mm, Hh, Hh^Fms, Gll^Fms, Gll^Fds, Gs^Fms, Gll^Fms, Gs^Fms, Gll^Fms, Gll^Fms, Gll^Fms, Gll^Fms, Gll^Fms, Gll^Fms, Hh, Hh, Hh, Hh
Mm, Mm, Mm, Mm, Mm, Hh, Mm, Hh, Mm, Hh, Mm, Mm, Hh, Hh, Mm, Hh, Mm, Mm, Mm, Mm, Mm, Mm, Mm, Mm, Mm, Mm, Mm, Hh, Mm, Hh, Hh, Hh, Gs, Gs, Ss, Ss, Ss, Ss, Ds, Hh, Hh, Gs, Mm, Mm, Mm, Hh, Hh, Gs^Fms, Gs^Fms, Gll^Fds, Gs^Fms, Gll^Fms, Gs^Fms, Gs^Fds, Gs^Fds, Gll^Fds, Gll^Fds, Gll^Fms, Hh, Hh, Hh, Hh
