Gs, Re, Gg, Gs, Ds, Re, Gll^Fp, Re, Gll^Fp, Rb, Rb, Re, Gg, Gg, Gs, Gs, Gs, Gs, Gg, Gg, Ds, Ds, Ds, Gg, Gg^Efm, Gg, Gs, Ds, Ds, Gg, Gs^Fp, Gs^Fp, Gs^Fp, Ds^Fp, Ds^Fp, Wwg, Wwg, Ss, Ss^Fp, Ss, Ss, Ss, Ds, Gg, Ds, Ds, Ds
Gs, Re, Re, Gg, Ds, Gg, Re, Gll^Fp, Gll^Fp, Gll^Fp, Re, Re, Gs, Gs, Gg^Es, Gg, Gg^Es, Gg^Efm, Gg^Efm, Gg, Ds, Ds, Ds, Gg^Efm, Gg, Gs, Ds, Ds, Ds, Gg^Fp, Gll^Fp, Gll^Fp, Gll, Ds^Fp, Ds, Wwg, Wwg, Gll^Fp, Gll^Fp, Gll^Fp, Gg^Fp, Ss, Gs^Fp, Gs^Vl, Ds, Ds, Ds
Hhd, Gs, Re, Gs, Ce, Ds, Re, Re, Gd^Fetd, Gll^Fp, Gll^Fmw, Gll, Gll, Gs, Rp, Rp, Rp, Gg^Efm, Gs^Efm, Ds, Ds, Ds^Vhr, Ds, Gg^Efm, Hh, Hh, Hh, Ds^Es, Ds, Ds, Hh^Fp, Gs^Fp, Gs^Fp, Ds, Wwg, Wwg, Gs, Gll^Fp, Gll^Fmw, Gll^Fmw, Ss^Fp, Ds, Gs^Fp, Gg^Fp, Ds, Ss, Ss
Hhd, Hhd, Gd, Gs, 2 Ke, Ce, Gs, Gg^Es, Gll^Fp, Gll^Fmw, Gs, Gll^Fmw, Gll, Gs, Gs, Gs, Rp^Es, Rp, Gs, Gg, Gg, Ds, Ds, Ds, Ds, Hh, Hh, Hh, Hh^Vhr, Hh^Fp, Hh^Fp, Gs^Fp, Ds, Ds, Wwg, Ss, Re^Fp, Re^Fp, Ss, Ss^Vhs, Ss, Ss^Fp, Ss, Re, Re, Ss, Ss
Hhd, Hhd, Gd, Ce, Ce, Ce, Gg, Gg, Ds, Ds, Gll, Gll, Gll, Gs, Gs^Vh, Gs, Gs, Gs, Gs, Gs, Gg, Ds, Gg, Gg^Efm, Gg, Hh, Hh, Hh, Re, Hh, Hh, Ds, Ds, Ds, Wwg, Ss, Ss, Ds, Gd^Dr, Ss, Ss, Ss^Fp, Ss^Fp, Ss, Gs, Ds, Ds
Gd, Gs, Gd, Hhd, Re, Re, Gs, Gs, Ds, Gs, Gs^Es, Gll, Gll, Gll, Gll, Gs, Gg, Gs, Gs, Gg, Ds, Ds, Gg, Gg, Gg, Re, Hh, Hh, Hh, Re, Ds, Ds, Ds, Wwg, Wwg, Ss, Ss, Ss, Ds, Ds, Sm, Ss, Sm, Re, Re, Ds, Ds
Hh, Hhd, Hhd, Re, Hhd, Re, Re, Ds, Ds, Ds, Gll, Re, Re, Re^Es, Re, Ds, Ds, Gs, Gg, Gg, Ds, Re, Re, Re, Ds, Ds, Re, Hh^Vhhr, Hh, Hh, Re, Ds, Ds, Wwg, Ds, Ds, Ss, Re, Re, Re, Re, Sm, Re, Re, Ss, Ss, Ss
Mm, Mm, Hh, Hhd, Re, Re^Es, Re, Gs, Gg, Gg, Gg, Re, Re, Gg, Gg, Re, Re^Es, Ds, Gg, Ds, Ds, Re, Re, Re, Re, Ds, Hh, Re, Re, Rb, Re, Ds, Ds, Wwg, Ss, Ds, Ds, Ss^Fp, Ss^Fp, Ss^Fp, Ds, Gd^Vhr, Gs, Ss, Ss, Ss, Ss
Mm^Xm, Mm, Mm, Hh, Gll^Fp, Gll^Fp, Gll, Gg, Gll^Fp, Gg, Gg^Em, Gll^Fp, Gll^Fdw, Gll^Fdw, Gll^Fdw, Gg, Gg^Es, Gg, Gs, Gs^Efm, Gs, Gg^Vh, Gg, Rb, Rb, Ds, Ds, Hh, Gg, Ds, Ds, Ds, Ds, Wwg, Ds, Ss, Ss^Fp, Ss^Fp, Ss, Ds, Gs^Fp, Gs^Fp, Re, Ss, Sm, Sm, Sm
Mm^Xm, Mm, Hh, Hh, Hh, Rb, Gll, Gll, Gg, Gg, Gs^Fp, Gg, Gg, Gll^Fp, Gll, Gg, Gs, Gs, Gs, Gs^Efm, Gg, Gs, Gg, Rb, Re, Re, Gg, Hh, Gs, Gg^Es, Gg, Ds, Wwg, Wwg, Ds, Ss, Ss^Fp, Ss, Gll^Fp, Re, Ss, Ss, Re, Sm, Sm, Sm^Vhs, Gll^Fdw
Mm^Xm, Mm, Mm, Hh^Vl, Hh^Dr, Re, Gll^Fp, Gs, Gll^Fmw, Gll^Fmw, Gd^Fdw, Gg, Gll^Fp, Gll, Gll^Fmw, Gll, Gg, Gs^Dr, Gs, Gg, Gs, Gs^Efm, Gs^Dr, Gs, Ds, Ds, Ds, Gg, Gs, Gs, Ds, Ds, Wwg, Ds, Ss, Ss, Ss, Gll^Fp, Gd, Ss, Ss, Ds, Ds, Ds^Es, Ds, Gll^Fdw, Gd^Fmw
Mm^Xm, Mm^Xm, Mm, Hh, Hh, Hh, Hh, Gll^Fp, Gll^Fp, Gll^Fmw, Gs^Fp, Gd^Fdw, Gll^Fp, Gll^Fp, Gll^Fmw, Gll, Gll^Vhhr, Gg, Gs^Ecf, Ce, Ce, Gs, Gg, Gs, Gg, Ds, Ds^Esd, Gg, Gs, Ds, Ds, Wwf, Wwf, Ss, Ss, Ss, Ds, Gd^Vhr, Gd^Edb, Ss, Ss, Ss, Ss, Ds, Ds, Gll^Fmw, Ss
Mm^Xm, Mm^Xm, Mm, Hh^Fp, Mm, Hh, Hh^Fp, Gll^Fp, Hh^Fmw, Hh^Fp, Gs, Gll^Em, Gd^Fdw, Gll^Fmw, Gll^Fmw, Gll^Fp, Gll, Gs, Ce, 1 Ket, Ce, Ce, Gs^Es, Gg^Es, Ds, Ds, Ds, Ds, Ds, Ds, Ds, Wwg, Ds, Re, Re, Ds, Ds, Ss, Re, Gs^Em, Rb, Ss, Re, Ss, Ss^Vht, Ss^Fp, Ss^Fp
Mm^Xm, Mm^Xm, Mm, Mm, Hh, Hh^Fp, Gll^Fp, Hh^Fmw, Hh, Hh^Fp, Ss, Gs^Vc, Gll^Fdw, Gll^Fmw, Gll^Fp, Gll^Fp, Gll, Gll, Gg, Ce, Gg, Gs, Gg, Re, Re^Vhcr, Re, Re, Re, Ds^Es, Ds, Ds, Wwg, Wwg, Ss, Ds^Em, Sm, Ss, Ss, Ss^Bw\r, Ss, Ds^Es, Ds, Re, Re, Ss, Ss, Ss
Mm^Xm, Mm^Xm, Mm, Hh, Hh, Hh^Fp, Hh, Hh^Fp, Gll^Fp, Hh^Fp, Ss, Ss, Gll^Fmw, Gll^Fp, Gll, Gll^Fp, Gll, Gll, Gs^Vhcr, Gg, Gg, Gs, Rp, Rp, Gs, Gs, Gg, Re, Re, Re, Ds^Esd, Ds, Wwg, Ds, Sm, Sm, Ss^Vhs, Ss, Ss^Fp, Rb, Rb, Ds, Ds, Ds, Sm, Rb, Rb
Mm^Xm, Mm^Xm, Mm, Mm, Mm, Hh, Gll^Dr, Rb, Ds, Ds, Re^Es, Gll^Fp, Gll^Fmw, Gll^Fmw, Hh, Gll, Gg, Gg, Gs, Gs^Efm, Gs^Es, Gs^Es, Rp, Gs, Gs^Efm, Gs^Efm, Gg, Re, Gg, Ds, Ds, Ds, Wwf, Ss, Ss, Sm, Ss, Ss, Gll^Fp, Re^Fmw, Ss^Fp, Ss, Ss, Sm, Sm, Sm^Fmw, Rb^Fmw
Mm^Xm, Mm^Xm, Mm, Mm, Hh, Hh, Re, Rb^Es, Re^Es, Re^Es, Gg, Gll, Gs, Gll, Hh, Hh^Dr, Gg, Gs, Gs^Efm, Gs, Gs, Gg^Es, Gg, Rp, Gg^Efm, Gg, Gg^Efm, Gg, Gg, Gg, Ds, Wwg, Wwg, Ss, Re, Gs, Ds, Ds, Ds, Ss^Fmw, Ss, Ss^Fp, Ss, Sm, Re, Re^Fmw, Rb
Mm^Xm, Mm, Mm, Mm, Mm, Hh, Re, Re, Gg, Gg, Gg, Gs^Edt, Gs, Gs, Gg, Gg, Gg, Rp, Gg^Efm, Gs^Efm, Gs^Fp, Gg, Hh, Gg^Efm, Gg^Efm, Gg^Efm, Gg, Gg, Gs, Ds, Wwg, Wwg, Ds, Ss, Ss, Ss^Bw\r, Ss^Bw\r, Ss, Ds, Ds, Gs^Vc, Gs, Rb, Rb, Ss, Ss, Ss
Mm^Xm, Mm^Xm, Mm^Xm, Mm, Mm, Hh, Re, Hhd, Gs, Gg, Hh, Gs, Gg, Gs, Hh^Dr, Gg, Hh, Rp, Rp, Gg, Gll^Fp, Hh^Fp, Ds^Efm, Ds, Gg^Efm, Ds, Ds, Ds, Ds, Wwg, Wwg, Ds, Ss, Ss, Ds^Edb, Ds, Ss, Ss, Ss^Bw\r, Ss, Ss, Ss, Sm, Rb^Edb, Ss, Ss, Ss
Mm^Xm, Mm^Xm, Mm^Xm, Mm^Vhr, Mm, Mm, Hh, Ds, Ds^Es, Gg, Hh^Fp, Hh, Gg^Vc, Gg, Gg, Hh, Hh, Hh, Gs, Gg, Re^Vhr, Gll^Fp, Gs^Efm, Gg, Ds, Ds, Ds, Wwg, Wwg, Wwg, Ss, Ss, Ss, Ds, Ds^Ecf, Gs, Ss, Ss, Chs, Chr, Chr, Sm, Sm, Sm, Re, Re, Re
Mm^Xm, Mm^Xm, Mm, Mm, Mm, Hh, Hh, Ds, Ds, Gg, Gll^Fp, Gg^Fet, Gg, Gg, Gg^Edt, Re, Re, Gg, Re^Es, Rb, Re, Gg, Gg^Efm, Gg, Gg, Ds, Ds, Wwg, Ss, Ss, Ss, Ss, Ss, Gd, Re, Gs, Ss, Ss, Chs, 3 Khs, Chr, Ds, Ds^Edb, Ds, Ss^Bw\r, Ss, Ss
Mm^Xm, Mm^Xm, Mm, Mm, Mm, Mm, Hh, Hh, Ds, Ds, Re, Gll^Fp, Re, Rb, Re^Es, Re, Re, Rb, Rb^Edt, Re, Hh^Fp, Gg^Fp, Ds, Gg, Gg^Es, Gs, Ds, Wwg, Wwf, Ss, Sm, Re, Re, Re, Ss, Ss, Ss^Vhs, Re^Edb, Re, Chr, Re, Re, Ss, Ss, Ss, Ss, Ss
Mm^Xm, Mm^Xm, Mm, Mm, Mm, Mm, Hh, Hh, Hh, Ds^Vhc, Rb, Gg, Gs, Gs, Gs, Gs^Vl, Re, Re, Re, Re, Re^Fp, Hh, Re, Re, Re^Fp, Gll^Fp, Gs, Ds, Wwg, Gs, Ss, Ss, Ss, Sm, Gll^Fp, Ss, Ds, Ss, Ss^Bw|r, Ss, Ss, Gs^Em, Gs^Vl, Ss, Ss^Fp, Ss, Ss
Mm^Xm, Mm, Mm, Mm, Hhd, Hhd, Hhd, Hh, Hhd, Re, Rb, Hhd^Dr, Ds, Ds, Ds, Gs, Gs^Dr, Gs, Gg, Gg, Gg, Ds, Ds, Re^Fp, Gll^Fp, Gll^Fp, Gs^Fp, Wwg, Wwg, Gs, Ss^Vht, Ss, Ss^Fp, Ss^Fmw, Gll, Sm, Ds, Ss, Ss, Ss, Ss, Gs, Re, Gll^Fmw, Sm^Fmw, Sm^Fp, Ss
Mm^Xm, Mm^Xm, Mm^Xm, Mm, Hhd^Vhr, Mm, Hhd^Dr, Hhd^Dr, Hhd, Hhd, Hhd, Hhd, Hhd, Hhd, Ds^Es, Gg, Hh, Hh, Gg, Gg^Edt, Re, Re, Gg, Gll^Fp, Gll^Fp, Gll^Fp, Wwg, Wwg, Gll, Ss, Ss, Ss, Ss, Gd^Fmw, Re, Ss, Ss, Ss^Vhs, Ss, Ss, Ss^Fp, Ss, Gd^Es, Ds, Ds^Edb, Sm, Sm
Mm^Xm, Mm^Xm, Mm^Xm, Mm, Mm, Mm, Mm, Hhd, Hhd, Hhd, Hhd, Hhd, Rb, Hhd, Rb, Gs, Gs, Hh, Re, Re^Es, Re, Gg, Gll^Fp, Gll^Fp, Gs^Fp, Wwg, Wwg, Gll^Fmw, Gll^Fmw, Ss^Fp, Ss^Fp, Ss, Re, Re, Ss, Ss, Ss, Ss, Ss, Re, Re^Fp, Gll^Fmw, Gll, Ds, Ds^Es, Ds, Ds
Mm^Xm, Mm^Xm, Mm^Xm, Mm^Xm, Mm, Mm, Mm, Hhd, Hhd, Hhd, Hhd, Re^Es, Gg, Gg, Gg, Gg, Hh, Hh, Gg, Gg, Re, Gll^Fp, Gll^Fp, Gll^Fp, Ds^Fp, Wwg, Wwg, Ds^Fp, Ss^Fp, Ss^Fp, Ss^Fp, Ss, Re, Re, Ss, Ss, Ss, Ss, Ss, Re, Re, Re, Ds, Ds, Ds, Ds, Ds
