Ds, Ds, Ds^Es, Re, Ss, Ss, Ss^Edb, Ss^Edb, Ss^Edb, Ss, Re, Re, Ss, Ss, Ss, Ss, Ss, Ss, Ss, Ss, Ss, Re, Re, Ss, Ss, Ss, Qxu, Ss, Qxu, Chr, Chr, Rp, Rp, Rp, Rp, Rp, Ds, Ss, Ss, Ss, Ss, Rp, Re, Rp, Gs, Chr, Chr, Ss, Ss, Rp, Hhd, Mm, Mm, Mm, Mm, Hh, Hh, Hh, Hh, Mm, Mm, Mm, Mm, Mm, Mm, Mm, Mm
Ds, Ds, Ds^Es, Re, Ss, Ss^Edb, Ss, Ss, Ss, Ss, Re, Re, Ss, Ss, Ss, Wwf, Wwf^Edb, Ss, Wwf, Ss, Ss, Re, Ds, Ss, Qxu, Qxu, Chr, Qxu, Chr, Chr, Gs^Es, Gs, Rp^Dr, Rp^Es, Rp^Xo, Rp, Ds, Ss, Ss, Ss, Ss, Ds, Re^Vhcr, Re, Rp, Chr^Es, Chr, Chs, Ss, Hhd, Chr, Mm, Mm, Mm, Mm, Hh, Hh, Hh, Hh, Mm, Mm, Mm, Mm, Mm, Mm, Mm, Mm
Ds, Ds^Es, Re, Re, Re, Re, Chr, Chs, Chr, Ds, Ds^Es, Ds, Ds^Es, Ds, Ss, Ss^Edb, Wwrg, Wwf, Wwf, Ss, Ss, Ss, Re, Re, Re, Chr, Rp, Chr^Dr, Gg, Gg, Gs, Rp, Qxu, Rp, Rp^Edt, Rp^Edt, Rp^Es, Ds, Ss, Ss, Ss, Ds, Sm, Re^Es, Qxu, Qxu, Ds, Chs, Chs, Ds^Dr, Chr, Chr, Mm, Mm, Mm, Gs, Re, Re, Gs, Hh, Mm, Mm, Mm, Mm, Mm, Mm, Mm
Ds, Ds, Gs, Ss, Ss, Ss, Chs, 2 Khr, Chr, Ss, Ds, Ds^Es, Re, Re, Re, Wwf, Wwrg, Wwrg, Wwrg, Wwg, Ss, Re^Xo, Ss, Re^Es, Re, Re, Rp, Rp, Rp^Vhcr, Gg, Rp, Rp, Qxu, Rp, Qxu^Bsb|, Rp, Qxu, Rp, Qxu, Ss, Ss, Sm, Sm, Re, Rp, Gs, Ss, Ss, Rp^Vhcr, Chr, Hh, Hh, Mm, Mm, Mm, Hh, Hh^Vhcr, Re, Hh, Mm, Mm, Mm, Mm, Mm^Vc, Mm, Mm, Mm
Ss, Rb, Gll^Fmw, Gll^Fmw, Gll^Fp, Gll^Fdw, Ss, Chr, Re, Re, Ss, Ss, Ss, Ss, Ss, Sm, Sm, Wwrg, Wwg, Wwg, Ss, Ss, Ss, Re, Re, Re, Rp^Es, Rp, Rp, Gg, Rp, Qxu, Qxu, Qxu, Rp, Qxu, Rp, Qxu, Ds, Ss, Ss, Ss, Sm, Sm, Ds^Dr, Ds, Ss, Ds, Rp, Hhd, Re, Hhd, Hh, Mm, Mm, Mm, Hh, Hh, Mm, Mm, Mm, Mm, Mm, Mm, Mm, Mm, Mm
Rb^Fp, Gll^Fmw, Gll^Fmw, Gll^Fmw, Ss^Fmw, Gll^Fdw, Ss^Bw/r, Ss^Bw|r, Re, Re, Ss, Ss, Wwg, Wwg, Wwrg, Ss^Vhs, Wwf, Sm^Dr, Sm^Dr, Ss, Ss, Ss, Re, Re^Edb, Qxu, Chr^Dr, Rp, Rp, Rp^Es, Rp^Edt, Rp, Qxu, Rp, Rp, Ds, Rp, Rp^Edt, Rp, Ds, Ds, Ss, Ss, Ds, Sm, Ss, Ss, Rp, Ds, Rp, Re^Es, Re, Hhd, Hhd, Mm, Mm, Mm, Mm, Mm, Mm, Mm, Mm, Hh, Hh, Mm, Mm, Mm, Mm
Rb^Fp, Rb^Fdw, Rb^Fmw, Ss^Fmw, Chs, Ss^Bw/, Ss, Ss, Ss, Re, Re, Ss, Ss, Wwg, Ss, Wwrg, Wwf, Wwf, Sm, Re, Ss, Re, Re, Qxu, Chr, Chr, Rp, Rp, Rp, Rp, Rp^Xo, Rp, Ss, Ds, Ss, Rp, Rp, Rp^Dr, Ss, Ss, Ss, Ss, Ds, Ds, Ss, Ds, Gg, Rp, Rp^Edt, Rp, Hh, Hh, Mm, Mm, Mm, Mm, Mm, Mm, Mm, Mm, Mm, Hh, Hh, Hh, Mm, Mm, Mm
Ss, Re, Ss^Bw|, Rb^Fdw, Ss^Bw|r, Ss, Ss, Ss, Ss, Ds, Ds, Ds, Ds, Re, Sm^Uf, Wwrg, Wwrg, Wwrg, Ds, Ds, Ds, Ds, Qxu, Qxu, Chr, Rp, Gg, Gg, Gg^Dr, Rp, Rp, Rp, Ds, Ss, Ss, Ds, Ds, Rp, Ss, Ss, Ds, Ss, Ss, Ss, Rp^Es, Rp, Rp, Qxu, Rp, Rp, Hh, Hh, Hh, Mm, Mm, Mm, Mm, Mm, Hh, Mm, Mm, Mm, Mm, Mm, Mm, Mm, Mm
Ss, Ss, Re, Ss, Re, Ss^Bw\, Ss^Vhs, Ds, Ds, Rp, Ds, Ds^Vhr, Wwf, Ss, Sm, Wwrg, Wwg, Wwg, Ss, Ds, Ds^Vh, Ds, Qxu, Chr, Rp, Rp, Rp^Vhcr, Gs, Gs, Rp, Rp^Es, Ds, Ds, Ss, Ss, Ss, Chr, Ds, Ss, Ds, Ds, Ss, Ss^Bw/r, Rp, Ds, Rp, Re, Qxu, Qxu, Rp^Es, Hhd, Hh, Hh, Mm, Mm, Mm, Hh, Hh, Qxu, Hh, Hh, Mm, Mm, Mm, Mm, Mm, Mm
Ss, Ss, Gll^Fmw, Gll^Fp, Gs^Fmw, Re, Gg, Re, Rp, Rp, Ds, Ss, Ss, Wwf, Sm, Sm^Dr, Wwg, Ss, Ss, Ss^Edb, Ss, Ss, Qxu, Chr^Dr, Rp, Rp, Rp, Gs, Gs, Gs^Es, Rp, Rp, Ds, Ss, Rp, Ss, Ds, Ds, Rp, Ds, Ds, Ss^Bw/r, Ss, Ss, Ds, Rp^Es, Re, Rp, Rp, Qxu, Rp, Hh, Mm, Mm, Mm, Hh, Qxu, Qxu, Cud, Qxu, Hh, Mm, Mm, Mm^Vhhr, Mm, Mm, Mm
Ss, Ss, Rp, Gll^Fmw, Re, Gs^Fp, Rp, Gs^Fet, Rp^Es, Re, Sm, Ss, Ss, Wwf, Wwg, Wwg, Ds, Sm, Ss, Ss^Edb, Ss^Edb, Ss, Qxu, Chr, Rp, Rp, Gg, Gg, Rp, Qxu, Qxu, Chr^Dr, Gs, Gs, Gs^Es, Ds, Rp, Rp, Sm, Sm, Sm, Ds, Ss, Ss, Ss, Ds, Rp, Re^Es, Re, Rp, Gs, Hh, Mm, Mm, Hh^Vhcr, Hh, Qxu, Cud, Urb, Cud, Hh, Mm, Mm, Mm, Mm, Mm, Mm
Ss, Rp, Sm, Rp, Rp, Rp, Ss, Rp, Rp, Rb^Es, Rb, Gs, Ss, Ss, Wwg, Wwg, Ds, Ds, Ds, Ss, Ss, Ss, Re, Re, Rp, Gs^Es, Rp, Gg, Gs, Rp, Qxu, Qxu, Rp, Gs^Vhcr, Rp, Rp, Chr, Chr, Chs, Ss, Chs, Ss, Sm, Ss, Ss, Ds^Dr, Ds, Rp, Gs^Es, Rp, Re, Gg, Hh, Mm, Mm, Mm, Urb, Urb, Cud, Urb, Urb, Hh, Hh, Mm, Mm, Mm, Mm
Rp, Rp, Ss, Gll^Fp, Gll^Fp, Ss, Ss, Ss, Ss, Rp, Rp, Rp, Rp, Ss, Ss, Wwg, Ss, Ss, Re, Re, Ss, Re, Re, Chr, Rp, Rp, Qxu, Rp, Rp^Dr, Rp, Rp, Qxu, Rp, Rp, Chr, Chr^Edt, Chr, 4 Khr, Chs, Chs, Chr^Dr, Chr^Dr, Chr^Edt, Ss, Ss, Ss, Ss, Gg^Edt, Rp, Re, Re^Es, Gg, Rp, Hh, Hh, Cud, Urb, Urb, 5 Kud, Urb, Urb, Cud, Qxu, Hh, Mm, Mm, Mm
Ss, Ss, Gll^Fp, Ss, Gll^Fmw, Ss, Rb, Rb, Chs, Ss, Ss^Edt, Ss, Ss, Rp, Rp, Re, Ce, Ce, Ce, Rd^Vh, Gs, Re, Ss, Chr, Gs, Rp, Qxu, Rp, Re, Re^Dr, Rp, Rp, Gs, Chr, Chr^Dr, Rp^Dr, Rp, Chr, Ss, Chs, Chr^Edt, Chr^Dr, Sm, Ss, Ss, Ss, Ss, Ds, Re^Edt, Re^Vhcr, Re, Rp^Es, Rp, Rp, Hh, Cud, Urb, Cud, Urb, Cud, Urb, Cud, Qxu, Hh, Mm, Mm, Mm
Ss, Gll^Fp, Gll^Fmw, Gll^Fmf, Gll^Fmw, Ss, Ds, Ds, Ds, Ss, Ss^Edt, Ss, Ss, Ss, Re, Rp, Ce, 1 Ket, Ce, Gs, Ss, Ss, Gll^Fp, Chs, Ss, Ss, Rp, Rp^Es, Rp, Re, Rp, Rp^Edt, Rp, Chr, Rp, Rp^Dr, Rp^Edt, Sm, Sm, Ss, Ss, Chr, Ss, Ss, Ss, Ss, Ds, Rp, Rp^Es, Re, Rp^Dr, Rp, Hh^Vhcr, Hh, Hh, Hh, Hh, Urb, Urb, Urb, Hh^Vhhr, Qxu, Hh, Mm, Mm, Mm, Mm
Gll^Fp, Gll^Fmf, Gll^Em, Gll^Emf, Ds^Fmw, Ds, Ds, Ds^Vhr, Ds^Es, Ds, Ss^Edt, Gs, Ss^Bw/, Ss^Bw/r, Ss, Re, Re, Ce, Gs, Gs, Ss, Ss, Gll^Fp, Chr, Rp, Rp, Gs, Gg, Gg, Qxu, Qxu, Qxu, Rp, Rp, Rp, Rp^Es, Gs, Rp^Es, Ds, Rp^Edt, Rp, Ss, Ds, Ss, Ss, Ss, Ds, Rp, Rp, Rp, Rp, Rp, Rp, Hh, Mm, Qxu, Qxu, Cud, Cud, Cud, Hh, Hh, Mm, Mm, Mm, Mm, Mm
Gll^Fmw, Gll^Emf, Gll^Em, Gll^Fmw, Ss^Fmw, Ss, Ds^Es, Ds^Es, Ds, Ds, Ss, Gs, Gll^Fmw, Ss, Ss, Ss, Ds^Vh, Re, Sm, Ss, Ss, Ss, Ss, Chs, Rp, Rp, Gs^Es, Rp, Rp, Rp, Rp, Rp, Rp^Edt, Chr, Ds, Gs, Ds, Rp, Ss, Ds, Rp^Dr, Sm, Sm, Sm, Ss, Ss, Gg, Gs, Rp, Qxu, Rp, Rp, Hh, Mm, Mm, Hh^Vhcr, Hh, Qxu, Qxu, Qxu, Mm, Mm, Mm, Mm, Mm, Mm, Mm
Gll^Fmw, Gll^Fmf, Gll^Fp, Gll^Fp, Gll^Fmf, Ss, Ss^Fmw, Re, Re, Ss, Gll^Fmw, Gd^Fmw, Gll^Emf, Gll^Fmw, Gll^Fp, Ss, Ss, Ss, Sm, Ss, Re, Re, Re, Re, Rp, Rp, Rp^Edt, Gg, Rp, Re, Gg, Rp^Vhcr, Rp, Rp, Ss, Ss, Ss, Ss, Ss, Ss, Ds, Chr, Ds, Ss, Ss, Ss, Ds, Gs^Es, Gs, Qxu, Qxu, Re, Hhd, Mm, Mm, Mm, Mm, Hh, Mm, Mm, Mm^Vhhr, Mm, Hh, Hh, Mm, Mm, Mm
Gll^Fp, Gll^Fdw, Gll^Fdw, Gll^Fdw, Gll^Fmf, Ss^Fmf, Ss^Fp, Ss, Re, Re^Fp, Gll^Fp, Ss^Fp, Gll^Em, Gll^Fp, Ss, Ss, Ss, Ss, Sm, Re, Re, Ss, Qxu, Chr, Rp, Rp, Rp, Rp, Rp, Re^Es, Gs, Rp, Rp^Dr, Ds, Rp, Ss, Ds, Ds, Ds, Ds, Ds, Ds, Ss, Ds, Ss^Bw\r, Ds, Ds, Rp^Vhcr, Gs, Rp, Qxu, Re, Hhd, Hhd, Mm, Mm, Mm, Mm, Mm, Mm, Mm, Mm, Mm, Hh, Mm, Mm, Mm
Ss, Gll^Fmf, Gll^Fp, Ss, Gd^Fetd, Ss^Fp, Ss^Fp, Ss, Ss, Gs, Ss^Edb, Gll^Fp, Ss^Fmw, Ss, Ss, Re, Gg, Re^Edb, Rp, Ss, Ss, Ss, Qxu, Chr, Chr, Rp^Es, Gg, Qxu, Rp, Gs, Rp, Rp^Es, Rp, Rp, Re, Rp, Re, Rp^Xo, Rp, Ds, Ss, Ss, Ss, Ss, Ss, Ds, Rp, Rp^Edt, Rp, Rp, Rp, Chr^Dr, Chr, Hhd, Hh, Mm, Mm, Mm, Mm, Mm, Mm, Mm, Mm, Mm, Hh, Mm, Mm
Ss, Ss, Gll, Ss, Gs, Ds, Gs, Re, Rp, Gs, Ds^Edb, Re, Rb, Rb, Rb^Es, Gs, Rp^Es, Re^Es, Re, Re, Ss, Ss, Qxu, Chr, Rp, Gg, Rp^Es, Gg, Rp, Gs, Rp, Rp, Ds^Es, Re, Sm, Re^Es, Rp, Re, Ds, Ds, Ss, Ss, Re, Ss, Ds, Ss, Ss^Bw/r, Re, Chr, Chr, Chr, Chr, Rp, Chr, Rp, Hh, Mm, Mm, Mm, Mm, Mm, Mm, Mm^Vhh, Mm, Mm, Mm, Mm
Ss, Gll, Gll, Gs, Ss, Gg, Gg^Edt, Rp, Ds, Ss, Ss^Edb, Ss, Ss^Bw|r, Ss, Ss, Gg, Rp, Ss, Ss, Re, Rp, Re, Re, Re, Rp^Edt, Rp, Qxu, Rp^Vhcr, Rp, Re, Sm, Rp, Ss, Ds, Ss, Sm, Ss, Ss, Ss, Ss^Bw\r, Rp^Es, Re, Re^Xo, Ds, Rp, Ds, Ss, Rp, Chr, Chr, Chr, Re, Qxu, Chr, Gs^Vhcr, Hhd, Hhd, Mm, Mm, Hh, Hh, Mm, Mm, Mm, Mm, Mm, Mm
Ss, Ss, Ss^Edt, Ss^Edt, Ss, Ss^Edt, Gs^Edt, Rp, Ss, Ss, Ss, Wwrg, Ss^Bw|r, Ss, Gg, Gs^Edb, Ss, Ss, Ss, Ss, Re, Rp^Es, Re, Re, Rp, Gs, Gs, Qxu, Rp, Rp, Ss, Ss, Ss, Ds, Ss, Ss, Ss, Ss, Ss, Ds, Gg^Fp, Re, Gs, Rp, Ss, Gg, Ss, Ds, Sm^Es, Gg^Dr, Rp, Rp, Qxu, Gs, Gs^Es, Hhd, Hh, Hh, Mm, Mm, Mm, Hh, Hh, Mm, Mm, Mm, Mm
Ss, Wwrg, Wwrg, Ss, Sm, Re, Re, Re, Re, Ss, Wog, Wwrg, Ss^Bw\, Ss, Gs, Gs, Re^Xo, Ss, Ss, Ss, Ss, Ds, Ss, Chr, Rp, Gs^Es, Gg, Gs, Chs, Ds, Ss, Ss, Ss, Ss, Ss, Sm, Gg^Fp, Ss, Ds, Gg^Fp, Hhd^Fp, Rp^Dr, Gll^Fp, Gg^Fp, Ss^Fp, Ss, Ss, Ss, Ds, Gg, Rp, Gs^Edt, Qxu, Gg, Gg^Es, Rp, Hh, Mm, Mm, Mm, Mm, Mm, Mm, Mm, Mm, Mm, Mm
Wog, Ss, Wwrg, Wwf, Ce, Ce, 3 Ket, Ce, Re, Ss, Wog, Wog, Ss, Re, Re, Ss, Ss, Ss, Ss, Ss, Ss, Re, Sm, Chr, Chr, Rp, Chs, Chs, Ss, Ss, Ss^Fp, Ds, Ss, Ss, Ss, Ss, Gll^Fp, Gll^Fp, Hhd, Ds^Fp, Hh, Hh^Fp, Mm, Hh^Fp, Hh^Fp, Ss, Hh, Ss^Fp, Ds^Fp, Ds, Gs, Rp, Gg, Gs^Es, Gs^Es, Hh, Hh, Mm, Mm, Mm, Hh, Mm, Mm, Mm, Mm^Vc, Mm, Mm
Wog, Wwg, Wwg, Wwf, Re, Ce, Ce, Ce, Re, Re, Ds, Ds, Gs, Ds, Ss, Ss, Wwg, Ss, Wwrg, Wwrg, Re^Es, Re, Sm, Ss, Ss, Chr, Ss, Ss, Ss, Ss, Gll^Fp, Gll^Fp, Gs^Fp, Ss, Gll^Fp, Ss, Hhd^Fp, Hhd^Fp, Hh, Hh, Mm, Hh, Mm, Mm, Mm, Hh, Hh, Hh^Fp, Hhd^Fp, Gll^Fp, Gs, Gg, Rp, Gs, Rp^Dr, Hhd, Mm, Mm, Mm, Hh, Hh, Hh, Mm, Mm, Mm, Mm, Mm
Ss, Wog, Wwg, Wwg, Ss, Re^Es, Rp, Re, Ss, Ss, Ds, Gg, Ds, Ss, Ss, Wog, Wwg, Wwrg, Wog, Ss, Re, Ss, Ss, Ss, Ss, Ss, Ss, Ss, Chr, Chr, Gs^Fp, Chs, Ss, Ss^Fp, Gll^Fp, Gll^Fp, Hhd^Fp, Hhd, Hhd, Mm, Mm, Mm, Mm, Mm, Mm, Mm, Mm, Hh, Hhd^Fp, Gll^Fp, Gg^Fp, Gs^Vhcr, Gs^Dr, Rp, Hhd, Hhd, Mm, Mm, Mm, Mm, Mm, Mm, Mm, Mm, Mm, Mm, Mm
Ss, Wog, Ss, Ss, Ss, Re, Rp, Re^Es, Ss, Ss, Gs, Gs, Ss, Ss, Wog, Wog, Ss, Wwg, Wog, Ss, Re, Ss, Ss, Ss, Ss, Ss, Rp, Chr, Gs, Gs^Fp, Gs^Fp, Chs, Rp, Chs, Rp, Hhd, Rp, Hhd, Hh, Hh, Hh, Mm, Hhd, Mm, Mm, Mm, Mm, Hhd, Hhd, Hhd^Fp, Rp^Fp, Rp^Fp, Gg, Rp, Hh, Hh, Mm, Mm, Mm, Mm, Mm, Mm, Mm, Mm, Mm, Mm, Mm
