Gll^Fds, Gll^Fds, Gll, Gs, Gs, Gg, Rb, Re, Gg, Gg, Gll, Gg, Gll^Fms, Gll^Fp, Gs^Fp, Gs^Fp, Gll^Fp, Gll^Fp, Gs^Fp, Gs^Fp, Gs^Fms, Hh^Fds, Hh, Hh, Hhd, Hhd, Hhd, Hhd, Hh, Mm, Mm, Mm, Mm, Mm
Gs^Fds, Gll^Fds, Gg, Gs, Gs, Gg, Rb, Re, Gg, Gd, Gg, Gll, Gll^Fms, Gll^Fms, Gll^Fp, Gs^Fp, Gll^Fp, Gll^Fp, Gs^Fp, Gs^Fms, Gs^Fms, Hh, Hh^Fds, Hh, Hh, Hh, Hh, Hh, Hh, Mm, Mm, Mm, Mm, Mm
Hh, Hh^Fds, Hh, Gg, Gg, Gg, Rd, Gd, Gg, Gll, Gll^Fp, Gll, Gs^Fp, Gll^Fp, Gll^Fp, Gll^Fp, Gll, Gll, Gs^Fms, Gs^Fms, Gs^Fms, Gs^Fms, Gs^Fms, Hh, Hh^Fds, Hh, Gg, Gg, Hh, Mm, Mm, Mm, Mm, Mm
Hh^Fds, Hh^Fds, Gll^Fds, Gll, Gg, Re, Gs, Gs, Gg, Gs^Fp, Gll^Fms, Gs^Fp, Gs^Fms, Re^Gvs, Re^Gvs, Gll^Fp, Gs^Fp, Gll^Fms, Hh, Hh, Gll^Fms, Gll^Em, Gs^Fms, Hh^Fds, Gg, Gs, Gs, Gg^Vh, Hh, Mm, Mm, Mm, Mm, Mm
Gs^Fds, Gs^Fds, Gll, Gll, Gg, Rb, Gg, Gg, Gll, Gll^Fp, Gll^Fms, Gs^Fms, Gll, Re^Gvs, Gg^Vl, Re^Gvs, Gs^Fms, Gll^Fp, Gll, Gg, Gg, Gll^Fms, Gll^Fms, Gll^Fms, Gll^Fms, Gd, Gs, Hh, Mm, Mm, Mm, Mm, Mm, Mm
Gll^Fds, Gll^Fds, Gll^Fds, Gg^Vh, Gg, Re, Re, Gg, Gg^Es, Gg, Gll, Gll, Gll^Fds, Gll, Hh, Gs, Hh, Gs^Fms, Gll, Gg^Vh, Gg, Gll^Fms, Gll, Gll^Fms, Gll^Fms, Gg, Gs, Hh, Mm, Mm, Mm, Mm, Mm, Mm
Gg, Gll, Re^Gvs, Re^Gvs, Re^Gvs, Gg, Re, Gg, Gg, Gg, Gs, Gs^Fms, Gs, Gs^Fms, Gs^Fms, Hh^Fms, Gs^Fds, Gll^Fms, Gll^Fds, Gll, Gll^Fms, Gs^Fms, Hh, Gg^Vl, Gll^Fds, Gs^Fms, Gg, Hh, Mm, Mm, Mm, Mm, Mm, Mm
Gg, Gg, Gg, Re^Gvs, Gs, Gg, Gs, Rd, Rb, Gg, Gs, Gg, Gg, Gg, Gg, Gs^Fms, Gs^Fms, Hh^Fms, Gs^Fms, Gll^Fms, Gll, Gs^Fms, Gs^Fms, Gg, Gs^Fds, Gll^Fms, Gg, Hh, Hh, Mm, Hhd, Mm, Mm, Mm
Gs, Gd, Gg, Gg, Gg, Gs, Gs^Eff, Gg, Rb, Gg, Re, Gg, Gg, Gll^Fds, Gll^Fms, Gll^Fds, Gll, Gll^Fms, Gll^Em, Gll^Fds, Gs^Fds, Gs^Fms, Gll^Fms, Gll^Fds, Gll^Fms, Gll, Gll^Fms, Gg, Gg, Hh, Hhd, Hhd, Mm, Mm
Gs, Gg, Gs^Fds, Gll, Gll^Fds, Gg^Eff, Re^Gvs, Gg^Eff, Gg^Eff, Re, Gg, Re, Re, Gll, Gll, Gg, Gll^Fds, Gll^Fms, Gs^Fms, Gll^Fds, Gll, Gll^Fms, Gll, Gll^Fms, Gs^Fms, Gll^Fms, Gs^Fms, Gll^Fms, Gll^Fms, Gg, Gg, Hh, Mm, Mm
Gg, Gll, Hh^Fds, Hh, Gll^Fds, Gll^Fds, Re^Gvs, Re^Gvs, Re^Gvs, Gd^Eff, Gs^Eff, Rb, Rb, Gg, Gs, Gll^Fms, Gll, Gs^Fms, Gll^Fds, Gg, Gs^Fds, Gll, Hh, Hh, Gs^Fms, Re^Gvs, Gg^Vh, Re^Gvs, Gs^Fms, Gs, Hh, Hh, Mm, Mm
Gll^Fds, Gll^Fds, Gg, Hh, Gs^Fds, Gll^Fds, Gg, Gg^Vwm, Gll^Fds, Gg^Eff, Gg^Efm, Gg, Re, Gg, Gg, Gll, Gll^Fds, Gll^Fms, Gll^Fms, Gg, Gs^Vh, Gg, Hh, Gs^Fds, Gs^Fms, Re^Gvs, Gll, Re^Gvs, Gll^Fds, Gs^Fms, Hh, Mm, Mm, Mm
Gll^Fds, Gll^Fds, Gll, Gll^Fds, Hh, Gs^Fds, Gll, Gll, Gll, Gg, Gg^Efm, Gg, Re, Rb, Gg, Gs^Fds, Gll, Gs^Fms, Gg, Gs, Gg, Gs^Fds, Gll^Fds, Hh, Gs^Fms, Gll^Fds, Gg, Gll^Fms, Gg, Gll, Hh, Mm, Mm, Mm
Gll, Gll, Gll^Fds, Gll^Fds, Hh, Hh, Gll^Fds, Gll^Fds, Hh, Gg, Gg, Gg, Re, Re, Gs, Gs, Gll^Fds, Gll^Fms, Gll^Fms, Gll, Gs^Fms, Gg, Gll, Gll, Gll^Fms, Gs, Gg^Vh, Gg, Gs^Fds, Gg, Gg, Hh, Mm, Mm
Gs^Fds, Gs^Fds, Gll^Fds, Gg, Gll^Fds, Hh, Gs^Fds, Gll^Fds, Hh, Gs, Rb, Re, Gg, Gs, Gd, Gs, Gll^Fms, Gll^Fds, Gll^Fds, Hh, Gs^Fds, Gll^Fds, Gll^Fms, Gll^Fds, Gll^Fms, Gll^Fds, Gll^Fms, Gg, Gll^Fms, Gll, Gg, Hhd, Mm, Mm
Gs^Fds, Gs^Fds, Gll, Gll^Fds, Gll^Fds, Gll^Fds, Re^Gvs, Gll^Fds, Gg, Gs, Re, Gg, Ch, Gg, Gg, Gg, Gll, Gs^Fms, Gll^Fms, Gll^Fms, Gll^Fds, Gs^Fds, Hh, Gs^Fms, Hh^Fds, Gll^Fms, Gll^Fms, Gll^Fds, Gll, Gg, Gg, Hhd, Mm, Mm
Gs^Fds, Gll^Fds, Gll^Fds, Gll^Fds, Gg, Gg^Vh, Re^Gvs, Re^Gvs, Re^Gvs, Gg, Re, Ch, 1 Kh, Ch, Gg, Gg, Gs^Fds, Gs^Fds, Gll^Fms, Gll, Gll^Fms, Gs^Fms, Gll^Fds, Gll, Gll^Fms, Gll^Fms, Gll^Fds, Gll^Fds, Gs, Gg, Hh^Fds, Hh, Mm, Mm
Gg, Gll, Gll^Fds, Gll^Fds, Gg, Gg, Hh, Gs^Fds, Gg, Gg, Rd, Ch, Ch, Ch, Gg, Gg, Gg, Gg, Hh, Gg, Gg, Gll, Gs^Fds, Hh, Gs^Fms, Gll, Gg, Gg, Gs, Hh^Fds, Hh^Fds, Mm, Mm, Mm
Gg, Gg, Gg, Gll^Fds, Gg, Gs, Gg, Hh, Gg, Gg, Re, Re, Gg, Gg, Gs, Gg^Es, Gs, Gg, Hh, Hh, Re^Gvs, Gg^Vh, Gll, Gs^Fds, Gll^Fms, Gg, Gs^Fds, Gs^Fds, Gg, Hh^Fds, Mm, Mm, Mm, Mm
Gg, Gll, Gll^Fds, Gll, Gll^Fds, Gs, Gg, Gg, Gs, Gs, Gg, Rb, Rb, Gs, Gs, Gs, Gg, Gg, Gg, Gg, Re^Gvs, Re^Gvs, Gll, Gll^Fms, Gg, Gg, Gg, Hh^Fds, Gg, Hh, Mm, Mm, Mm, Mm
Gg, Gll, Gg, Gg, Gg, Gg, Gs, Gll^Fds, Gs, Gs, Gg^Efm, Gg, Gg, Re, Re, Gg, Ch, Ch, Ch, Gg, Gg, Gg, Gs^Fds, Hh, Gg, Gg, Gg, Gs, Gg, Hh, Hhd, Mm, Mm, Mm
Gg, Gg^Es, Gg, Gg, Gs^Fds, Gg, Gg, Gg, Gg, Gg, Gg, Gg, Gg, Gg, Re, Re, Ch, 2 Kh, Ch, Gg, Gg, Gg, Gll, Gg, Gll^Fds, Gs, Gs, Gd, Gg, Gg, Hh, Mm, Mm, Mm
Gg, Gs, Gg, Gs^Fds, Hh^Fds, Gs^Fds, Gg^Vl, Gg, Gg, Gs^Fds, Gg, Gs^Efm, Gs, Gs, Gg, Re, Rb, Ch, Gll, Gg, Gs^Fds, Gg, Gll^Fds, Gg, Gg, Hh, Gs^Fds, Gg, Gg, Hh, Gg, Hhd, Mm, Mm
Gg, Gs, Gg, Hh^Fds, Gs^Fds, Re^Gvs, Re^Gvs, Gs^Fds, Hh, Gs^Fds, Gg, Gg, Gs, Gd, Gg, Re, Re, Gll^Fds, Gll^Fds, Gg, Gg, Hh, Gg, Gg, Gg, Gg, Gg, Gg, Gg, Gg, Hh, Hh, Mm, Mm
Gs, Gs, Gg, Gs^Fds, Gg, Re^Gvs, Gg, Gs^Fds, Gg, Gg, Gg^Efm, Gg^Efm, Gg, Gg, Gg, Gs^Fds, Re, Re, Re, Gll, Gg, Gs, Gs, Gs^Fds, Gg, Hh, Gg, Gg, Hh, Hh, Hh, Mm, Mm, Mm
Gg, Gs, Gs, Gg, Gs^Fds, Hh, Gg, Gg, Gg, Gg, Gg, Gg, Gg, Gg, Rd, Rb, Gg, Gs^Fds, Gg, Re, Rb, Gg, Gs, Gd, Gs, Gs, Hh, Hh, Hh, Mm, Mm, Mm, Mm, Mm
Gg, Gg, Gg, Gg, Gg, Hh, Gg, Gg^Es, Gs, Gs, Gg, Gg, Re, Re, Gg, Gs, Gs, Gg, Gg, Gs, Gs, Rb, Rb, Gg, Gg^Efm, Gg, Gg, Gg, Hh, Mm, Mm, Mm, Mm, Mm
Hh, Hh, Gg, Gg, Gg, Gg, Gg, Gs, Gd, Gs, Gg, Rb, Gs^Fds, Gs^Fds, Gg, Gs, Gll, Gg, Gs^Fds, Gg, Gs, Gg, Gg, Re, Gg, Gg^Efm, Gg, Hh, Gg, Hh, Hh, Mm, Mm, Mm
Hh, Hh, Gg, Gg, Gg, Gs, Gs, Gg, Gd, Gg, Rb, Rb, Gll^Fds, Gll^Fds, Gg, Gg, Gg, Gll^Fds, Gll^Fds, Gll, Gg^Efm, Gs, Gg, Re, Re, Gg, Gs, Gg, Ch, Gg, Hh^Vhh, Mm, Mm, Mm
Gg, Gg, Gs, Gs, Gg, Gg, Gs, Gs, Gg, Gg, Re, Gll^Fds, Gll, Gll, Gg, Gs, Gs, Gg, Gg, Gg, Gg, Gg, Gg, Hh, Re, Gg, Gs, Ch, 3 Kh, Ch, Hh, Mm, Mm, Mm
Gll, Gll, Gll, Gs, Hh, Gg, Gg, Gs, Rd, Re, Gg, Gg, Gg, Gg, Gs, Hh, Hh, Gs, Gg, Gg^Efm, Gg, Hh, Hh, Gg, Gg, Rd, Gg, Ch, Ch, Ch, Mm, Mm, Mm, Mm
Gll^Fds, Gll^Fds, Gs^Fds, Hh^Fds, Gll^Fds, Gll, Rb, Rb, Gs^Fds, Hh, Hh, Gg, Gg, Gg, Gd, Hh, Gs, Gg^Efm, Gg, Gg, Hhd, Mm, Mm, Hh, Hh^Vhh, Rb, Gg, Hh, Hh, Hhd, Mm, Mm, Mm, Mm
Gs^Fds, Gll^Fds, Gll^Fds, Gll^Fds, Re, Rb, Gll^Fds, Gll^Fds, Gll^Fds, Hh^Fds, Hh, Gg^Efm, Gg, Gg, Gg, Gs, Gs, Gg, Gg, Hh, Gg, Mm, Mm, Mm, Mm, Re, Re, Hh, Mm, Mm, Mm, Mm, Mm, Mm
Gs^Fds, Gll^Fds, Gs^Fds, Gll^Fds, Re, Gll^Fds, Gll^Fds, Gll^Fds, Gll^Fds, Hh^Fds, Hh, Gg, Gg, Gs^Efm, Gs, Gs, Gs, Gg, Gg, Gg, Gg, Mm, Mm, Mm, Hh, Hh, Rb, Hh, Mm, Mm, Mm, Mm, Mm, Mm
