Gg, Gg, Gg, Gg, Gs, Gg, Gg, Gg, Gg, Gg, Gs, Gs, Gd, Gd, Gd, Gg, Gg, Rd, Gg, Gg, Ds, Hhd, Hhd, Re, Hhd, Mm, Mm, Mm, Mm, Mm, Mm, Mm, Mm, Mm, Mm, Mm, Mm, Mm, Mm, Mm, Mm, Mm
Gs, Gg, Gs, Gs, Gg, Gs, Gg, Hh, Hh, Gg, Hh, Gg, Hh, Gs, Gg, Gg^Es, Gg, Rd, Gg^Vo, Ds, Ce, Hhd, Hhd, Re, Hhd, Mm, Mm, Mm, Mm, Mm, Mm, Mm, Mm, Mm, Mm, Mm, Mm, Mm, Mm, Mm, Mm, Mm
Gs, Gs, Gg, Gd, Gd^Gvs, Gg, Gg^Eff, Hh, Mm, Hh, Mm, Hh, Hh, Gg, Gg, Gs, Gs, Gg, Gg, Ce, 2 Ke, Ce, Ds, Rd, Hhd, Hhd, Hhd, Mm, Mm, Hhd, Hhd, Hhd, Mm, Mm, Mm, Mm, Mm, Mm, Mm, Mm, Mm, Mm
Gs, Gg, Gg^Vwm, Gd^Gvs, Gs^Gvs, Gd^Gvs, Gg^Eff, Gg^Eff, Hh, Mm, Mm, Mm, Hh, Gg^Vh, Gs, Gs, Gd, Gd, Gg, Ce, Ce, Ce, Rd, Rd, Dd, Ds, Hhd, Hhd, Hhd, Hhd, Hhd^Vhh, Hhd, Mm, Mm, Mm, Mm, Mm, Mm, Mm, Mm, Mm, Mm
Gs, Gs, Gg^Gvs, Gs^Gvs, Gs, Gs, Gg^Eff, Gg^Eff, Gg, Hh, Hh, Mm, Hh, Hh, Gg, Gs, Gd, Gd, Gd, Gg, Gg, Gg, Re, Gg^Vo, Rd, Dd, Rd, Hhd, Hhd, Hhd, Hhd, Hhd, Mm, Mm, Mm, Mm, Hhd, Hhd, Hhd, Mm, Mm, Mm
Gg, Gg, Gg, Gs, Gs^Eff, Gs^Es, Gg, Gg, Hh, Hh, Gg, Hh, Gs, Gg, Gg, Gd, Gg, Gd, Gg, Gg, Hh, Gg, Re, Gg^Esd, Gs, Ds, Ds, Rd, Ds, Dd, Dd, Hhd, Hhd, Hhd, Hhd, Mm, Hhd, Hhd^Vh, Hhd, Mm, Mm, Mm
Gg, Gg, Gg^Eff, Gg^Eff, Gs, Gg, Gg, Gg, Gg^Vl, Gg, Gg, Gg, Gg, Gs, Gg, Gs, Gg, Hh, Gg, Hh, Gs, Gg, Rd, Gs, Gs, Gs, Ds, Ds, Rd, Ds, Ds, Rd, Ds, Rd, Hhd, Hhd, Hhd, Hhd, Hhd, Mm, Mm, Mm
Gg, Gs, Gs, Gs, Gs, Gs, Gg, Gg, Gs, Gg, Gd, Hh, Gg, Hh, Hh, Gg, Hh, Hh, Gg, Gs, Gs, Gg, Rd, Gg, Gg, Rd, Rd, Ds, Rd, Gg^Vh, Gd, Dd^Esd, Rd, Ds, Rd, Ds, Ds, Hhd, Mm, Mm, Mm, Mm
Gd, Gd, Gs, Gg, Gs, Gs, Ce, Ce, Ce, Gd, Gd, Gg, Gs, Gg, Gg, Gg, Hh, Hh, Hh, Gg^Vh, Gg, Gs, Rd, Gg, Gd^Esd, Gs, Ds, Dd, Dd, Gs, Ds, Ds, Ds, Rd, Dd, Ds, Hhd, Hhd, Hhd, Mm, Mm, Mm
Gg, Gd, Gg, Gs, Gg, Gg, Ce, 3 Ke, Ce, Gg, Gs, Gs, Gg, Gg^Vhr, Gg, Gg, Mm, Mm, Mm, Hh, Gg, Gg, Rd, Gg, Gd, Gd, Gd, Dd, Dd, Rd, Ds, Rd, Ds, Dd, Ds, Hhd, Hhd, Hhd^Vhh, Hhd, Mm, Mm, Mm
Gg, Gg, Gg, Gg^Vhr, Gg, Gg, Gg, Ce, Gg, Gg, Gg, Gs^Es, Gg, Hh, Hh, Hh, Hh, Mm, Mm, Mm, Hh, Gg, Re, Gs, Gd, Gd^Vh, Gg, Gs, Ds, Ds^Esd, Rd, Dd, Ds, Rd, Ds, Rd, Hhd, Hhd, Hhd, Mm, Mm, Mm
Rd, Rd, Rd, Re, Re, Re, Rd, Rd, Rd, Gg, Rd, Gg, Gg, Gg, Gg, Hh, Gg, Hh, Hh, Hh, Gg, Hh, Gg, Rd, Gs, Gs, Gd, Ds, Gs, Ds, Ds, Rd, Dd, Dd, Ds^Es, Dd, Rd, Hhd, Mm, Mm, Mm, Mm
Gs, Gg, Gs, Gg, Gg, Gll, Gg, Gg, Gg, Re, Gg, Rd, Re, Re, Rd, Gg, Re, Gg, Gg, Gg, Gg, Hh, Gg, Rd, Re, Gd, Gd, Gg, Gg, Gs, Ds, Rd, Rd, Ds, Ds, Dd, Ds, Hhd, Hhd, Hhd, Hhd, Hhd
Gg, Gs, Gll, Gll^Fds, Gll^Fms, Gll^Fds, Gll^Fds, Gs^Fds, Gg, Gg^Vhr, Gg, Gd, Gs, Gg, Gg, Rd, Gs, Re, Re, Re, Re, Gs, Gs, Gs, Re, Gg, Gg, Gg^Vhh, Gd, Gs, Ds, Gd, Ds, Rd, Rd, Dd^Esd, Ds, Ds, Rd, Rd, Rd, Rd
Gll, Gll, Gs^Fds, Gll^Fds, Gs^Fds, Gll^Fms, Gll^Fds, Gll^Fds, Gll, Gg, Gs^Fds, Gg, Gs, Gs, Hh, Gs, Gd, Gs, Gg, Gg, Gg, Rd, Rd, Re, Rd, Gg, Gd, Gg, Gd, Gg, Gg, Gd, Ds, Rd, Dd, Dd, Hhd, Ds, Hhd, Hhd, Hhd, Hhd
Gll^Fds, Gll, Gll^Fms, Gs^Fms, Gll^Vl, Gs^Fds, Gll^Fms, Gll^Fds, Gll^Fds, Gs^Fds, Gll^Fds, Gll, Gs^Fds, Gg, Hh, Gs, Gd, Gs, Gg, Gg^Vl, Gg, Gg, Gg, Gg, Rd, Gs, Gs, Gd, Gg, Gg, Gs, Ds, Gg^Esd, Ds, Rd, Hhd, Hhd, Hhd, Hhd, Mm, Mm, Mm
Gs^Fds, Gll^Fds, Gll^Fms, Gll^Fds, Gs^Fds, Gll^Fds, Gs^Fms, Gll^Fms, Gs^Fds, Gll^Fds, Gll^Fds, Gg, Gg, Gg, Gg, Gg, Gs, Gg, Gg, Gg, Gg, Gs, Gs^Es, Gs, Gg, Re, Re, Gs, Gg, Gd, Gd, Gs, Gg, Rd, Rd, Rd, Hhd, Mm, Mm, Mm, Mm, Mm
Gg, Gs^Fds, Gs^Fds, Gs^Fds, Gs^Fp, Gs^Fds, Gs^Fds, Gs^Fds, Gs^Fds, Gll^Em, Gll, Gg, Gs^Fds, Gg, Gs, Gs, Gg, Gll^Fds, Gg, Gd^Fms, Gd, Gd, Gg, Gg, Gg, Gg, Gg, Re, Re, Gd, Gs, Gs, Gs, Gg, Ds, Hhd, Hhd, Hhd, Mm, Mm, Mm, Mm
Gg, Gg, Gll^Fds, Gll^Fds, Gll^Fp, Gs^Fds, Gs^Fds, Gs^Fds, Gg, Gll^Fds, Gg, Gg, Gg, Gs, Gs, Gs^Fds, Gg, Gll, Gs^Fms, Gll, Gg, Gd, Gg, Gg^Vh, Gd, Gg, Gd, Gg, Re, Gg, Gg^Vh, Gs, Ce, Gs, Gg, Ds, Rd, Ds, Mm, Mm, Mm, Mm
Gs^Fds, Gg, Gll^Fds, Gll^Fms, Gll^Fms, Gll^Fp, Gs^Fds, Gs^Fds, Gs^Fds, Gg, Gd, Gg, Gg^Vh, Gs, Gg, Gg, Gll^Fds, Gll, Gll, Gs^Fms, Gll, Gll, Gll, Gs^Fp, Gg, Gd, Gd, Gd^Fp, Re, Gg, Gg, Ce, 1 Ke, Ce, Gg, Ds, Hhd, Hhd, Mm, Mm, Mm, Mm
Gs^Fds, Gll^Fds, Gs^Fms, Gs^Fds, Gll^Fms, Gs^Fds, Gll^Fms, Gll^Fds, Gs^Fds, Gg, Gd, Gd, Gg, Gg, Gll, Gll^Fds, Gll^Fms, Gll^Fms, Gll^Fms, Gll^Fms, Gll^Fms, Gll^Fp, Gll, Gg, Gll, Gg, Gg, Gg, Gg, Re, Rd, Ce, Ce, Ce, Gg, Hhd, Hhd, Hhd, Hh, Mm, Mm, Mm
Gll^Fds, Gs^Fms, Gll^Vh, Gs^Fds, Gll^Fds, Gll^Fms, Gll^Fds, Gll, Gg, Gg, Gg, Gs, Gg, Gg, Gll^Fds, Gll^Fds, Gs^Fds, Gll^Vl, Gs^Fms, Gll^Fms, Gll^Fp, Gll^Fp, Gs^Fp, Gll^Fp, Gs^Fp, Gll^Fp, Gll^Fp, Gll^Fp, Gll, Gg, Gg, Rd, Rd, Gg, Hh, Mm, Hh, Hh^Vh, Hh, Mm, Mm, Mm
Gll^Fds, Gll^Fds, Gs^Fds, Gll^Fds, Gll^Fds, Gll^Em, Gg, Gg, Gs, Gg, Gll, Gll^Fds, Gll^Fms, Gll^Fds, Gll^Fms, Gs^Fds, Gll^Fds, Gll^Fds, Gll^Fp, Gs^Fp, Gll^Fp, Gs^Fp, Gs^Fp, Gs^Fp, Gs^Fp, Gll^Vh, Gll^Fp, Gll^Fp, Gs^Fp, Gs, Gd, Gs, Re, Gd, Gd, Hh, Mm, Hh, Hh, Mm, Mm, Mm
Gll, Gll, Gll, Gll, Gll^Fds, Gg, Gg, Gs, Gs^Fds, Gg, Gg^Vl, Gll, Gll^Em, Gs^Fms, Gs^Fds, Gs^Fp, Gll^Fds, Gll^Fds, Gs^Fds, Gll^Fp, Gll^Fp, Gll^Fp, Gs^Fp, Gll^Fms, Gll^Fp, Gll^Fp, Gs^Fp, Gll, Gg, Gg, Gd, Gd, Re, Gd^Es, Gs, Gg, Hh, Mm, Mm, Mm, Mm, Mm
Gg, Gg, Gg, Gg, Gg, Gg, Gd, Gll^Fds, Gll^Fds, Gll^Fds, Gll^Fms, Gll^Fds, Gll^Fms, Gs^Fds, Gll^Fms, Gs^Fds, Gll^Fds, Gll^Fds, Gll^Fms, Gll^Fds, Gs^Fms, Gs^Fp, Gll^Fp, Gll^Fp, Gll^Fms, Gll^Fp, Gs^Fp, Gs^Fp, Gll, Gg, Gll, Gg, Gg, Rd, Gs, Gg, Gg, Hh, Mm, Mm, Mm, Mm
Gg, Gg, Gg, Gs^Fp, Gs, Gs^Es, Gd, Gg, Gll, Gll^Fds, Gs^Fds, Gll, Gll, Gll^Fms, Gs^Fms, Gs^Fds, Gs^Fms, Gll^Fms, Gll^Fms, Gll^Fp, Gs^Fms, Gs^Fms, Gs^Fms, Gs^Fms, Gs^Fp, Gll^Fms, Gll^Fp, Gll^Fp, Gll^Fp, Gll^Fp, Gll, Gll, Gg, Rd, Re, Gs, Hh, Hh, Mm, Mm, Mm, Mm
Gg, Gg, Gs, Gs, Gs, Gd, Gg, Gg, Gg, Gll^Fds, Gg, Gll, Gg, Gll^Fds, Gll, Gll^Fms, Gll^Fms, Gll^Fms, Gll^Fms, Gs^Fms, Gs^Fms, Gs^Fp, Gs^Fp, Gs^Fp, Gs^Fp, Gs^Fp, Gs^Fp, Gs^Fp, Gs^Fp, Gs^Fp, Gg, Gg, Gg, Gg, Re, Gs, Hh, Hh, Mm, Mm, Mm, Mm
