Mm, Mm, Mm, Mm, Mm, Hh, Hh, Hh, Gs, Gs, Hh, Mm, Mm, Mm, Mm, Hh, Hh, Gs, Gd, Gd, Gs, Gs, Hh, Hh, Mm, Mm, Mm, Mm, Mm, Mm, Mm, Mm, Mm, Hh, Hh, Mm, Hh, Mm, Mm, Mm, Mm, Hh, Mm, Hh, Mm, Hh
Mm, Mm, Mm, Mm, Mm, Hh, Hh, Hh, Gg, Gs, Hh, Mm, Mm, Mm, Mm, Hh, Hh, Gs, Gs, Gs, Gg, Gs, Hh, Hh, Mm, Mm, Mm, Mm, Mm, Mm, Mm, Mm, Mm, Hh, Hh, Mm, Hh, Hh, Hh, Mm, Mm, Mm, Mm, Mm, Mm, Mm
Mm, Mm, Mm, Mm, Hh, Gs, Gs, Gs, Gg, Gg^Vo, Gs, Hh, Hh, Hh, Hh, Hh, Gg, Gg, Gs^Fds, Gll^Fds, Gg, Gg, Gg^Vo, Hh, Mm, Mm, Mm, Mm, Mm, Mm, Hh^Fds, Hh^Fms, Hh^Fds, Hh, Hh, Hh, Hh, Gs, Hh, Mm, Mm, Mm, Mm, Mm, Mm, Mm
Mm, Mm, Mm, Mm, Gd, Hh, Gg, Gg, Gg, Gd, Gd, Gd, Gd, Gd, Gs, Gs, Gs, Gg, Gll, Gll^Fds, Gs, Gs, Gs, Hh, Hh, Hh, Hh, Hh, Hh, Hh^Fms, Gll^Fds, Gll^Fms, Gs, Gs, Gd, Gs, Gs, Gd, Hh, Mm, Co, Mm, Mm, Mm, Mm, Hh
Mm, Mm, Hh, Hh, Gd, Gs^Es, Gd, Gs, Gs, Gs, Hh^Fms, Hh, Gll, Gll, Gll^Fms, Gs, Gs, Gg^Vo, Co, Co, Co, Gg, Gg, Gs, Gs^Fds, Gs, Hh, Hh, Gs, Gs, Gll, Gll^Fms, Gll, Gll^Fds, Gs, Gs^Fms, Gs^Fds, Gd, Co, Co, 4 Ko, Mm, Mm, Mm, Mm, Mm
Hh, Hh, Gs, Gs, Gd, Gd, Gg, Gs^Fds, Gg, Hh^Fds, Gll^Fds, Gll^Em, Gll^Fms, Gll^Fds, Gs, Gg, Gg, Gg, Co, 3 Ko, Co, Gs, Gs, Gll^Fds, Gll, Gs, Gs, Gs, Hh, Gs^Es, Gs, Gll^Fds, Gll, Gll, Gg, Hh, Hh, Gs, Hh, Co, Co, Co, Hh, Mm, Mm, Mm
Hh, Hh, Gs, Gg, Gg, Gg, Gll^Fms, Gll, Gll^Fds, Gll^Fms, Gll^Fms, Gll^Fds, Gll^Fms, Gll, Gs, Gs^Fms, Gs^Fds, Gs, Gs, Co, Gs, Gs, Gs^Es, Gll^Fds, Gs, Gs, Hh, Gs, Gg, Gs, Gg^Vo, Gs, Hh, Gg, Gg, Gs, Gs, Hh, Gs, Gg, Hh, Hh, Hh, Mm, Mm, Mm
Hh, Hh, Gs, Gg, Gg^Vo, Gs, Gll, Gll, Gll^Fms, Gll^Fds, Gll^Fms, Gs^Fds, Gs, Gs, Gs^Fms, Gs, Gs, Gs, Gg, Gs, Gg, Gg, Gg, Gs, Gg, Hh, Hh, Hh, Gg, Gg, Gg, Gg, Gg, Gg, Gg^Vc, Gs, Hh, Hh, Hh, Gs, Gs, Gs, Gs, Hh, Hh, Hh
Gs, Gs, Gs, Gg, Gs, Gg, Gg, Gll, Gll, Gll^Fds, Gll, Gll, Gll^Fds, Gs, Gs, Gd, Gd, Gg, Gg, Gg, Gg, Gg, Gg, Gg, Gg, Co, Gs, Gs, Gs, Gd, Gd, Gd, Co, Gg, Gg, Gg, Gs, Gs, Gg, Gg, Gg, Gs, Hh, Gs, Gg, Gs
Gs, Gs, Gd, Gg^Es, Gs, Gs, Gd, Gll, Gs^Fms, Gs, Gs, Gs^Fds, Gs, Gs, Gs, Gs, Gs, Gd, Gd, Co, Gs, Gs^Es, Gs, Gg, Gs, Gs, Ds, Ds, Ds, Ds, Gs, Gd, Gs, Gg, Gs, Gg, Gs, Hh, Gd, Gd^Es, Gg, Gg, Gg^Vc, Gg, Gg, Gs
Ds, Ds, Gs, Gs, Ds, Ds, Ds, Gs, Gs, Gs, Gs, Gs, Ds, Ds, Ds, Ds, Ds, Ds, Gs, Gs, Ds, Ds, Ds, Ds, Ds, Ds, Ww, Ww, Ww, Ww, Ds, Ds, Ds, Ds, Ds, Ds, Gs, Gs, Gs, Gd, Gs, Gg, Gs, Gs, Hh, Hh
Gs, Gs, Ds, Ds^Esd, Ds, Ds^Esd, Wwf, Ds, Ds, Ds, Ds, Ds, Ww, Ww, Ww, Ww, Ww, Ww, Ds, Ds, Ww, Ww, Ww, Ww, Ww, Ww, Ww, Ww, Ww, Ww, Ww, Ww, Ww, Ww, Ww, Wwf, Ds, Ds, Ds^Esd, Ds, Ds, Gd, Gd, Hh, Gd, Gs
Ds, Ds, Wwf, Ds, Ww, Ww, Ww, Ww, Ww, Ww, Ww, Ww, Ww, Ww, Wo, Wo, Wo, Ww, Ww, Ww, Ww, Ww, Wo, Wo, Wo, Wo, Ww, Ww, Ww, Ww, Ww, Wo, Wo, Wo, Wo, Ww, Ww, Ww, Ww, Ww, Ds, Gs, Ds, Gs, Gs, Gs
Ww, Wwf, Ww, Ww, Ww, Ww, Wo, Ww, Wo, Wo, Wo, Wo, Wo, Wo, Wo, Wo, Wo, Wo, Ww, Ww, Ds, Ww, Wo, Wo, Wo, Ww, Ww, Ds, Ds, Ww, Wo, Wo, Wo, Wo, Wo, Wo, Wo, Wo, Wo, Ww, Ww, Ds, Ds, Ds, Ds, Ds
Ww, Ww, Wo, Wo, Wo, Ww, Ww, Wo, Wo, Wo, Wo, Wo, Wwf, Wwf, Ds, Wo, Wo, Wo, Wo, Ww, Ds, Ww, Ww, Wo, Wo, Ww, Wwf, Gg, Wwr, Ww, Wo, Wo, Wo, Wo, Wo, Wo, Wo, Wo, Wo, Ww, Ww, Wwf, Ww, Ww, Ww, Ww
Wo, Wo, Wo, Wo, Wo, Wo, Wo, Wo, Wo, Wo, Wo, Wo, Ds, Gs, Gg, Ds, Wo, Wo, Ww, Ww, Wwf, Gg, Wwr, Ww, Wo, Ww, Ww, Ww, Ww, Wo, Wo, Wo, Wo, Wo, Wo, Wo, Wo, Wo, Wo, Wo, Wo, Ww, Wo, Wo, Ww, Ww
Wo, Wo, Wo, Wo, Wo, Wo, Wo, Wo, Wo, Wo, Wo, Ds, Gs, Gg^Vh, Rp, Ds, Wo, Wo, Wo, Ww, Ww, Wwf, Ds, Ww, Ww, Ww, Ww, Ww, Ww, Wo, Wo, Wo, Wo, Wo, Wo, Wo, Wo, Wo, Wo, Wo, Wo, Wo, Wo, Wo, Wo, Wo
Wo, Wo, Wo, Wo, Wo, Wo, Wo, Wo, Wo, Wo, Wo, Ds, Ds, Gd, Rp, Ds, Wo, Wo, Wo, Wo, Wo, Ww, Ww, Ww, Wwf, Ww, Wwf, Ww, Ww, Ww, Wo, Wo, Wo, Wo, Wo, Wo, Wo, Wo, Wo, Wo, Wo, Wo, Wo, Wo, Wo, Wo
Wo, Wo, Wo, Wo, Wo, Wo, Wo, Wo, Wo, Wo, Wo, Wo, Wo, Ds, Wo, Wo^Bw\, Ww, Wo, Wo, Wo, Wo, Wo, Ww, Ww, Wwr, Gg, Ds, Ds, Ww, Ww, Ww, Wo, Ww, Wo, Wo, Wo, Wo, Wo, Wo, Wo, Wo, Wo, Wo, Wo, Wo, Wo
Wo, Wo, Ww, Wo, Wo, Wo, Wo, Wo, Wo, Wo, Wo, Wo, Wo, Wo, Ww, Ww, Ww, Ww, Ww, Wo, Wo, Wo, Ww, Ww, Ww, Ds, Wwf, Ww, Ww, Ww, Ww, Ww, Ww, Ww, Ww, Ww, Ww, Wo, Wo, Wo, Wo, Wo, Wo, Wo, Wo, Wo
Ww, Ww, Ww, Ww, Ww, Ww, Ww, Wo, Ww, Wo, Ww, Ww, Ww, Ww, Ww, Ww, Ww, Ww, Ww, Ww, Ww, Ww, Ds, Ww, Ds, Ds, Ds, Ww, Ds, Ds, Ds, Ds, Ds, Ww, Ww, Ww, Ww, Wo, Ww, Wo, Wo, Wo, Wo, Wo, Wo, Wo
Ds, Ds, Ds, Ds, Ds, Ds, Ds, Ds, Ds, Ds, Ds, Ww, Ds, Ww, Ds, Ds, Ds, Ds, Ds, Ww, Ds, Ds, Gs, Ds, Gs, Ds^Esd, Re, Ds, Gd, Gs, Gs, Gs, Ds, Ds, Ds, Ds, Ds, Ww, Ds, Ww, Ww, Wo, Wo, Wo, Wo, Wo
Gg, Gs, Gg, Gs, Gg, Gs, Gg, Gs, Gs, Gs, Gs, Ds, Ds, Ds, Gs, Gs, Gs, Gs, Gs, Gs, Gs, Gd, Gs, Gg, Gd, Gs, Gs, Rd, Re, Re, Gs, Gs^Efm, Gs^Eff, Gd, Gd, Gs, Gg^Gvs, Ds, Gs, Ds, Ds, Ww, Ww, Wo, Wo, Wo
Gg, Gd^Es, Gg^Efm, Gg^Efm, Gg^Gvs, Gg^Gvs, Gs^Gvs, Gg^Vh, Gg, Gs, Gll, Gg, Gg, Gs, Gg, Gg, Gg, Gg, Gg, Hh, Gd, Gg, Gg, Gd^Es, Gg, Gs^Vh, Gg, Gs, Ce, Re, Rd, Gs^Eff, Gg^Eff, Gs^Efm, Gg, Gg^Gvs, Gg^Gvs, Gs^Gvs, Gd^Vl, Gd, Ds, Ww, Ds, Ww, Wo, Wo
Gg, Gg, Gg, Gg, Gg^Gvs, Gg^Gvs, Gg^Gvs, Gg, Hh^Fds, Gll^Fds, Gll^Fds, Gll^Fds, Gll, Gs, Gs, Gg^Efm, Gg, Hh, Gg, Gd, Hh^Fds, Hh, Hh, Gg, Gg, Gg, Rd, Ce, 1 Ke, Ce, Rb, Gg, Gg^Efm, Gs, Hh, Gg^Gvs, Gg, Gg, Gg, Gs, Gs, Ds, Ds, Ww, Ds, Ds
Gg, Gg, Gs, Hh, Hh, Gg, Gg, Hh^Fds, Hh^Fds, Gll^Fds, Gll^Fds, Gll^Fds, Gll^Fds, Gll^Fds, Gs, Gg, Gg^Efm, Gll, Gll^Fds, Hh, Gg, Hh^Fds, Hh, Hh, Gg, Gg, Re, Ce, Gg, Ce, Re, Gg, Gg, Hh, Hh, Gg, Hh, Gg^Efm, Gll, Gll, Gll, Gs, Gs, Ds, Ds, Ds
Hh, Hh, Gs, Gg, Hh, Hh, Gg, Hh^Fds, Gg, Gll^Fds, Gll^Fds, Gll^Fds, Gll^Em, Gs, Gd, Gg, Gg, Gg, Gll, Gll^Fds, Gll, Gg, Gll, Gg, Gg, Gg, Gg, Gg, Gs, Gg, Rb, Gg, Gs, Gs, Hh, Gg, Hh^Fds, Gg, Gll, Gll^Fds, Gll^Fds, Gll^Fds, Gll, Gs, Gg, Gg
Gg, Gs, Gg, Gs, Gd^Es, Gg, Gg, Gg, Gg, Gg, Gg, Gll, Hh, Gg, Gd, Hh, Gd, Gs, Gll^Fds, Gll^Fds, Gll^Fds, Gll^Fds, Gll^Fds, Gll^Fds, Gg, Gs^Fds, Hh, Gs, Gs^Es, Gs, Re, Gg, Hh, Gs, Gs, Gg, Gll, Gll^Fds, Gll^Fds, Gll^Fds, Gll^Fds, Gll^Fds, Gs^Fds, Gll^Fds, Gll, Gg
Gg, Gg, Hh, Hh, Gs, Gs, Gg, Gg^Efm, Gll^Fds, Gll^Em, Gll, Hh, Gg, Gs, Gs, Gs, Gd, Gll, Gll^Fds, Gll^Fds, Gll, Gll^Fds, Gll^Fds, Gll, Gg, Gs, Gg, Gg, Hh, Rd, Gg, Gg^Efm, Hh, Gg, Gs, Gs, Gs, Gll^Fds, Gll^Fds, Gll^Fds, Gll^Fds, Gs^Fds, Gll^Fds, Gll^Fds, Gll, Gll
Gg, Gg, Hh, Gs, Gs, Gg^Vl, Gg^Efm, Gg^Efm, Gll^Fds, Gll^Fds, Gs^Fds, Hh^Fds, Gll, Hh, Gg, Gg^Vh, Gg, Gll, Hh, Gll^Fds, Gll, Gll, Gll^Vhh, Gll, Gs, Gs, Gg, Gg, Gg, Re, Gg, Gg, Hh, Hh, Gs, Gs, 2 Gg, Hh^Fds, Gll^Fds, Gs^Fds, Gll^Fds, Gll^Fds, Gll^Fds, Gll^Fds, Gll, Gg
Gg, Gg, Hh, Gg, Gg, Gg, Gg, Gll, Gll^Fds, Gs^Fds, Gs^Fds, Gll^Fds, Gll, Gg, Gll^Efm, Gg, Gg^Efm, Gg, Gg, Hh^Fds, Gll^Fds, Gll, Gg, Gg, Gg, Gs, Gs, Gg, Gg, Rb, Gg, Hh, Gg, Gg, Gs, Gs^Efm, Gg^Efm, Gll, Hh^Fds, Gll, Hh^Fds, Gll^Em, Gll, Gll, Gg, Gg
Gg, Gg, Gg, Hh, Hh^Fds, Hh^Fds, Hh^Fds, Gll^Fds, Gll^Fds, Gll^Fds, Gll^Fds, Gll^Fds, Gll^Fds, Gll^Fds, Gll, Gg, Gg, Gg, Hh, Gg, Gg^Efm, Hh, Gg, Gg, Gg, Gs, Gg, Gg, Gs, Rd, Re, Gg, Gs, Gd, Gg, Gg^Efm, Gg^Efm, Gg, Gg, Hh, Gg, Gg, Gg, Gg, Gd, Gg
Gg, Gg, Gg, Hh, Hh, Hh^Fds, Gs^Fds, Gs^Fds, Gs^Fds, Gs^Fds, Gs^Fds, Gll^Fds, Gll^Fds, Gll^Fds, Gg, Gg^Efm, Gg, Gg, Hh, Gg, Gg, Gs, Gs, Gs, Gs, Gg, Gs, Gs, Gs, Gg, Re, Gs, Gs, Gs, Gg, Gg, Gg, Gg, Gg, Hh, Gg, Gg, Gs, Gs^Es, Gd, Gg
