Gs, Gg, Gll^Fp, Gg^Fp, Gd^Fmw, Gg^Fp, Gll^Fp, Gll^Fp, Gll^Fp, Gg, Gll^Fp, Gg, Gg, Gs, Gll^Fp, Gg^Fmw, Gg^Fp, Gg, Ds, Wwg, Wwg, Wog, Wog, Wog, Wog, Wog, Wog, Wwg, Wwg, Wwg, Ds, Ds, Gll^Fp, Hh, Gll^Fp, Gg^Fp, Gll^Fp, Hh^Fp, Hh^Fp, Gg, Gll^Fp, Gg, Gg, Wwg, Wwg, Wwg, Wwg, Wwg, Wwg
Gg, Gll, Gll, Gll^Em, Gll^Fp, Gll^Fmw, Gll, Gll^Fmw, Gll, Gll^Fmw, Gll^Fp, Gll^Fp, Gs, Gg, Gll^Fp, Gs, Ds, Ds, Ds, Wwg, Wwg, Wog, Wog, Wog, Wog, Wog, Wog, Wog, Wwg, Wwg, Ds, Gll, Ds, Gll, Gll, Gll^Fmw, Gg^Em, Hh, Gd, Gll^Fmw, Gll, Ds, Ds, Wwg, Wwg, Wwg, Wwg, Wwg, Wwg
Gg, Gg, Gg, Gs, Gg, Gll, Gg^Es, Gg, Ds, Gll^Fp, Gg, Gs, Ds, Ds, Wwf, Wwg, Wwg, Wwg, Wwg, Wwg, Wog, Wog, Wog, Wog, Wog, Wog, Wog, Wog, Wog, Wwg, Wwg, Wwf, Gg, Gg^Es, Ds, Gll^Fp, Gll^Fp, Gll^Fp, Ds, Gg, Ds, Wwg, Wwg, Wwg, Wog, Wog, Wog, Wog, Wog
Ds, Ds, Ds, Ds, Wwg, Ds, Ds, Wwg, Wwg, Wwg, Wwf, Wwf, Wwg, Wwg, Wwg, Wwg, Wwg, Wwg, Wwg, Wog, Wog, Wog, Wog, Wog, Wog, Wog, Wog, Wog, Wog, Wwg, Wwg, Wwg, Wwg, Wwg, Ds, Gg, Ds, Wwg, Wwg, Ds, Wwg, Wwg, Wog, Wog, Wog, Wog, Wog, Wog, Wog
Wwg, Wwg, Wwg, Wwg, Wwg, Wwg, Wwg, Wwg, Wog, Wwg, Wog, Wwg, Wwg, Wwg, Wwg, Wwg, Wwg, Ds, Wwg, Wwg, Wwg, Wog, Wwg, Wog, Wog, Wog, Wog, Wog, Wwg, Wwg, Wwg, Wwg, Wwf, Wwg, Wwg, Ds, Wwg, Wwg, Wwg, Wwg, Wog, Wog, Wog, Wog, Wog, Wog, Wog, Wog, Wog
Wwg, Wwg, Wog, Wwg, Wog, Wwg, Wog, Wog, Wog, Wog, Wwg, Wwg, Wwg, Wwg, Wwf, Wwg, Ds, Wwf, Chw, Wwg, Wwg, Wwg, Wwg, Wwg, Wwg, Wog, Wwg, Wwg, Wwg, Ds, Wwf, Wwg, Wwg, Wwg, Wwg, Wwg, Wog, Wog, Wog, Wog, Wog, Wog, Wog, Wog, Wog, Wog, Wog, Wog, Wog
Wog, Wog, Wog, Wog, Wog, Wog, Wog, Wog, Wog, Wog, Wwg, Ds, Wwg, Wwg, Wwg, Gg, Rp, Gg^Edt, Rp, Ds, Gg, Wwf, Ds, Ds, Wwf, Wwg, Wwg, Ds, Wwg, Wwf, Wwg, Wwg, Ds, Wwg, Wwg, Wog, Wog, Wog, Wog, Wog, Wog, Wog, Wog, Wog, Wog, Wog, Wog, Wog, Wog
Wog, Wog, Wog, Wog, Wog, Wog, Wog, Wog, Wog, Wog, Wog, Wog, Wwg, Wwg, Wwg, Ds, Ds, Rp, Rp, Gg, Chr, Rp, Gs, Gg^Vhr, Ds, Wwg, Wwg, Gs, Gg, Wwg, Wwf, Ds, Gg, Wwg, Wwg, Wog, Wog, Wog, Wog, Wog, Wog, Wog, Wog, Wog, Wog, Wog, Wog, Wog, Wog
Wog, Wog, Wog, Wog, Wog, Wog, Wog, Wog, Wog, Wog, Wog, Wog, Wog, Wog, Wwg, Wwf, Wwg, Gg^Vhcr, Wwg, Chr, 2 Khr, Chr, Gg, Gs^Edb, Rp, Ds, Gg^Es, Ds, Wwf, Wwg, Wwg, Gg, Wwg, Wwg, Wwg, Wog, Wog, Wog, Wog, Wog, Wog, Wog, Wog, Wog, Wog, Wog, Wog, Wog, Wog
Wog, Wog, Wog, Wog, Wog, Wog, Wog, Wog, Wog, Wog, Wog, Wog, Wog, Wog, Wog, Wwg, Ds, Wwg, Gs, Chw, Chw, Chw, Wwg, Gg, Wwg, Rp, Ds, Wwg, Wwg, Wwg, Wwg, Wwg, Wwg, Wwg, Wog, Wog, Wog, Wog, Wog, Wog, Wog, Wog, Wog, Wog, Wog, Wog, Wog, Wog, Wog
Wog, Wog, Wwg, Wog, Wog, Wog, Wog, Wog, Wog, Wog, Wog, Wog, Wog, Wog, Wwg, Wwg, Ds, Chr, Rp^Es, Gg, Gg, Rp, Gg^Vhcr, Wwg, Wwg, Ds, Chr, Wwg, Wwf, Wwg, Wog, Wog, Wog, Wog, Wog, Wog, Wog, Wog, Wog, Wog, Wog, Wog, Wog, Wog, Wog, Wog, Wog, Wwg, Wwg
Wwg, Wwg, Ds, Wwg, Wwg, Wog, Wog, Wog, Wog, Wog, Wog, Wog, Wog, Wog, Wwg, Wwg, Wwf, Gs^Edb, Wwg, Ds, Wwf, Gs, Wwg, Wwg, Wwg, Ds, Gs, Gg, Ds, Wwg, Wog, Wog, Wog, Wog, Wog, Wog, Wog, Wog, Wog, Wog, Wog, Wog, Wwg, Wwg, Wog, Wog, Wwg, Wwg, Gll^Fmw
Wwg, Wwg, Gg, Ds, Wwg, Wog, Wog, Wog, Wog, Wog, Wog, Wog, Wog, Wwg, Wwg, Gg, Gg^Edt, Wwg, Wwg, Wwg, Wog, Wwg, Wog, Wog, Wog, Wwg, Wwg, Ds, Wwg, Wwg, Wog, Wog, Wog, Wog, Wog, Wog, Wog, Wog, Wog, Wog, Wwg, Wog, Wwg, Wog, Wwg, Wwg, Wwg, Gll^Fp, Gll^Fp
Ds, Ds, Gs^Vl, Gs, Wwg, Wwg, Wog, Wog, Wog, Wog, Wog, Wog, Wwg, Wwg, Wwg, Wwf, Wwg, Wwg, Wwg, Wog, Wog, Wog, Wog, Wog, Wog, Wwg, Wwg, Wwf, Wwg, Wwg, Wwg, Wog, Wog, Wog, Wog, Wog, Wog, Wog, Wog, Wwg, Wwg, Wwg, Wwg, Wwg, Ss, Ss, Gll^Fp, Wwg, Gll
Gg, Gg, Re, Gg^Es, Ds, Wwg, Wwg, Wog, Wog, Wog, Wwg, Wwg, Ds, Wwg, Wwg, Wwg, Wwg, Wwg, Wwg, Wog, Wog, Wog, Wog, Wog, Wog, Wwg, Wwg, Wwg, Wwg, Ds, Wwg, Wog, Wog, Wog, Wog, Wog, Wog, Wwg, Wwg, Wwg, Gg^Es, Gg, Gg, Ds, Gg, Sm, Sm, Wwg, Gg
Gll, Gll^Fp, Gll^Fp, Gll, Ss, Wwg, Wwg, Wwg, Wwg, Wwg, Wwg, Ds, Gg, Wwf, Wwg, Wwf, Gg, Wwg, Wwg, Wwg, Wwg, Wog, Wog, Wog, Wwg, Wwg, Wwf, Ds, Wwg, Wwg, Wwg, Wog, Wog, Wog, Wog, Wog, Wwg, Wwg, Wwg, Ds, Gg, Gg, Sm, Ss, Ss, Sm, Ds, Wwg, Wwg
Sm, Sm, Gll^Fmw, Gs^Fmw, Re^Fmw, Ss, Ss^Ewl, Ss, Ds, Ds, Sm, Ds, Re, Ds, Gg, Ds, Gg, Ss, Ss, Ds, Wwg, Wwg, Wwf, Wwg, Wwg, Ds, Gg, Ds, Wwg, Wwg, Wwg, Wwg, Wwg, Wwg, Wwg, Wwg, Ds, Gg, Ds, Ds, Gs, Sm, Sm, Ss, Ss, Ss, Ds, Gll^Fp, Gs^Fp
Ss, Sm, Gg^Em, Gll^Fdw, Gll^Em, Ss, Ss, Ss, Ss, Ss, Ds, Ds, Gs, Gll, Gll^Fp, Gg^Fdw, Ss^Fmw, Ss, Ss, Ss, Ds, Ds, Gg, Gg, Gll^Fmw, Gll, Gs, Gg, Ds, Ss, Ss, Ss, Ss, Ds, Ss, Ds, Gg, Gs, Gg^Fmw, Ds, Gg, Ds, Ss, Gg, Ss, Ss, Gg, Gs, Gll^Fmw
Ss, Ss, Gll^Fmw, Gll^Fdw, Ss^Fdw, Ss, Sm, Ss^Vhs, Ss^Ewl, Gg^Fmw, Ss, Ds, Gg, Re^Fmw, Gll^Fmw, Gll^Fdw, Ds, Ss^Bw\r, Ds, Ds, Gll^Fp, Re, Gs^Fmw, Gs, Gll^Fdw, Gg^Fp, Ds, Sm, Ss, Ss, Ss, Ss, Ss, Ss, Sm, Ss, Gg, Gll^Fmw, Gll^Fp, Gll, Gll^Fmw, Ds, Ss, Ss^Vhs, Ss, Sm, Gs^Vwm, Gg, Gs
Ds, Gll, Ss, Ss^Fmw, Ss, Ds, Ss, Ss^Bw|r, Gll^Fdw, Ss^Fmw, Gg, Gs, Sm, Gg, Ds, Gg^Em, Gg, Ss, Ss, Gs^Fp, Gll^Fdw, Gll^Fmw, Ds, Ds, Gg^Fp, Gll^Fmw, Ds, Sm, Ss^Vhs, Ss, Ds, Ds, Sm, Sm, Ds, Sm, Gg, Gll, Gll^Fp, Gll^Fmw, Gll^Fmw, Gll, Sm, Ss, Ss, Gs, Ds, Gg, Gg
Ss, Gll^Fp, Ss^Fp, Ss^Fmw, Ss, Ss, Gg, Gs, Re, Re, Ss, Sm, Sm, Gll, Gll^Fp, Ds, Ss, Ss, Ss, Ss^Fmw, Gll^Fmw, Re, Gg, Gs, Gll^Fp, Gll^Em, Ds, Ss, Ss, Ss, Ss, Ds, Gs, Gg, Gd, Gg, Gs, Gs^Ecf, Gg, Gg, Gg, Gs^Em, Gg, Sm, Sm, Ds, Ds, Gg, Gg
Ss, Ss, Ds, Gg^Vl, Re, Re, Gs, Gg^Em, Ss^Fmw, Ss, Ss^Ewl, Ss^Bw|r, Gg, Gll^Fmw, Ds, Ss, Ss, Ss^Bw\r, Ss^Bw\r, Gll^Em, Ds, Re, Gg, Sm, Ss, Ds, Ds, Ss, Ss^Ewl, Sm, Sm, Gg, Ds, Gg, Gd^Es, Gs, Rd, Gg, Gs, Gs^Es, Ce, Ce, Ce, Sm, Gg, Sm, Gg, Gs, Gs
Ss, Ds, Ds^Fmw, Re, Gll, Ds, Ss, Ds, Gg^Fdw, Ss^Fdw, Ss, Ss^Vhs, Gs, Ds, Ds, Ss, Gg^Vl, Ss, Ss, Ss^Bw\, Ds, Re, Re, Sm, Gg, Ss, Ss, Ss, Ds, Ds, Gg, Gg, Re, Gs, Gs, Gs, Rd, Gg^Vh, Gs, Gg, Ce, 1 Ke, Ce, Gg, Gd, Ss, Gg, Gg, Gll^Fp
Ss, Ds, Gll, Gll^Fdw, Gll^Fmw, Ss, Sm, Ds, Re, Gll^Fmw, Gg, Ss, Gg^Em, Ds, Ds, Ss, Gs, Gg, Ss, Sm, Ds, Gll, Gg^Em, Re, Re, Gg, Gs, Gs, Gg, Gs, Gg^Vh, Gs, Gd, Gs, Gg, Hh, Hh, Rd, Gg, Gs, Gd, Ce, Gg, Gd, Gs, Gs, Hh^Fp, Gll^Es, Gs^Fp
Ss, Sm, Gg^Em, Re^Fdw, Ss, Ss, Gg, Sm, Gs, Re, Gg, Ss, Ss, Ss, Ss, Ss, Ds, Gs, Ds, Gs, Ss, Gll^Fp, Gll^Fmw, Re^Fmw, Re^Fmw, Gg, Gg, Re, Re, Gg, Gs, Re, Gg^Es, Gs, Hh, Hh, Hh, Hh, Hh, Gs, Rd, Gg, Rd, Gs, Hh, Hh, Hh^Fp, Gll^Fmw, Gs^Fp
Ss, Gs, Gg, Re, Gg, Gg, Gg, Ss, Ss, Gg, Gg, Ss, Gg, Gg, Gg, Gg, Gg, Ds, Gs, Ds, Gs, Gll^Fmw, Gll, Gg^Fmw, Gll, Gll, Ss, Ds, Ds, Gs, Gs, Gg, Gg, Gg, Hh, Hh, Hh, Hh, Hh, Rd, Rd, Gg, Rd, Hh, Hh, Hh, Hh, Hh, Gg
