Ha, Ha, Ha, Ha^Fda, Ha^Fda, Ha, Ha^Fma, Hh, Aa^Fda, Ai, Ai, Ww, Ww, Aa, Aa, Aa^Fda, Ha^Fma, Ha, Ha^Fda, Hh, Ha^Fda, Hh, Ms, Mm, Ms, Mm, Ms, Mm, Ms, Mm, Ms, Mm, Mm, Mm, Mm, Ms, Ms, Ms, Ms, Ms, Ms, Ms, Ms, Mm, Ms, Ms, Ms
Ha^Fpa, Ha^Fpa, Ha^Fda, Ha, Ha, Ha, Ha^Fma, Aa^Fma, Aa^Fda, Ai, Ww, Ww, Ww, Aa^Fda, Ai, Aa^Fma, Aa^Fda, Ha, Ha^Fda, Ha^Fpa, Ha^Fpa, Ha, Ha, Ms, Ms, Ms, Ms, Ms, Ms, Ms, Ms, Mm, Mm, Mm, Mm, Mm, Ms, Ms, Ms, Ms, Ms, Ms, Ms, Ms, Ms, Ms, Ms
Ha^Fda, Ha^Fpa, Ha^Fda, Ha^Fda, Ha^Fda, Ha^Fma, Aa^Fma, Aa^Fma, Aa^Fma, Ai, Ai, Ww, Ww, Ww, Ai, Aa, Aa^Fpa, Aa^Fpa, Ha^Fda, Ha^Fpa, Ha, Ha, Ha, Ms, Ms, Ms, Ms, Ms, Ms, Ms, Mm, Mm, Mm, Mm^Vhh, Mm, Mm, Cud, Ms, Ms, Ms^Vhh, Ms, Ms, Ms, Ms, Ms, Ms, Ms
Ha, Ha, Ha, Ha^Fma, Ha^Fma, Ha^Fda, Aa^Fma, Aa^Fpa, Aa^Fda, Aa^Fpa, Gd, Wwf, Wwf, Ww, Ai, Ai, Aa, Aa, Aa^Fpa, Ha, Ha, Ha^Fma, Ha^Fma, Ms, Ms, Ms, Ms, Ms, Ms, Ms, Ms, Mm, Ms, Mm, Hh, Cud, 2 Kud, Cud, Ha, Ms, Ms, Ms, Ms, Ms, Ms, Ms, Ms
Ha^Fpa, Ha^Fpa, Ha, Ha^Fpa, Aa, Aa^Fma, Aa, Aa, Aa^Fda, Aa^Fda, Gd, Gd, Ww, Ww, Ai, Ai, Aa^Fpa, Ha^Fma, Aa^Fpa, Aa, Ha^Fda, Ha^Fda, Ha, Ha^Fda, Mm, Mm, Ms, Ms, Ms, Ms, Ms, Ms, Mm^Vhh, Hh, Rr, Cud, Rr, Cud, Rr, Ha, Ms, Ms, Ms, Ms, Ms, Ms, Ms
Ha, Ha^Fda, Ha, Ha^Fpa, Aa, Aa^Fda, Aa, Gd^Fdw, Gd, Gd^Vo, Gd, Wwf, Wwf, Ww, Ww, Aa, Ha^Fda, Ha^Fda, Hh^Fma, Aa, Aa, Ha, Ha, Hh, Hh, Mm, Mm, Ms, Mm, Ms, Mm, Ms, Mm, Hh, Rr, Rr, Ha, Rr, Ha, Rr, Rr, Ms, Ms, Ms, Ms, Ms, Ms
Ha^Fpa, Ha, Hh^Fdw, Hh^Fdw, Gd^Fdw, Aa, Gd, Gd, Gd, Gd, Gd, Gd^Fdw, Wwf, Ww, Ww, Aa, Aa, Gd^Fdw, Gd, Gd^Fdw, Gd, Aa, Gd, Hh, Hh, Ms, Ms, Ms, Mm, Mm, Mm, Mm, Mm, Cud, Rr, Hh, Ms, Ha, Mm^Vhh, Ha, Rr, Rr, Ms, Ms, Ha^Fda, Ha, Ha^Fpa
Hh^Fdw, Ha^Fdw, Hh, Hh^Fmw, Hh^Fmw, Gd^Fdw, Gll, Gd, Gs, Gd, Gg, Gd, Ww, Ww, Ww^Bw/r, Gd, Gd, Gd, Hh, Gd, Gs, Gd, Gd, Gd, Ha, Ha, Ms, Ms, Mm, Mm, Mm, Mm, Rr, Rr, Rr, Mm, Mm, Ms, Ms, Ms, Cud, Rr, Mm, Ms, Ha^Fpa, Ha^Fda, Ha^Fpa
Hh, Hh, Hh^Fmf, Hh^Fmw, Gll, Gll^Fmw, Gg, Co, Co, Co, Gg, Gs, Ww^Bw/r, Ww^Bw/r, Ww, Gd, Gd^Fdw, Hh, Gd, Gs, Gd, Gs, Gd, Ha, Aa, Ha, Ha, Hh, Mm, Mm, Mm, Hh, Hh, Rr, Hh, Mm, Mm, Mm, Ms, Ms, Ha, Rr, Rr, Ha^Fpa, Ha^Fda, Ha^Fpa, Ha^Fpa
Hh, Hh, Hh, Gs, Gg^Vo, Gs, Gg, Co, 5 Ko, Co, Gg, Gs, Ds, Ww, Ww, Wwf, Aa, Aa, Gg^Vo, Gs, Gs, Gd, Hh, Aa, Aa, Ha, Aa, Hh, Hh, Hh, Hh, Hh, Hh, Rr, Hh, Hh, Hh, Hh, Ha^Fda, Ha^Fda, Hh, Hh, Rr, Aa, Aa^Fpa, Aa^Fda, Aa^Fda
Hh, Hh, Hh, Gs, Gs, Gd, Gd, Co, Co, Co, Gd, Gg, Ds, Ww, Ww, Ww, Ai, Gd, Gg, Gs, Co, Gd, Gs, Gd, Aa, Aa, Ha, Aa, Gd, Gd, Gd, Gd, Gd, Rr, Gd, Gd, Aa, Ha, Aa, Aa^Fda, Aa, Gd, Gd, Rr, Rr, Aa, Rr
Mm, Hh, Hh, Hh, Hh, Gd, Gs, Gs, Gs, Gg, Gs, Gs, Gg, Ds, Ww, Ww, Ww, Aa, Gs, Gs, 3 Ko, Co, Gg, Gd, Gd^Eff, Aa, Hh, Hh, Gd, Re^Gvs, Re^Gvs, Gd, Gd, Rp, Hh, Gd, Aa^Fda, Aa^Fda, Aa, Ha, Aa, Aa, Gd^Eff, Gd, Gd^Fdw, Rr, Gd^Fdw
Mm, Mm, Hh, Gs, Gg, Gg, Gg^Ecf, Gs, Gs, Gg, Gs^Vo, Gg, Gs, Gs, Ww, Ww, Ww, Aa, Gs, Co, Co, Gs, Gg, Gd^Eff, Gd^Eff, Aa, Gd, Gs, Gd, Re^Gvs, Gd^Es, Gs, Gd, Rp, Gd, Aa, Aa, Ha, Ha, Gd, Aa^Eff, Aa^Eff, Gd^Vl, Gs, Re^Gvs, Gd^Fdw, Gd^Fmf
Mm, Mm, Hh, Hh, Gs, Gg, Gs, Gs, Gs, Gs, Gd, Gs, Gs, Gg, Ww, Ww, Ww, Gg^Es, Gs, Gs, Gg, Gs, Gs^Eff, Gs^Eff, Hh, Gd, Gs, Gd, Gg^Vo, Gs, Aa, Aa, Rp, Rp, Gd, Aa, Gd, Aa^Fda, Aa, Gd, Hh, Gd^Eff, Gs, Re^Gvs, Re^Gvs, Re, Re
Hh, Hh, Hh, Gg, Gg, Gs, Gs^Es, Gs, Gg, Gs, Gs, Gd, Gs, Gg, Ds, Ww, Ww, Ds, Hh, Gs, Gg, Gs^Eff, Gg, Hh, Gd, Aa, Aa, Gs, Gg, Gd, Gs^Gvs, Aa, Rp, Gd, Gd, Gd, Gd, Gd, Gd, Hh, Gs, Gg, Gg^Gvs, Re^Gvs, Re^Gvs, Re^Gvs, Gs
Hh, Hh, Gs, Gg, Gg, Gs, Hh, Hh, Gs, Gs, Gs, Hh, Hh, Hh, Ds, Wwf, Ww, Wwf, Ds, Hh, Gs, Gs^Es, Gs, Gg, Gd, Gd, Gg^Gvs, Gg^Gvs, Gd^Gvs, Gg^Gvs, Gg, Gs, Rp, Gs, Gs, Gg^Vhh, Gg^Gvs, Gd, Gg, Gd, Hh, Gs, Hh, Gg, Gg^Es, Gg, Gg
Hh, Hh, Gg, Gs, Gs^Es, Gg, Gs, Hh, Gs, Gs, Gg, Hh, Gs, Gs, Gs, Wwf, Ww, Ww, Ww, Gg^Vo, Gg, Gs, Gd, Gs, Gs, Gs^Es, Gs, Gd, Gg, Gg^Gvs, Gs^Eff, Gg, Rp, Gg, Gg, Gs^Gvs, Gs^Gvs, Gd^Gvs, Gs, Hh, Hh, Hh, Gs, Hh, Gd, Gg, Gg
Hh, Gs, Hh, Gd, Gg, Gs, Gs, Gs, Rp, Rp, Rp, Gg, Rp, Rp, Rp, Ds, Ww, Ww, Ww, Ww, Ww^Bw/, Gd, Gs, Gg^Gvs, Gd^Gvs, Gs^Gvs, Gs, Gg, Gg, Gg^Eff, Gs, Gs, Gs, Gg, Gg, Gg, Gg, Gd^Fmf, Gll^Fp, Hh^Fdf, Hh^Fmf, Gs, Gll^Fp, Gg, Gg, Gg, Gd
Gs, Gs, Hh, Gs, Rp, Rp, Rp, Gs, Hh, Hh, Gs, Gs, Gs, Gs, Gs, Rp, Rp, Wwf, Ww^Bw/, Ww^Bw/, Ww, Wwf, Ds, Gd, Rp, Gs, Gs, Rp, Rp, Gg, Gg^Es, Gg, Rp, Gs, Gs, Gg^Es, Gg, Gll, Gll^Fmf, Hh^Fmf, Gg^Fdf, Hh^Fmf, Gs^Fmf, Gg, Ds, Gs, Wwf
Gg, Gd, Rp, Rp, Gs, Hh, Gs^Fmf, Gs, Gg, Gs, Gs, Gg^Es, Gs, Gs, Gg, Gs, Gd, Gd, Gg, Ww, Ww, Ww, Ww, Ds, Gg, Rp, Gg, Gs^Vc, Gs, Rp, Gg, Gs, Rp, Gs, Ds, Gg, Ww, Ds, Wwf, Gs, Ww, Gg, Wwf, Ds, Ww, Wwf, Ww
Rp, Gg, Hh, Gg, Gs, Gs, Hh^Fp, Gll^Fp, Gll, Gs, Gs, Gs, Gll, Gs, Gg, Gs, Gs, Gd, Gd, Rp, Ds, Ww, Ww, Wwf, Wwf, Ds, Ds, Gg, Gg, Gs, Gs, Gg, Ww, Ww^Bw\, Ww^Bw\, Ww, Ww, Ww, Ww, Ww, Ww, Ww, Ww, Ww, Ww, Ww, Ww
Gg, Gd, Gd^Fmf, Gs^Em, Gg^Fp, Hh^Fp, Gg, Gll^Fp, Gs^Ve, Gg^Fmf, Gll^Fp, Gll, Gll^Fmf, Gll, Gs, Gg, Gg^Gvs, Gg^Gvs, Gg, Gs, Gg, Ww, Ww, Ww, Ww, Ww, Ww, Gs, Wwf, Ds, Ww, Wwf, Ww, Ww, Ww, Ww^Bw\, Ww^Bw\, Ww, Ww, Ww, Wwf, Ww, Wwf, Ww, Ww, Ww, Gll
Gs^Fmf, Gs^Fmf, Gg^Fdf, Gs^Fp, Gs^Fp, Gg^Fdf, Gs^Fmf, Gll^Fp, Gll, Gll^Fp, Gll^Fmf, Gll^Fmf, Gd^Fp, Gs, Gd, Gg^Gvs, Gs, Gs, Gs^Vl, Gg, Gs, Ds, Ds, Ww, Ww, Ww, Ww, Ww, Ww, Ww, Ww, Ww, Ww, Ww, Ds, Wwf, Gg, Rp, Rp, Gs, Gll, Gs^Vc, Gll^Fmf, Gs^Fmf, Gll^Fmf, Gll^Fmf, Gll^Fmf
Gs^Fmf, Gs^Fp, Gg^Fp, Gg^Fdf, Hh^Fmf, Hh^Fdf, Hh^Fdf, Hh^Fmf, Gs^Fp, Gd^Fp, Gg^Fp, Gll^Fp, Gll, Gd^Fmf, Gs, Gg, Gg, Gg, Gs^Gvs, Gs, Gs^Gvs, Gg, Gs, Gs, Gs, Ww, Ww, Ww, Ww, Ww, Ds, Wwf, Gg, Ds, Gg, Gg, Gg^Es, Gg, Gg, Rp, Gg, Gll^Fmf, Gg, Gll^Fmf, Gll, Gll^Fmf, Gg^Em
Gs^Fmf, Gd^Fp, Gs^Ve, Gs^Fdf, Hh^Fmf, Gs, Gs^Fp, Gs^Fmf, Gs^Fp, Gg^Fmf, Gg^Fp, Gll^Es, Gll^Fmf, Gs, Gll, Gs, Gs, Gg^Gvs, Gg, Gg^Gvs, Gs^Gvs, Gs^Gvs, Gs, Gs, Gs, Gg, Gs, Ds, Gs, Ds, Gs, Gs, Gg, Gs, Gs^Vh, Gg, Gs, Gg, Gs, Gg, Ce, Ce, Ce, Gs, Gll^Fmf, Gll^Fmf, Gll^Fmf
Gs^Fmf, Gg^Fmf, Gs^Fmf, Hh^Fmf, Hh, Gs^Fmf, Cv, Cv, Gg^Fmf, Gd^Fdf, Gs^Fmf, Gll^Fmf, Gll^Vh, Gll^Fmf, Gll^Fmf, Gd^Fmf, Gg^Fmf, Gll^Fmf, Gll, Gg, Gg, Gs, Gs, Gs^Es, Gs, Hh, Hh, Hh, Hh, Gs, Gs, Gs, Gg^Gvs, Gs, Gg^Gvs, Gg, Gg^Gvs, Gs^Gvs, Gs, Gg, Ce, 1 Ke, Ce, Gs, Gs, Gll, Gs
Gg^Fmf, Gll^Fmf, Gll^Fdf, Gs, Gs^Fp, Gs^Fmf, Cv, 4 Kv, Cv, Gg^Fmf, Gll^Fp, Gs^Em, Gll^Fmf, Gll^Fp, Gll^Fp, Gll^Fp, Gll^Fmf, Gs^Fmf, Gs^Fmf, Gll^Fmf, Gll^Fmf, Gs^Fmf, Gll^Fmf, Gg, Hh, Hh, Mm, Hh, Hh, Hh, Gg, Gs, Gg, Gg^Gvs, Gg^Gvs, Gd^Gvs, Gs, Gg, Gg^Es, Gs, Gg, Ce, Gg, Gs, Gg^Vl, Gg, Gg^Gvs
Gs^Fmf, Gll^Fdf, Gll^Fdf, Gll^Fdf, Gll^Fdf, Gg^Fdf, Gg, Cv, Gg^Fmf, Gg^Fmf, Gll^Fp, Gll^Fmf, Gg^Fmf, Gll^Fmf, Gg^Fp, Gll^Fp, Hh^Fp, Gs^Fmf, Gll^Fmf, Gll^Fmf, Gll^Vl, Gll^Fmf, Gg^Fp, Gg^Fmf, Hh^Fp, Mm, Mm, Mm, Hh, Gg, Gs, Gs^Es, Gg, Gs, Gll^Fp, Gll, Gll^Fmf, Gs^Fp, Gs, Gg, Gd, Gd, Rp, Gg, Gs, Gs^Gvs, Gs
Gg^Fmf, Gll^Fdf, Gll^Fmf, Gll^Fmf, Gll^Fmf, Gll^Em, Gll^Fmf, Gll, Gg^Fmf, Gg^Fp, Gll, Gg^Fmf, Gg^Fmf, Gg^Fmf, Gg^Fmf, Hh^Fmf, Hh, Gs^Fp, Gll^Fdf, Gll^Fmf, Gll^Em, Gll^Fmf, Gg, Hh^Fmf, Hh^Fp, Hh^Fp, Hh^Fmf, Hh, Gg, Gd, Gs, Gs, Gs, Gg, Gll^Fp, Gll^Em, Gg^Fp, Gll^Fmf, Gs^Eff, Gs^Eff, Gs^Eff, Gs, Gg, Rp, Gg^Gvs, Gs^Gvs, Gg
Gs^Fmf, Gll^Fp, Gll^Fmf, Gll^Fmf, Gll^Fp, Gll^Fmf, Gll^Fmf, Gll, Gll^Fmf, Gll^Fmf, Gll, Gll^Fmf, Gll^Fp, Gg^Ve, Gd^Fp, Hh^Fp, Hh, Gs^Fdf, Gg^Fmf, Gll^Fmf, Gll^Fmf, Gll^Fmf, Gd^Fp, Gs^Fmf, Gll^Fmf, Gs^Fmf, Gll, Gg, Gs^Es, Gs, Gs, Hh, Hh, Gs, Gg, Gll^Fmf, Gd^Fmf, Gg^Eff, Gg^Eff, Gs^Vwm, Gs, Gs, Gs, Rp, Gg, Gg^Gvs, Gd
Gll^Fp, Gll^Fp, Gll^Fp, Gll^Fp, Gll^Fmf, Gll^Fp, Gll^Fdf, Gll^Fp, Gg^Fdf, Gll^Fp, Gs^Fmf, Gll, Gll^Fmf, Gg^Fmf, Gg^Fp, Hh^Fp, Gs^Fmf, Hh^Fmf, Gll^Fp, Gll^Fmf, Gll^Fp, Gll^Fp, Gll^Fmf, Gll^Fmf, Gll^Fmf, Gll^Fmf, Gll^Fmf, Gll, Gg, Gg, Hh, Hh, Hh^Vhh, Gs, Gg, Gs, Gg, Gg, Gg, Gd, Gd^Gvs, Gg^Gvs, Gs, Rp, Gg, Gs, Gg
Gs, Gll^Fp, Gd^Fmf, Gll^Fmf, Gg, Gs^Fmf, Gs^Fmf, Gll^Fmf, Gll, Gll^Fmf, Gll, Gll, Gll, Gs^Fmf, Gs, Gll^Fmf, Gll, Gll^Fmf, Gs, Gg^Fp, Gs^Fmf, Gs^Fp, Gs^Fmf, Gs^Fmf, Gs, Gg^Fmf, Gs, Gll^Fmf, Ww, Gd, Hh, Hh, Hh, Hh, Gg, Gg^Es, Gs, Gs, Gs, Gg, Gs, Gs, Gs, Gs, Gs, Rp, Rp
