Wo, Wo, Ww, Ww, Ai, Ai, Ha, Ha, Ha, Ha, Ms, Ms, Ha, Ha, Ms, Ms, Ms, Ms, Ms, Ms, Ms, Ms, Ms, Ms, Ms, Ms, Ms, Ms, Ms, Ha, Ha, Ha, Ha, Ha, Ms, Ms, Ms, Ms, Ms, Ms, Ms, Ms, Ms, Ha, Ha, Ai, Ai, Ww, Ww, Wo, Wo, Wo, Wo, Wo, Wo
Wo, Wo, Ww, Ww, Ai, Ai, Ha, Ha, Ha, Ha, Ms, Ha, Ms, Ms, Ms, Ms, Ms, Ms, Ms, Ms, Ms, Ms, Ms, Ms, Ms, Ms, Ms, Ms, Ms, Ha, Ha, Ha, Ha, Ha, Ms, Ms, Ms, Ms, Ms, Ms, Ms, Ms, Ms, Ha, Ha, Ha, Ha, Ai, Ai, Ww, Ww, Wo, Wo, Wo, Wo
Ww, Ww, Ai, Ai, Ha, Ha, Ms, Ha, Ms, Ms, Ha, Ms, Aa, Ms, Ha, Ms, Ha, Ms, Ms, Ms, Ms, Ms, Ha, Ms, Ms, Ms, Ms, Ms, Ha, Ha, Ha, Aa, Aa, Ha, Ha, Ha, Ms, Ms, Ms, Ms, Ms, Ms, Ms, Ha, Ha, Ms, Ha, Ai, Ai, Ai, Ai, Ww, Ww, Wo, Wo
Ai, Ai, Ha, Ha, Ms, Ms, Ms, Ms, Ha, Ha, Aa, Cha, Cha, Aa, Aa, Aa, Aa, Ha, Ha, Ms, Ms, Ha, Ms, Ms, Ms, Ms, Ms, Ha, Ha, Ha, Ha, Aa^Es, Aa, Ha, Ms, Ms, Ms^Vhha, Ms, Ms, Ms, Ha, Ms, Ha, Ha, Ms, Ms^Voa, Ms, Ha, Ha, Ha, Ai, Ai, Ww, Ww, Wo
Ai, Ai, Ha, Ms, Ms, Ms, Ms, Ms, Ha, Aa, Aa, Cha, Kha, Cha, Cha, Aa, Aa, Aa, Ha, Ha, Ha^Vca, Ms, Ms, Ms, Ms, Ms, Ms, Ms, Ms, Ms, Ms, Ha, Aa, Ha, Ms, Ms, Ms, Ms, Ms, Ms, Ha, Ha, Ha, Ms, Ms, Ms, Ms, Ms, Ms, Ha, Ai, Ww, Ww, Wo, Wo
Ha, Ha, Ha, Ms, Ms, Ms, Ms, Ms, Ha, Aa, Aa, Cha, Cha, Cha, Aa, Aa, Aa^Es, Aa, Ha, Ms, Ha, Ms, Ms, Ms, Ms, Ms, Ms, Ms, Ms, Ms, Ha, Ha, Ha^Voa, Ha, Ha, Ms, Ms, Ms, Ms, Ha, Coa, Coa, Coa, Ha, Ha, Ms, Ha, Ms, Ha, Ha, Ai, Ww, Ww, Wo, Wo
Ha, Ha, Aa, Ha, Ha, Ms, Ms, Ms, Ms, Ha, Ms, Cha, Aa, Aa, Ha, Ha, Ha, Ms, Ms, Ms, Ms, Ha, Ms, Ms, Ms, Ms, Ha, Ms, Ha, Ha, Aa, Ha, Aa, Ha, Ms, Ms, Ms, Ms, Ms, Ha, Coa, 2 Koa, Coa, Ha, Ms, Ha, Ms, Ha, Ha, Ai, Ai, Ww, Ww, Wo, Wo
Aa, Aa, Aa^Es, Ha, Ha, Ms, Ms, Ms, Ms, Ms, Rb, Rb, Ms, Ha, Ms, Ms, Ms, Ms, Ms, Ms, Ms, Ha, Ha, Ms, Ha, Ha, Aa, Ha, Gd, Ha, Gg, Aa, Ha, Ha, Ms, Ms, Ms, Ha, Ms, Ha, Ha, Coa, Ha, Ha, Ms, Ms, Ms, Ms, Ha, Ww, Ww, Ww, Ww, Wo, Wo
Aa, Aa, Aa, Aa, Ha, Ms, Ms, Ms, Ms, Rd, Ms, Ms, Ms, Ms, Ms, Ms, Ms, Ha, Ha, Ms, Ha, Ms, Ha, Ha, Aa, Ha, Gd, Aa, Ha, Gs, Ha, Ha, Ms, Ha, Ms, Ms, Ms, Ha, Ha, Ha, Ms, Ha, Ms, Ms, Ms, Ms, Ms, Ha, Ha, Ww, Ai, Ww, Ww, Wo, Wo
Gd, Gs, Aa, Aa, Ms, Ms, Ms, Ms, Ms, Re, Ms, Ms, Ms^Vca, Ms, Ms, Ms, Ms, Ms, Ha, Ha, Aa, Ha, Aa, Aa, Ha, Gs, Ha, Ha, Ms, Ha, Ms, Ha, Ms, Ms, Ms, Ms, Ms^Voa, Ms, Ms, Ha, Ms, Ms, Ms, Ms, Ms, Ms, Ha, Ha, Ai, Ai, Ww, Ww, Wo, Wo, Ww
Gs, Gd^Es, Ha, Ha, Ha, Ms, Ms, Ms, Ha, Rb, Ms, Ms, Ms, Ms, Ms, Ms, Ms, Ha, Ha, Aa, Aa, Aa, Ha, Gd^Es, Ms, Ms, Ms, Ms, Ms, Ms, Ms, Ms, Ms, Ms, Ms, Ms, Ms, Ms, Ms, Ms, Ha, Ha, Ha, Ha, Ms, Ha, Ha, Ai, Ai, Ww, Ww, Wo, Ww, Ww, Ww
Ha, Ha, Ms, Ms, Ms, Ms, Ms, Ha, Ha, Re, Ms, Ms, Ms, Ms, Ms, Ms, Ha, Ms, Ha, Aa, Aa, Aa, Re, Ha, Ms, Ms, Ms, Ms, Ms, Ms, Ms, Ms, Ms, Ms, Ha, Ms, Ms, Ms, Ms, Ms, Ha, Ha, Ai, Ai, Ha, Ha, Ha, Ai, Ai, Ww, Ww, Ww, Ww, Ai, Ai
Ms, Ms, Ms, Ms, Ms, Ms, Ms, Ms, Re, Ms, Ms, Ms, Ms, Ms, Ha, Ms, Ha, Ha, Gs, Gd, Re, Rd, Re, Rb, Rb, Ms, Re, Ms, Rb, Ms, Re, Ms, Ms, Ms, Ha, Ha, Ha, Ms, Ha, Ha, Ai, Ai, Ai, Ha, Ai, Ai, Ai, Ai, Ww, Ww, Ww, Ww, Ai, Ai, Ha
Ms, Ms, Ha, Ms, Ha, Ms, Ha, Ms, Re, Ms, Ha, Ms, Ha, Ms, Ha, Ha, Aa, Gs, Re, Rb, Aa, Aa, Ms, Aa, Aa^Es, Re, Ms, Re, Ms, Rb, Ms, Re, Rb, Rb, Ai, Ha, Ai, Ha, Ai, Ha, Ai, Ww, Ai, Ai, Ww, Ww, Ww, Ww, Ww, Ww, Ai, Ai, Ha, Ha, Ms
Ha, Ha, Aa, Ha, Aa, Ha, Gd, Ha, Rb, Ha, Re, Ha, Ha, Ha, Aa, Aa, Rb, Re, Aa, Rb, Ms, Ms, Ms, Aa, Ms, Ms, Ha, Ms, Ha, Ms, Ha, Ha, Ww, Rb, Ww, Ai, Ai, Ai, Ai, Ai, Ww, Ww, Ww, Ww, Wo, Wo, Ww, Wo, Ai, Ai, Ha, Ha, Ms, Ms, Ms
Aa, Aa, Aa, Aa, Aa, Aa, Gg, Gs, Gd, Rd, Gd, Rb, Re, Re, Rd, Re, Aa, Re, Ha, Ha, Ms, Ms, Ms, Ms, Ha, Ha, Ai, Ha, Ww, Ha, Ww, Ha, Ww, Ww^Bw|, Ww, Ww, Ww, Ai, Ww, Ww, Wo, Wo, Wo, Wo, Ww, Wo, Ww, Ww, Ha, Ha, Ms, Ms, Ms, Ms, Ms
Gd, Gd, Gd, Gs, Gd, Gs, Aa^Es, Gs, Aa, Gs, Aa, Aa^Es, Aa, Gd, Aa, Aa, Ha, Aa, Ha, Ms, Ha, Ms, Ha, Ha, Ww, Ai, Ww, Ai, Ww, Ww, Wo, Ww, Ww, Ww^Bw|, Ww, Wo, Wo, Ai, Wo, Wo, Wo, Wo, Ww, Ww, Ww, Ai, Ai, Ai, Ha, Ms, Ms, Ha, Ha, Ha, Ha
Gs, Gg, Gs, Gs, Aa, Aa, Aa, Aa, Gd, Gg, Ha, Re, Ha, Aa, Ha, Ms, Ms, Ms, Ha, Ha, Ww, Ha, Ww, Ai, Ai, Ai, Wo, Ww, Ai, Ww, Ww, Ww, Ww, Ww^Bw|, Ww, Wo, Wo, Wo, Wo, Wo, Ww, Ww, Ha, Ww, Ha, Ai, Ms, Ha, Ms, Ms, Ha, Ms, Ha, Ha, Ha
Gs, Gs, Aa, Gd, Ha, Gd, Ha, Gs, Ms, Ms, Ms, Ms, Ms, Ha, Ms, Ms, Ha, Ha, Ww, Ha, Ww, Ww, Wo, Ww, Ai, Ww, Wo, Ww, Ww, Ai, Ai, Ai, Ww, Ww^Bw|, Ww, Wo, Wo, Wo, Ww, Wo, Ha, Ww, Ha, Ha, Ms, Ms, Ms, Ms, Ms, Ha, Ha, Ha, Ha, Ha, Ms
Gd, Gd^Es, Ha, Gs, Ha, Ha, Ms, Ha, Ms, Cha, 3 Kha, Cha, Ms, Ms, Ha, Ha, Ww, Ww, Wo, Ww, Wo, Wo, Ww, Ww, Ww, Ww, Ww, Ww, Ww, Wo, Ww, Ai, Ai, Ww^Bw|, Ww, Wo, Ww, Ww, Ww, Ww, Ha, Ha, Ha, Ha, Ha, Ha, Ha, Ha, Ms, Ms, Ms, Ha, Ms, Ms, Ms
Ha, Ha, Ms, Ha, Ms, Ms, Ms, Ms^Vca, Ms, Ms, Cha, Ms, Ms, Ms^Vca, Ai, Ww, Wo, Wo, Wo, Wo, Ww, Ww, Ww, Ai, Ai, Ai, Ai, Ai, Ww, Wo, Ww, Ai, Ai, Ww^Bw|, Ai, Ai, Ai, Ww, Ha, Ha, Ms, Ha, Ha, Ms, Ms, Ms, Ms, Ms, Ha, Ha, Ms, Ms, Ha, Ms, Ms
Ms, Ms, Ha, Ms, Ha, Ms, Ha, Ha, Ai, Ms, Ai, Ms, Ai, Ai, Ww, Ww, Wo, Wo, Wo, Wo, Ww, Ai, Ai, Ai, Ww, Ai, Ai, Ww, Ww, Wo, Ai, Ai, Ai, Ww^Bw|, Gd, Gs, Gd, Ai, Gs, Ha, Ms, Ha, Ms, Ha, Ha, Ms, Ha, Ms, Ha, Ha, Ha, Ms, Ha, Ms, Ms
Ha, Ha, Ai, Ha, Ai, Ha, Ai, Ai, Ww, Ai, Ww, Ww, Ww, Ww, Wo, Wo, Ha, Wo, Ha, Ha, Aa, Ww, Ai, Ai, Ai, Ai, Aa, Ai, Ai, Ww, Ai, Ai, Aa^Vha, Rd, Rb, Rb, Re, Gd, Gs, Ha, Ha, Ms, Ha, Ms, Ha, Ha, Aa, Ha, Aa, Ha, Aa, Ha, Aa, Ha, Ha
Ww, Ww, Ww, Ai, Ww, Ai, Ww, Ww, Ww, Ww, Wo, Ww, Wo, Ww, Ha, Ha, Aa, Ha, Aa, Ha, Gd, Aa, Ha, Aa, Ha, Aa, Ha, Gd, Ha, Ww, Ha, Gs, Ha, Gs, Ha, Gs, Aa, Re, Re, Ha, Gd, Ha, Aa, Ha, Aa, Ha, Aa, Ha^Vhha, Ha, Aa, Ha, Aa, Ha, Aa, Aa
Wo, Wo, Wo, Ww, Wo, Ww, Wo, Wo, Wo, Wo, Wo, Wo, Ww, Ww, Ha, Aa, Ha, Gd, Ha, Gs, Ha, Ha, Ms, Ha, Ms, Ha, Ms, Ha, Ms, Ha, Ms, Ha, Ms, Ha, Ha, Gd, Aa, Aa, Rb, Gs, Aa, Aa, Aa^Es, Aa, Ha, Aa, Ha, Ha, Ms, Ha, Ms, Ha, Ms, Ha, Ha
Wo, Wo, Wo, Wo, Wo, Wo, Wo, Wo, Ww, Wo, Ww, Ww, Ha, Ha, Ha, Aa^Es, Ha, Ms, Ms, Ms, Ms, Ms, Ha, Ha, Ms, Ms, Ms, Ms, Ms, Ms, Ha, Ha, Ms, Ha, Gd, Aa, Gd, Aa, Rb, Aa, Aa, Aa, Gd, Ha, Ms, Ms, Ms, Ms, Ms, Ms, Ms, Ms, Ms, Ms, Ms
Ww, Ww, Ww, Wo, Ww, Wo, Ww, Ww, Ha, Ha, Ha, Ha, Ha, Ha, Ha, Gd, Aa, Ms, Ha, Ms, Ms, Ha, Ms, Ms, Ms, Ms, Ms, Ms, Ms, Ms, Ha, Ms, Ms, Ha, Ha, Gg, Gs, Aa^Vha, Re, Gs, Re, Gs, Aa, Ha, Gd, Ha, Ha, Ms, Ms, Ms, Ha, Ms, Ms, Ms, Ms
Ha, Ha, Ha, Ww, Ww, Ww, Ha, Ha, Ms, Ms, Ms, Ms, Ms, Ms, Ha, Gs, Ha, Aa, Aa, Ha, Gd, Ha, Ha, Ms, Ha, Ha, Ha, Ms, Ms, Ms, Ms, Ms, Ha, Ha, Ha, Gs, Ha, Aa, Gs, Re, Gs^Es, Rd, Rb, Gs, Re, Aa, Aa, Ha, Ha, Ha, Ms, Ms, Ms, Ms, Ms
Ha, Ha, Ha, Ha, Ms, Ha, Ha, Ms, Ha, Ms, Ha, Ms, Ms, Ms, Ms, Ha, Ha, Gd, Ha, Gs, Gs, Ha^Vhha, Aa, Ha, Gs, Ha, Ha, Ha, Ha, Ms, Ms, Ha, Ms, Ha, Ha, Ha, Ha, Gd, Ha, Aa, Gd, Re, Aa, Re, Re, Aa, Aa, Ha, Gs, Ha, Ha, Ms, Ha, Ms, Ms
Ha, Ha, Ha, Ms, Ms, Ms, Ms, Ha, Ha, Ha, Ha, Ms, Ms, Ms, Ms, Ms, Ms, Ha, Ms, Ha, Ha, Gd, Ha, Aa, Ha, Aa, Aa, Ha, Ha, Ha, Ms, Ms, Ms, Ms, Ms, Ha, Ha, Ha, Ms, Ha, Ha, Aa, Ha, Aa, Re, Aa, Re, Gd, Gs, Ha, Gs, Ha, Ha, Ms, Ms
Ha, Ha, Ha, Ms, Ms, Ms, Ms, Ha, Ms, Ha, Ha, Ha, Ms, Ms, Ms, Ha, Ha, Ha, Ms, Ms, Ms, Ha, Ms, Ha, Ha, Gd^Es, Aa, Gs, Ha, Ha, Ha, Ms, Ms, Ms, Ms, Ha, Ha, Ms, Ms, Ha, Ms, Ha, Ha, Gs, Ha^Vhha, Re, Aa, Rb, Ce, Gs, Gg, Gs, Aa, Ha, Ha
Ha, Ha, Ha, Ms, Ms, Ha, Ms, Ha, Ms, Ms, Ms, Ms, Ms, Ms, Ha, Ha, Ms, Ms, Ms, Ms, Ms, Ms, Ms, Ms, Ms, Ha, Ha, Ha^Vhha, Gd, Ha, Ms, Ha, Ms, Ms, Ms, Ms, Ms, Ha, Ms, Ms, Ms, Ms, Ha, Gs, Ha, Aa, Aa, Re, Ce, 1 Ke, Ce, Gs, Re, Aa, Aa
Ha, Ha, Ha, Ha, Ms, Ms, Ms, Ha, Ms, Ms, Ms, Ms, Ms, Ms, Ms, Ms, Ms, Ms, Ms, Ms, Ms, Ms, Ms, Ms, Ms, Ms, Ha, Gs, Gd, Ha, Ms, Ms, Ms, Ms, Ms, Ms, Ms, Ms, Ms, Ms, Ms, Ms, Ms, Ha, Ms, Ha, Ha, Gs, Gd, Gs, Aa, Rd, Re, Aa, Aa
Ha, Ha, Ha, Ha, Ms, Ms, Ms, Ms, Ha, Ms, Ms, Ms, Ms, Ms, Ms, Ms, Ms, Ms, Ms, Ms, Ms, Ms, Ms, Ms, Ms, Ms, Ha, Ha, Ha, Ha, Ms, Ms, Ms, Ms, Ms, Ms, Ms, Ms, Ms, Ms, Ms, Ms, Ms, Ms, Ms, Ha, Ha, Ha, Aa, Aa, Gs, Gg, Re, Rb, Re
Ms, Ms, Ms, Ms, Ms, Ms, Ms, Ms, Ms, Ms, Ms, Ms, Ms, Ms, Ms, Ms, Ms, Ms, Ms, Ms, Ms, Ms, Ms, Ms, Ms, Ms, Ha, Ha, Ms, Ms, Ms, Ms, Ms, Ms, Ms, Ms, Ms, Ms, Ms, Ms, Ms, Ms, Ms, Ms, Ms, Ms, Ha, Ha, Aa, Aa, Aa, Gs, Re, Rb, Re
