Xu, Xu, Xu, Xu, Xu, Qxu, Qxu, Xu, Xu, Xu, Qxu, Qxu, Qxu, Xu, Xu, Xu, Xu, Xu, Xu, Xu, Xu, Xu, Xu, Xu, Xu, Xu, Xu, Xu, Xu, Xu, Xu, Xu, Xu, Xu, Xu, Xu, Xu, Xu, Xu, Xu, Xu, Xu, Xu, Xu
Xu, Xu, Xu, Xu, Xu, Qxu, Qxu, Qxu, Qxu, Xu, Qxu, Qxu, Qxu, Xu, Xu, Xu, Xu, Xu, Xu, Xu, Xu, Xu, Xu, Xu, Xu, Xu, Xu, Xu, Xu, Xu, Xu, Xu, Xu, Xu, Xu, Xu, Xu, Xu, Xu, Xu, Xu, Xu, Xu, Xu
Xu, Xu, Xu, Xu, Xu, Xu, Qxu, Qxu, Qxu, Xu, Uu, Qxu, Xu, Xu, Xu, Xu, Xu, Xu, Uu^Uf, Uu^Uf, Xu, Xu, Uu, Xu, Uu, Xu, Xu, Xu, Xu, Xu, Xu, Xu, Xu, Xu, Xu, Xu, Xu, Xu, Xu, Xu, Xu, Xu, Xu, Xu
Xu, Xu, Xu, Xu, Xu, Xu, Xu, Qxu, Re, Uu, Re, Re, Uu, Xu, Xu, Xu, Uu^Em, Xu, Re, Uu, Uh, Xu, Xu, Re, Re, Re, Uu, Xu, Xu, Xu, Xu, Xu, Xu, Xu, Xu, Xu, Xu, Xu, Xu, Xu, Xu, Xu, Xu, Xu
Uu, Xu, Xu, Xu, Xu, Xu, Xu, Xu, Xu, Re, Uu, Re, Re, Xu, Uu, Uu^Em, Uu, Re, Xu, Xu, Xu, Xu, Xu, Re, Uu, Re, Re, Uu, Xu, Xu, Xu, Xu, Xu, Xu, Xu, Xu, Xu, Xu, Xu, Xu, Xu, Xu, Xu, Xu
Xu, Uu, Uu, Uu, Uu, Xu, Xu, Xu, Xu, Xu, Xu, Xu, Re, Re, Re, Uu, Xu, Xu, Xu, Xu, Xu, Xu, Xu, Xu, Xu, Re, Re^Xo, Xu, Xu, Xu, Xu, Xu, Xu, Xu, Xu, Xu, Xu, Xu, Xu, Xu, Xu, Xu, Xu, Xu
Xu, Xu, Xu, Xu, Xu, Re, Xu, Xu, Xu, Xu, Re, Uu, Uu, Uu, Xu, Xu, Xu, Xu, Uu, Uu, Re, Uu, Uu, Xu, Xu, Xu, Re, Re, Uu, Xu, Xu, Xu, Xu, Xu, Xu, Xu, Xu, Xu, Xu, Xu, Xu, Xu, Xu, Xu
Xu, Xu, Xu, Xu, Xu, Re, Re, Xu, Uu, Re, Uu, Uu, Xu, Xu, Xu, Xu, Xu, Xu, Uu, Re, Re, Re, Xu, Xu, Xu, Uu, Uu, Uu, Xu, Xu, Re, Uu, Uu, Xu, Xu, Xu, Xu, Xu, Xu, Xu, Xu, Xu, Xu, Xu
Xu, Xu, Xu, Xu, Xu, Xu, Xu, Uu, Xu, Uu, Xu, Xu, Xu, Xu, Uu, Uu, Uu, Xu, Xu, Uu, Xu, Re^Xo, Re, Uu, Uu, Uu, Uu^Ii, Re, Xu, Uu, Re, Re, Uu, Xu, Xu, Xu, Xu, Xu, Xu, Xu, Xu, Xu, Xu, Xu
Xu, Xu, Xu, Xu, Xu, Xu, Xu, Xu, Xu, Uu, Xu, Xu, Xu, Uu, Re, Re, Re, Xu, Xu, Xu, Uu, Re, Uu, Uu, Re, Uu^Ii, Re^Ii, Re^Ii, Re, Re^Xo, Xu, Uu, Xu, Xu, Xu, Xu, Xu, Xu, Xu, Xu, Xu, Xu, Xu, Xu
Xu, Xu, Xu, Xu, Xu, Xu, Xu, Xu, Xu, Uu, Xu, Xu, Xu, Uu, Xu, Re, Xu, Re^Xo, Re, Uu, Uu^Ii, Uu^Ii, Uu^Ii, Re, Re, Re^Ii, Re^Ii, Uu^Ii, Uu, Re, Xu, Xu, Xu, Xu, Urb, Xu, Xu, Xu, Xu, Xu, Xu, Xu, Ha^Fpa, Ha^Fpa
Xu, Xu, Xu, Xu, Xu, Xu, Xu, Xu, Uh, Uu, Xu, Xu, Xu, Xu, Xu, Xu, Xu, Re, Uu, Uu, Uu^Ii, Re^Ii, Re^Ii, Re, Re, Uu, Uu, Uu, Re, Xu, Xu, Xu, Xu, Urb, Urb, Urb, Xu, Xu, Xu, Xu, Xu, Ha^Fpa, Ha^Fpa, Ha^Fpa
Xu, Xu, Xu, Xu, Xu, Xu, Xu, Xu, Xu, Uu, Uu, Xu, Xu, Xu, Xu, Xu, Uu, Uu, Re, Uu, Re, Re^Ii, Uu, Re, Uu, Uu, Urb, Urb, Urb^Ii, Re^Ii, Re^Ii, Uu^Ebn, Uu, Xu, Re, Xu, Xu, Xu, Xu, Xu, Xu, Ha, Aa, Ha
Xu, Xu, Xu, Xu, Xu, Xu, Xu, Xu, Uu, Uu, Uu, Uh, Uh, Xu, Xu, Xu, Xu, Uu, Uu, Re, Re, Uu, Uu, Uu, Urb, Urb, Urb, Urb, Urb^Ii, Urb^Ii, Urb^Ii, Uu, Uu, Uu, Re, Uu, Xu, Xu, Xu, Xu, Aa, Aa, Aa, Aa
Xu, Xu, Xu, Xu, Xu, Xu, Uu^Em, Uu^Em, Uu^Em, Uu, Uu, Uh, Xu, Xu, Xu, Xu, Xu, Xu, Xu, Xu, Uu, Uu, Uu, Urb, Urb, Urb, Urb, 1 Urb, Urb, Urb^Ii, Co, Urb, Urb, Re, Re, Uu, Xu, Xu, Xu, Xu, Aa, Gd, Gd, Gd
Xu, Xu, Xu, Xu, Xu, Xu, Xu, Uu^Uf, Xu, Xu, Uu, Uu, Xu, Xu, Urb^Edt, Urb^Edt, Urb^Edt, Xu, Xu, Xu, Uu, Uu, Uu, Re, Re^Ii, Urb^Ii, Urb^Ii, Urb, Co, Co, 2 Co^Kov, Co, Co, Urb, Urb, Uu, Xu, Xu, Uu, Uu, Gd, Gd, Aa, Gd
Xu, Xu, Xu, Xu, Xu, Xu, Xu, Xu, Xu, Xu, Uu, Uu, Re, Xu, Urb^Edt, Urb^Edt, Urb^Edt, Xu, Xu, Xu, Re, Uu, Re, Uu, Uu^Ii, Re^Ii, Uu^Ii, Urb, Urb, Co, Co, Co, Urb, Urb, Re, Uu, Xu, Xu, Uu, Uu, Uu, Aa, Ha, Aa
Xu, Xu, Xu, Xu, Xu, Xu, Xu, Xu, Xu, Uh, Xu, Uu, Uu, Re, Re, Re, Uu, Xu, Xu, Xu, Re, Re, Xu, Xu, Xu, Uu^Ii, Uu, Uu, Uu, Urb, Urb, Urb, Re, Re, Xu, Uu^Ebn, Xu, Xu, Uu, Uu, Xu, Xu, Xu, Xu
Xu, Xu, Uu, Xu, Uu, Uu, Uu, Xu, Xu, Xu, Xu, Xu, Xu, Uu, Uu, Uu, Uu, Uu, Re, Re, Re, Uu, Xu, Xu, Xu, Xu, Xu, Re^Ebn, Uu, Uu, Re, Uu, Uu, Re, Xu, Xu, Xu, Xu, Uu, Uu, Xu, Xu, Xu, Xu
Gd, Uu, Re, Uu, Re, Uu, Uu, Uu, Uu, Xu, Xu, Xu, Xu, Xu, Xu, Uh, Uh, Uu, Uu, Re, Xu, Uu, Uu, Xu, Xu, Xu, Xu, Re, Uu, Uu, Xu, Uu, Uu, Uu, Re, Xu, Uu, Uu, Uu, Uu, Xu, Xu, Xu, Xu
Gd, Gd, Re, Re, Uu, Uu, Uu, Uu, Uu, Uu, Uu, Xu, Xu, Xu, Xu, Xu, Xu, Xu, Xu, Xu, Xu, Uu^Uf, Uu, Uu, Uu, Xu, Uu, Uu, Uu, Re, Xu, Uu, Uu, Uu, Uu, Uu, Uu, Uu, Uu, Uh, Xu, Xu, Xu, Xu
Gd, Gd, Uu, Uu, Xu, Xu, Xu, Xu, Xu, Uu, Re, Uu, Uu, Uh, Uu, Xu, Xu, Xu, Xu, Xu, Uu^Em, Uu^Em, Uu^Em, Xu, Xu, Uu, Re, Re, Uu, Xu, Xu, Xu, Xu, Uu, Uu, Uu, Uu, Uu, Uh, Uh, Xu, Xu, Xu, Xu
Gd, Gd, Xu, Xu, Xu, Xu, Xu, Xu, Xu, Xu, Xu, Re, Re, Uu, Re, Re, Re, Re, Re, Re, Uu, Uu^Em, Xu, Xu, Xu, Xu, Xu, Re, Uu, Xu, Xu, Xu, Xu, Xu, Xu, Uu, Uh, Uh, Uh, Uh, Xu, Xu, Xu, Xu
Gd, Gd, Xu, Xu, Xu, Xu, Xu, Xu, Xu, Xu, Xu, Xu, Uh, Uu, Uu, Re, Uu, Re, Uu, Re, Uu, Xu, Xu, Xu, Uu^Uf, Uu^Uf, Uu^Em, Uu, Re, Uu, Urb^Edt, Urb^Edt, Xu, Xu, Xu, Xu, Xu, Xu, Xu, Xu, Xu, Xu, Xu, Xu
Gd, Gd, Xu, Xu, Xu, Xu, Xu, Xu, Xu, Xu, Xu, Xu, Xu, Uh, Uh, Uh, Uh, Uu, Xu, Xu, Xu, Uu, Uu, Xu, Uu^Em, Uu^Uf, Uu^Em, Uu^Em, Re, Re, Urb^Edt, Urb^Edt, Xu, Xu, Xu, Xu, Xu, Xu, Xu, Xu, Xu, Xu, Xu, Xu
Gd, Xu, Xu, Xu, Xu, Xu, Xu, Xu, Xu, Xu, Xu, Xu, Xu, Uh, Xu, Uh, Xu, Xu, Xu, Xu, Xu, Uu, Uh, Uu, Uu^Em, Uu^Em, Xu, Re, Uu^Em, Re, Uh^Em, Xu, Xu, Xu, Xu, Xu, Xu, Xu, Xu, Xu, Xu, Xu, Xu, Xu
Xu, Xu, Xu, Xu, Xu, Xu, Xu, Xu, Xu, Xu, Xu, Xu, Xu, Xu, Xu, Xu, Xu, Xu, Xu, Xu, Xu, Xu, Xu, Uh, Xu, Xu, Xu, Uu^Uf, Uh^Em, Uu^Em, Xu, Xu, Xu, Xu, Xu, Xu, Xu, Xu, Xu, Xu, Xu, Xu, Xu, Xu
Xu, Xu, Xu, Xu, Xu, Xu, Xu, Xu, Xu, Xu, Xu, Xu, Xu, Xu, Xu, Xu, Xu, Xu, Xu, Xu, Xu, Xu, Xu, Xu, Xu, Xu, Xu, Xu, Xu, Xu, Xu, Xu, Xu, Xu, Xu, Xu, Xu, Xu, Xu, Xu, Xu, Xu, Xu, Xu
Xu, Xu, Xu, Xu, Xu, Xu, Xu, Xu, Xu, Xu, Xu, Xu, Xu, Xu, Xu, Xu, Xu, Xu, Xu, Xu, Xu, Xu, Xu, Xu, Xu, Xu, Xu, Xu, Xu, Xu, Xu, Xu, Xu, Xu, Xu, Xu, Xu, Xu, Xu, Xu, Xu, Xu, Xu, Xu
Xu, Xu, Xu, Xu, Xu, Xu, Xu, Xu, Xu, Xu, Xu, Xu, Xu, Xu, Xu, Xu, Xu, Xu, Xu, Xu, Xu, Xu, Xu, Xu, Xu, Xu, Xu, Xu, Xu, Xu, Xu, Xu, Xu, Xu, Xu, Xu, Xu, Xu, Xu, Xu, Xu, Xu, Xu, Xu
