Ha, Ha, Ha, Ha, Ms, Ms, Ms, Ms, Ms, Ms, Ha, Ha, Aa, Aa, Aa, Gll^Fp, Aa^Fp, Aa^Fp, Ha^Fp, Ha^Fp, Ms, Ms, Ms, Ms, Ms, Ms, Ms, Ms, Ms, Ms, Ha, Ha, Ha
Ha, Ha, Ha, Ha, Ms, Ms, Ms, Ms, Ms, Ms, Ha, Ha, Aa, Aa, Ha, Gs, Aa^Voa, Aa, Ha, Ha^Fp, Ms, Ms, Ms, Ms, Ms, Ms, Ms^Voa, Ms, Ms, Ms, Ha^Voa, Ha, Hh
Aa, Aa, Aa, Ha, Ha, Ms, Ha, Ha, Ha, Ha, Aa, Ha, Gs^Vo, Gs, Ha, Hh, Aa^Es, Aa, Aa, Ha, Ha, Ms, Ms, Ms, Ms, Ms, Ha, Ha, Coa, Coa, Coa, Hh, Hh
Ha, Ha, Ha, Ha, Ha, Ha, Aa^Es, Aa, Aa, Ha, Hh, Gs, Hh, Aa, Hh, Hh, Gs, Aa, Gs, Hh, Hh, Ha, Ha, Ms, Ha, Ha, Ha, Aa, Co, 2 Koa, Co, Aa^Voa, Aa
Ms, Ms, Ms, Ha, Ha, Aa, Aa, Aa, Aa, Gs, Mm, Hh, Hh, Gll, Gs, Gd, Gd, Gg, Co, Co, Co, Ha, Gll^Fp, Hh, Hh, Ha, Re, Re, Aa, Co, Ha, Re, Re
Ms, Ms, Ms, Ms, Ms, Ha, Aa, Aa, Ha, Mm, Mm, Mm, Hh, Gll^Fp, Gll^Fp, Gs, Co, Co, 1 Ke, Co, Co, Gs, Gs, Gll, Re, Re, Gs^Vo, Aa, Ha, Ha, Ha^Voa, Ha, Ha
Ms, Ms, Ms, Ms, Ha, Ha, Gs, Gs^Vo, Mm, Mm, Mm, Mm, Hh, Gll^Fp, Gs^Efm, Gs, Co, Co, Co, Co, Re, Re, Re, Re^Vo, Gs^Es, Gg, Aa, Ha, Ha, Ha, Ms, Ms, Ms
Ms, Ms, Ms, Ms, Ha, Gs^Vo, Aa, Ha, Mm, Mm, Mm, Mm, Ha, Gll, Aa, Gs, Gs, Co, Re, Re, Gs, Aa, Gs, Gs, Aa, Aa, Ha, Ha, Ha, Ha, Ha, Ms, Ms
Ms, Ms, Aa^Voa, Ha, Coa, Coa, Co, Hh, Ha, Mm, Ha, Ha, Gs, Aa, Aa, Gd, Re, Re, Gs, Gg^Es, Gg^Vo, Aa, Ha, Ha, Ha, Aa, Ms, Ms, Ms, Ha, Ms, Ms, Ms
Hh^Fp, Ha, Ha, Ha, Coa, 3 Ko, Co, Re, Hh^Vo, Hh, Gs, Gs, Re, Gs^Vo, Re, Re, Gs, Gs, Gs^Fp, Gs, Aa, Ha, Ha, Ha, Ms, Ms, Ha, Ms, Ha, Ha, Ha, Ms, Ms
Gll^Fp, Gll, Gs^Vo, Gs, Re, Co, Re, Re, Gs, Gs, Re, Gg, Gs, Re, Gll, Gll, Gs, Hh, Gs, Gs, Hh, Aa, Ha, Ha^Voa, Ha, Ha^Voa, Ms, Ha, Ms, Ms, Ha, Ms, Ms
Gll^Fp, Gll, Re, Re, Hh, Hh, Hh, Re, Gs, Gd, Aa, Gs^Es, Re, Re, Gll^Fp, Gll^Fp, Gll, Hh, Gs, Hh, Gs, Gg, Ha, Ms, Ha, Ms, Ha, Ms, Ms, Ms, Ha, Ms, Ms
Gs^Fp, Gll^Fp, Gll, Re, Hh, Hh, Hh, Gg, Gs^Vo, Aa, Gs, Re, Gs, Gll, Gll^Fp, Gs^Fp, Re, Hh, Gs, Gs, Chr, Cha, Cha, Ms, Ms, Ha, Ha, Ha, Ms, Ha, Ms, Ms, Ms
Gll, Gll^Fp, Gll, Hh, Gs^Vo, Hh, Gg, Gs, Gs^Eff, Gg, Re, Re, Aa, Gll^Fp, Gll^Fp, Gll, Hh, Re, Gs, Gg, Chr, 4 Khr, Cha, Ms, Ha, Ha, Ha, Ha, Aa, Ha, Ha, Ms, Ms
Aa, Aa, Aa, Aa, Gs, Gs^Es, Gs, Gd, Gg^Eff, Gs^Eff, Re, Aa, Aa, Gs, Gg, Gs, Gd, Gs^Vo, Gs, Hh, Hh^Vo, Chr, Gs, Ha, Gs, Aa, Aa, Aa, Aa, Ha, Ha, Ha, Ha
Ai, Ai, Ai, Aa, Aa, Gs, Gg, Gs, Re, Re, Gs, Gs, Gg, Gs, Aa, Gs, Gs, Gs, Gs, Hh, Hh, Hh, Gs, Gg, Gs^Vo, Gs, Gg, Gd, Aa, Aa, Aa, Gs, Ha
Wog, Ai, Ai, Aa, Wog, Wwg, Wwg, Gs, Wwg^Bw|, Gs, Wwg, Wwg, Wwg, Wwg, Wwg, Gs, Wwg, Gg, Wwg, Gg, Gs, Hh, Gd, Gd, Gg, Gg^Es, Gs, Aa, Gs, Aa^Es, Gd, Ha, Ha
Wog, Ai, Ai, Wog, Wog, Wog, Wog, Wwg, Wwg^Bw|, Wwg, Wog, Wog, Ai, Ai, Wog, Wog, Wog, Wog, Wog, Wwg, Wwg, Gs, Wwg, Gs, Wwg, Gs, Wwg, Aa, Aa, Gs, Aa, Gs, Aa
Wog, Wog, Wog, Wog, Wog, Wog, Wog, Wog, Wog^Bw|, Wog, Wog, Wog, Wog, Ai, Wog, Wog, Wog, Wog, Wog, Wog, Wog, Wwg, Wwg, Wwg, Wwg, Wwg, Wwg, Wwg, Ai, Aa, Aa, Aa, Aa
Wog, Wog, Wog, Wog, Wwg, Wog, Wwg, Wog, Wwg^Bw|, Wog, Wwg, Wog, Wwg, Wog, Wwg, Wog, Wog, Wog, Wog, Wog, Wog, Wog, Wog, Wog, Wog, Wog, Wog, Wwg, Wog, Ai, Ai, Ai, Ai
Wog, Wog, Wwg, Wwg, Ds, Wwg, Ds, Wwg, Re, Wwg, Ds, Wwg, Ds, Wwg, Ds, Wwg, Wwg, Wwg, Wwg, Wog, Wwg, Wog, Wog, Wog, Wog, Wog, Wog, Wog, Wog, Ai, Ai, Ai, Wog
Wwg, Wwg, Ds, Ds, Gs, Ds, Gs, Ds, Re, Ds, Gs, Ds, Ds, Ds, Ds, Ds, Ds, Ds, Ds, Wwg, Ds, Wwg, Wwg, Wwg, Wwg, Wog, Wwg, Wog, Wwg, Wog, Wog, Wog, Wog
Ds, Ds, Gg, Gd, Gs, Gs, Gs, Re, Gs, Gs, Gg, Gg, Gs, Gs, Gd^Es, Ds, Gs, Ds, Gs, Ds, Gs, Ds, Ds, Ds, Ds, Wwg, Ds, Wwg, Wwg, Wwg, Wog, Wog, Wog
Gs, Gs, Gs, Gs^Efm, Gs, Gd, Re, Re, Gs^Es, Gd, Gs, Gs, Gs, Gs, Gs, Gs, Gd, Gs, Gd^Efm, Gs, Gs, Gs, Gs, Gs, Gg, Ds, Gg, Ds, Ds, Wwg, Wwg, Wog, Wog
Gd, Gd^Es, Gs, Gg, Gd, Gs, Re, Gs, Gs, Gs, Gs, Gs, Gs, Gs, Gs, Gg, Gs, Gg, Gs, Gs, Gg, Gs, Gd, Gs, Gd, Gs, Gs, Ds, Wwg, Wwg, Wog, Wog, Wog
Gg, Gs, Gs, Gd, Gs, Gs, Re, Gs, Gs, Gs, Gs, Gs, Gd, Gs, Gd, Gd, Gs, Gs, Gd, Gs, Gd^Es, Gd^Es, Gg, Gs, Gg, Gs, Gd, Ds, Wwg, Wwg, Wog, Wog, Wog
