Gs, Gs, Gs, Gs, Gs, Gs, Gd, Gd, Gd, Gd, Gs, Gs, Gd, Gd, Gd, Gs, Gd, Gs, Gd, Gs, Gd, Gs, Gd, Gs, Gs, Gs, Gd, Gd, Hh, Hh, Hh, Gd, Gd, Gs, Gd, Gd, Gs, Gs, Gs, Gs, Gs, Gs, Ce, Gs, Rd, Rd, Rd
Gd, Gd, Gd, Gd, Gs, Gd, Gs, Gd, Gs, Gs, Gd, Gd, Gs, Gs, Gs, Gd, Gs, Gs, Gs, Gs, Gs, Gd, Gd, Gd, Gs, Gs, Gd, Gs, Hh, Hh, Hh, Gd, Gd, Gs, Gs, Gs, Gs, Gd, Gs, Gd, Gd, Gs, Ce, Gs, Rd, Rd, Rd
Gs, Gd, Gs, Gs, Ss, Gs, Gs, Gd, Gd, Gs, Gs, Ds, Ds, Ds, Ss, Gs, Gs, Hh, Hh, Hh, Gs, Gs, Gs, Gd, Gs, Gs, Gs, Hh, Gs, Gs, Hh, Ss, Ss, Hh, Gd, Gd, Gs^Vh, Ds, Ds, Gd, Gs, Ce, 1 Ke, Gs, Ss, Gs, Gs
Gs, Gs, Gs, Ss, Hh, Ss, Gs, Gs, Gs^Vh, Gs, Gs, Ds, Ds, Ss, Ss, Gs, Gs, Gs, Hh, Hh, Hh, Gs, Ds, Ds, Gs, Gs, Gs, Gs, Gs, Ds, Hh, Ss, Ss, Gd, Gd, Gd, Ss, Ds, Ss, Ds, Ss, Ce, Ce, Ce, Ss, Ss, Ss
Gd, Gd, Ss, Hh, Hh, Ss, Gs, Gs, Ss, Ds, Ds, Ds, Gs, Gs, Gs, Gs, Ds, Hh, Hh, Mm, Hh, Gd, Ds, Gd, Gs, Gs, Ss, Ss, Ss, Hh, Ds, Ss, Ds, Ss, Ss, Hh, Ss, Ss, Ds, Ds, Ds, Ss, Gs, Ss, Ss, Ss, Ss
Gd, Gs, Ss, Hh, Ss, Ss, Ss, Ss, Ss, Ds, Ss, Gs, Gs, Gs, Ds, Ds, Ds, Gs, Ss, Hh, Gs, Gd, Ds, Gs, Gs, Ss, Ss, Ds, Ds, Gs, Gs, Ds, Ss, Ss, Hh, Hh, Gs, Gs, Gs, Ss, Ss, Ds, Ds, Gs, Ss^Vhs, Ss, Ss
Ss, Ss, Ss, Ss, Ww, Ss, Ww, Ss, Ss, Ss, Ss, Gs, Gs, Gs, Gs, Ds, Gs, Ss, Ss, Ss, Gs, Gs, Ss, Ds, Gs, Ds, Ss, Ss, Ss^Vhs, Ds, Ss, Gs, Ss, Ss, Hh, Hh, Gs^Vh, Gs, Ss, Ds, Rd, Ds, Ds, Ds, Gs, Gs, Gs
Ds, Ds, Ss, Ss, Ss, Ss, Ww, Ww, Ss, Ss, Ss, Gs, Ds, Ds, Gs, Gs, Gs, Ss, Ss, Ss, Ss, Ss, Ds, Ds, Ds, Ds, Ss, Gs, Ss, Ss, Gs, Gs, Ss, Ss, Ss, Hh, Ss, Hh, Ss, Rd, Ss, Ss, Gs, Ss, Gs, Ds, Ds
Ss, Ss, Ss, Ss, Ss, Ss, Ss, Ss, Ss, Ss, Ds, Gs, Gd, Gs, Hh, Gs, Gs, Ss, Ww, Ww, Ss, Ds, Ds, Ss, Ds, Gs, Ss, Ds, Ss, Gs, Gs, Gs, Gs, Ss, Gs, Ss, Ww, Ss, Ss, Rd, Ss, Ss, Ss, Ss, Ds, Ds, Ds
Gs, Gs, Gs, Gs, Gs, Ss, Ss, Ss, Ss, Ds, Ds, Gs, Gd, Hh, Hh, Gs, Gs, Ss, Ss, Ww, Ss, Ss, Ds, Ds, Ss, Ds, Ds, Ss, Ss, Ss, Gs, Gs, Hh, Gs, Gs, Ss, Ww, Ww, Ss, Ss, Gs, Ss, Ww, Ss, Ss, Gs, Gs
Gs, Gs, Gd, Gs, Gs, Ss^Vhs, Ss, Ss, Gs, Ds, Gd, Gd, Gd, Hh, Hh, Hh, Gs, Ss^Vhs, Ss, Ss, Ss, Ss, Ss, Ss, Ss, Ss, Ss, Ss, Ss, Ss, Ss, Hh, Hh, Hh, Gs, Ss, Ss, Ss, Rd, Rd, Gs, Ss, Ww, Ww, Ss, Ss, Ss
Gd, Gd, Ds, Gs, Gs, Gs, Gs, Gs, Gs, Gs, Gs, Gs, Gs, Gd, Gs, Gs, Gs, Gs, Gs, Ss, Gs, Ss, Gs, Ss, Ds, Gs, Gs, Ss, Ss, Ss, Ss, Hh, Hh, Hh, Gs, Gs, Rd, Gs, Ds, Ds, Ss, Ss, Ss, Ss, Gs, Ds, Ds
Gs, Gd, Ds, Gs, Ds, Ds, Gd, Gs, Gs, Gs, Ss, Gs, Gs, Gs, Gs, Ss, Ss, Gs, Gs, Gs, Gs, Gs, Ds, Gs, Ds, Ds, Ss, Ss, Ss, Ss, Gs, Gs, Hh, Gs, Rd, Rd, Ss, Gs, Gs, Ds, Gs, Gs, Hh, Hh, Hh, Hh, Hh
Ds, Gs, Ds, Ss, Ss, Ds, Gd, Gs, Ds, Ss, Ss, Ss, Gs, Gs, Gs, Ss, Ss, Gs, Gs, Gs, Ss, Ss, Ss, Ds, Ds, Gs, Ss, Ss, Ss, Gs, Rd, Gs, Rd, Ss, Ss, Ss, Ss, Ss, Ss, Ss, Gs, Gs, Gs, Gs, Mm, Mm, Mm
Gs, Ds, Ss, Ss, Ss, Ds, Ds, Ds, Hh, Ss, Ss, Ss, Ss, Ss, Ss, Ss, Gs, Gs, Ss, Ss, Ss, Ss, Ss, Ss, Gs, Gs, Gs, Ss, Gs, Rd, Ds, Rd, Gs^Vh, Ss, Ss, Ss, Ww, Ss, Ss, Ss, Ss, Gs, Gs, Hh, Hh, Hh, Hh
Gs, Gs, Ss, Ss, Ss, Ds, Gs, Gs, Hh, Gs, Gs, Ss, Ss, Gs, Ss, Ss, Gs, Gs, Ss, Ss, Gs, Gs, Ss, Ss, Ss, Gs, Ss, Ss, Ss, Rd, Ds, Ds, Ds, Gs, Ss, Ss, Ww, Ww, Ss, Ss, Ss, Gs, Ss, Ss, Ss, Ss, Ss
Ds, Gs, Ss, Ss, Ss, Ss^Vhs, Gs, Hh, Gs, Gs, Hh, Ss, Ss, Ss, Ss, Gs, Ss, Gs, Gs, Ss, Ss, Gs, Ss, Ss, Ss, Ss, Rd, Rd, Ss, Ss, Gs, Ds, Ss, Ss, Ss, Ss, Ss, Ss, Ss, Ss, Gs, Gs, Ss^Vhs, Ss, Ss, Gs, Gs
Gs, Ds, Gs, Ss, Ww, Ss, Ss, Hh, Hh, Hh, Ds, Gs, Gs, Ss^Vhs, Ss, Gs, Ss, Gs, Gs, Gs, Ss, Ss, Ss, Ss^Vhs, Rd, Ss, Ww, Ww, Ww, Ss, Gs, Ss, Ss, Ww, Ss, Ss, Gs, Gs, Gs, Gs, Ss, Ss, Ss, Gs, Gs, Ds, Ds
Gs, Ds, Gs, Ss, Ss, Ss, Ss, Ss, Gs, Gs, Ds, Ds, Ds, Ss, Ss, Ss, Ww, Ss, Ss, Gs, Ss, Ss, Ss, Ss, Rd, Ss, Ss, Ww, Ss, Ss, Gs, Ss, Ss, Ss, Gs, Gs, Gs, Gs, Ss, Ss, Ss, Ss, Ss, Gs, Gs, Ds, Ss
Gs, Gs, Gs, Gs, Gs, Ss, Ss, Ss, Gs, Gs, Ds, Ds, Ss, Ss, Ss, Ss, Ww, Ss, Ss, Gs, Gs, Ss, Rd, Rd, Gs, Ss, Ss, Ww, Ss, Ss, Gs, Gs, Gs, Gs, Ss, Gs, Gs, Hh, Hh, Hh, Hh, Ss, Ss, Ss, Gs, Gs, Gs
Gs, Gs, Gs, Ds, Gs, Ss, Ds, Ss, Gs, Ds, Gs, Gs, Gs, Ss, Ss, Ss, Ss, Ss, Gs, Gs, Gs, Hh, Hh, Hh, Hh, Gs, Ww, Ww, Ss, Ss, Ww, Gs, Gs, Gs^Vh, Ss, Ss, Gs, Hh, Hh, Hh, Hh, Ss, Ss, Ss, Gs, Ss, Ss
Ds, Gs, Gs, Ds, Ds, Ds, Gs, Ds, Ds, Ds, Hh, Gs, Gs, Ss, Ss, Ss, Ss, Ss, Rd, Rd, Ss, Ss, Ss, Hh, Ww, Ww, Wo, Ww, Wo, Ww, Ww, Ww, Ww, Ss, Ss, Ss, Gs, Ss, Hh, Mm, Hh, Hh, Ss, Gs, Ds, Ss, Ds
Ds, Ds, Ds, Gs, Gs^Vh, Hh, Hh, Gs, Ds, Ds, Hh, Hh, Gs, Ss, Ss, Ww, Ss, Rd, Gs, Ss, Ss, Ss, Ss, Gs, Ww, Wo, Wo, Ww, Ss, Wo, Ww, Wo, Ww, Ww, Gs, Gs, Hh, Hh, Ss, Hh, Mm, Hh, Ss, Ss, Ds, Ds, Ds
Ds, Ds, Gs, Ds, Ds, Ds, Ds, Ds, Gs, Gs, Hh, Hh, Gs, Gs, Gs, Ss, Ss, Rd, Gs, Gs^Vh, Gs, Gs, Ss, Ww, Wo, Ww, Ww, Ss, 3 Chs, Ss, Wo, Wo, Wo, Ww, Gs, Hh, Mm, Mm, Ss, Ss, Hh, Hh, Ww, Ss, Ss, Ds, Ds
Gs, Gs, Gs, Gs, Ss, Ds, Ds, Ss, Ss, Ss, Ss, Gs, Gs, Ss, Ss, Gs, Gs, Gs, Ss, Ss, Ss, Ss, Gs, Ss, Ww, Wo, Ww, Ss, Ss, Ss, Wo, Wo, Ww, Ww, Gs, Hh, Hh, Hh, Ss, Hh, Ss, Ss, Ss, Ww, Ss, Ds, Ds
Gs, Gs, Gs, Ss, Ss, Ss, Ss, Ss, Ss, Ss, Ss, Ds, Ds, Gs, Ds, Ds, Ds, Rd, Gs, Ss, Ss, Gs, Ss, Ss, Ww, Wo, Wo, Wo, Wo, Ww, Ww, Ww, Gs, Gs, Gs, Ds, Ss, Gs, Ss, Ss, Ss, Ss, Gs, Ss, Ss, Ss^Vhs, Ss
Ds, Ds, Gs, Ss, Ss, Ss, Ss, Ss, Ss, Ss, Gs, Gs, Ds, Ds, Ss, Gs, Ds, Rd, Gs, Gs, Ss, Ss, Ss, Ss, Gs, Ww, Ww, Wo, Ww, Ww, Gs, Gs, Ds, Gs, Gs, Gs, Gs, Ss, Ss, Ss, Ss, Hh, Gs, Ss, Ss, Ss, Ss
Ds, Ds, Ds, Gs, Gs, Gs, Gs, Ss, Ss, Ss, Ss^Vhs, Gs, Gs, Ss, Ss, Ds, Gs, Rd, Gs, Gs, Gs, Ss, Ss, Ss, Gs, Gs, Ww, Wo, Ww, Gs, Gs, Ds, Ss, Ds, Ss, Gs, Ss, Gs, Ss, Hh, Hh, Hh, Gs, Gs, Ds, Gs, Gs
Gd, Gs, Gd, Gd, Gd, Gs, Gs, Ss, Ss, Ss, Ss, Gs, Gs, Gs, Ds, Ss, Rd, Gs, Gs, Gs, Ss, Ss, Ss, Gs, Hh, Gs, Ww, Ww, Gs, Gs, Gs, Ds, Ss, Ss, Ss, Ss^Vhs, Ww, Ss, Ss, Hh, Ss, Hh, Ss, Gs, Ds, Ds, Ds
Gd, Gd, Gd, Gd, Gd, Ds, Gs, Gs, Ds, Ss, Gs, Gs, Gs, Gs, Ds, Gs, Rd, Hh, Ss, Gs, Ss, Ss, Ss, Ss, Hh, Gs, Ww, Ww, Gs, Gs, Gs, Ds, Ds, Ss, Ss, Ww, Ww, Ss, Ss, Ss, Ss, Ss, Ss, Ss, Ds, Ds, Ss
Gs, Gd, Gs, Gs, Gs, Ds, Ds, Ds, Ds, Gs, Hh, Gs, Gs, Ds, Gs, Rd, Hh, Gs, Ss^Vhs, Ss, Ss, Ss, Ss, Hh, Gs, Gs, Ww, Ww, Gs, Gs, Gs, Gs, Gs, Ss, Ss, Ww, Ss, Ss, Ss, Ss, Ds, Ss, Ss, Ss, Ds, Ss, Ss
Gs, Gs, Gs, Gs, Ss, Gs, Gs, Gs, Ds, Hh, Hh, Hh, Ds, Ds, Ss, Rd, Ss, Ss, Ss, Ss, Ss, Ss, Hh, Gs, Gs, Gs, Ww, Ww, Gs, Gs, Gs, Gs, Ds, Ds, Ds, Ss, Ss, Ss, Gs, Gs, Ds, Ss, Ss, Ss, Ss, Ss, Ss
Gs, Gs, Ss, Ss, Ss, Ss, Ss, Gs, Gs, Gs, Ds, Ds, Gs, Ss, Rd, Ss, Ss, Ss, Ss, Ss, Hh, Gs, Hh, Hh, Gs, Ww, Ww, Gs, Gs, Gs, Ds, Ds, Gs, Gs, Ss, Ss, Ss, Ss, Ds, Ds, Ds, Ss, Ss, Ss, Ss, Ss, Ss
Gs, Gs, Ss, Ss, Ss, Ss, Ss, Gs, Gs, Gs, Gs, Ds, Gs, Ss, Rd, Ss, Ss, Ss, Ss, Ss, Hh, Hh, Hh, Hh, Gs, Ww, Ww, Gs, Gs, Gs, Ds, Ds, Gs, Gs, Ss, Ss, Ss, Ss, Ss, Ds, Ds, Ss, Ss, Ss, Ss, Ss, Ss
