Gg, Gg, Gs, Gg, Gs, Gg, Gg, Gg, Gd, Gd, Gd, Gg, Gg, Gg, Gg, Gg, Gg, Gs, Gg, Gg, Gs, Gg, Gg, Gg, Rr, Rr, Gg, Gg, Gg, Gg, Gg, Gg, Gs, Gs, Gs, Gg, Gg, Gg
Gg, Gs, Gg, Gs^Eff, Gg^Eff, Gg^Eff, Gg^Eff, Gg, Gg^Eff, Gg, Gg, Gg^Es, Gg, Gg, Gg, Gg, Gg, Gs, Gg, Gg, Gg, Gg, Gg, Gg, Rr, Rr, Gg, Gg, Gd^Gvs, Gg, Gg, Gg, Gg, Gs, Hh, Gg, Gs, Gg
Gg, Gs^Fdw, Gg^Vl, Gg, Gg, Gg, Gg, Gs^Eff, Gs, Gg, Gg, Gg, Gs^Gvs, Gd^Gvs, Gg^Gvs, Gg, Gg, Gs, Gg^Es, Gg, Gg, Gg, Gg, Gg, Gg, Rr, Gg, Gs^Gvs, Gs^Gvs, Gg^Gvs, Gg^Gvs, Hh, Hh, Hh, Hh, Gg, Gg, Gs
Gg, Gg, Gg, Gg, Gg^Gvs, Gg^Gvs, Gg^Es, Gg, Gs, Gd, Gg, Gg^Gvs, Gg^Gvs, Gs^Gvs, Gs, Gg, Gg, Gg, Gg, Gg, Gg, Gs^Fdf, Ce, Ce, Ce, Rr, Gg, Gg^Eff, Gg^Eff, Gg^Gvs, Gg^Gvs, Hh, Hh, Hh, Hh, Gg, Gg^Es, Gs
Gs, Gg, Gg^Gvs, Gg, Gg, Gs, Gg, Gg, Gg, Gg, Gg, Gg, Gg, Gg, Gg, Gd, Gg, Gg, Gg, Gg, Gg, Gg, Ce, 1 Ke, Gg, Rr, Rr, Gg, Gg, Gg^Eff, Gg^Eff, Hh, Gg, Hh, Gg, Gg, Gg, Gg
Gg, Gs^Gvs, Gg^Gvs, Gg, Hh, Hh, Hh, Gg, Re^Gvs, Gg^Vh, Gg, Gg, Gg, Gg, Gg, Gg, Gg, Gs^Fdf, Gg, Gg, Gll, Gll, Gll^Fdw, Gg, Gll^Fdf, Gg, Rr, Gg, Gg^Efm, Gg^Eff, Gg^Eff, Gg^Efm, Gg, Gg, Gg, Gg, Gg^Efm, Gg
Gg, Gg, Gg, Hh, Hh, Hh, Re^Gvs, Re^Gvs, Re^Gvs, Re^Gvs, Gg, Gg, Gs, Gs, Gg, Gg, Gll, Gg, Hh^Fdf, Hh^Fdf, Gll^Fdf, Gll^Fdf, Hh, Gll^Em, Gll^Fdw, Gll, Rr, Gg, Gs, Gg, Gg, Gg^Eff, Gg^Eff, Gg^Eff, Gg, Gg, Gg^Efm, Gg
Gg, Gg, Gg, Gg, Re^Gvs, Re^Gvs, Re^Gvs, Re^Gvs, Re^Gvs, Re^Gvs, Hh, Hh, Gg, Gg, Gg, Gs^Fdw, Gll, Gll^Fdf, Gg, Hh^Fdw, Gll^Fdw, Gll^Fdf, Hh, Hh, Gs, Gll, Rr, Gg, Gg, Gg, Gg, Gg, Hh, Hh, Re^Gvs, Gg, Gg, Gg
Gg, Gg, Gg, Gg, Re^Gvs, Re^Gvs, Re^Gvs, Re^Gvs, Gll, Gg, Hh, Hh, Gg, Gg^Es, Gg, Gg, Gs, Gll^Fdw, Gs, Gll, Gll^Fdf, Gs^Fdw, Gll^Fdf, Gg, Gg, Rr, Gg, Gll, Gll^Fdf, Gs^Fdw, Gg, Hh, Re^Gvs, Re^Gvs, Re^Gvs, Re^Gvs, Re^Gvs, Gg
Gg, Gg, Gg, Gg^Vl, Gg, Re^Gvs, Gg, Gg, Gs^Fdw, Gg, Gg, Gg, Gs^Eff, Gs, Gs^Vh, Gg, Gd, Gg, Gg, Gg, Gg, Gll, Gll^Fdw, Gs, Rr, Rr, Gg, Gll, Hh, Hh^Fdw, Hh, Hh, Re^Gvs, Gg^Vl, Re^Gvs, Re^Gvs, Gg, Gg
Gg, Gg^Es, Gs, Gg, Gg, Gg, Gll^Fdw, Gll^Fdf, Gs^Fdf, Gg, Gs, Gs^Eff, Gg^Eff, Gs, Gg, Gg, Gg, Gs, Gg, Gg, Gs^Fdf, Gg, Gg, Gll, Rr, Gg, Hh, Hh, Mm, Mm, Mm, Hh, Hh^Fdw, Re^Gvs, Re^Gvs, Gg, Gg, Gg
Gs, Gs, Gg^Gvs, Gg, Gs, Gll, Gll^Fdf, Gll^Fdf, Gll^Fdf, Gg, Gg, Gs, Gg, Gd, Gg^Efm, Gg, Gg, Hh, Hh, Gg, Gg^Efm, Gg, Gg, Gg, Rr, Gs, Gg, Hh, Hh, Mm, Hh^Fdf, Gs^Fdf, Gg, Hh, Hh, Gg, Gg^Es, Gg
Gg, Gg^Gvs, Gg^Gvs, Gg^Gvs, Gg, Gg, Gg, Gll^Fdw, Gll, Gll, Hh, Hh, Gg, Gg, Gg, Gg, Gg, Hh, Gg, Gg, Gg, Hh, Hh, Gs, Rr, Hh, Gg, Gg, Gg, Hh, Hh, Gll^Fdw, Gll, Gg, Hh, Gg, Gs, Gg
Gg, Gg^Gvs, Gg, Gg^Gvs, Gs, Gg, Gg, Gg, Gg, Gg, Hh, Gg^Vh, Gg, Gg, Gg, Gg, Gg^Efm, Gg, Gg^Efm, Gg^Efm, Hh, Hh, Gg, Gs, Gg, Rr, Rr, Gg, Hh, Gg, Gs^Fdw, Hh, Gg, Gg, Gg, Gg, Gs, Gg
Gg, Gg, Hh, Gg, Hh, Gg, Hh, Gg, Hh, Hh, Mm, Hh, Hh^Fdf, Gll, Hh^Fdf, Gg, Gg, Gg, Gg, Gg, Re^Gvs, Re^Gvs, Gg, Gg, Ce, Ce, Rr, Gg, Gg, Gg, Gg, Gg, Gg, Gg, Gg, Gg, Gg, Gs
Gg, Gg, Gg, Hh, Gg, Hh, Hh, Gg, Hh, Mm, Mm, Mm, Hh^Fdw, Gll^Fdw, Gll^Em, Hh, Gll, Gg^Es, Gg, Gg^Vwm, Re^Gvs, Re^Gvs, Gg, Gg, Gg^Vh, Rr, Gg^Vhc, Gg, Ce, Gg, Gs, Gg^Efm, Re^Gvs, Re^Gvs, Re^Gvs, Re^Gvs, Re^Gvs, Gg
Rr, Rr, Rr, Gg, Gg, Hh, Gs^Fdf, Hh, Gg, Hh, Gs^Fdf, Hh, Hh, Gll^Fdf, Gll^Fdf, Gll^Fdw, Gll^Fdf, Gg, Gg, Re^Gvs, Re^Gvs, Re^Gvs, Gg, Ce, Ce, Rr, Gg, Ce, 2 Ke, Gg, Gs^Efm, Gg^Efm, Re^Gvs, Re^Gvs, Re^Gvs, Re^Gvs, Gg, Gg
Gs, Gs, Gg, Rr, Rr, Ce, Gg^Vh, Gg, Rr, Gg, Gg, Gg, Hh^Fdw, Gll^Fdw, Gll^Fdw, Hh^Fdf, Hh, Gs, Gs, Gg, Gg, Gg, Gg, Gg, Rr, Rr, Gg^Vhc, Ce, Gg, Gg, Gg^Efm, Gg, Re^Gvs, Re^Gvs, Re^Gvs, Gg, Gg, Gg^Efm
Gg, Gg, Gg, Ce, Gg^Vh, Rr, Rr, Rr, Ce, Rr, Gg, Gll^Fdw, Gll, Gll^Fdf, Gll^Fdf, Gll, Gg, Gg, Gg, Gg, Re^Gvs, Re^Gvs, Re^Gvs, Rr, Gg, Gs^Fdf, Gg, Gg, Gg, Gg^Efm, Gg^Efm, Gg, Gg^Vhc, Re^Gvs, Re^Gvs, Gg, Gg, Gg
Gs^Fdf, Gg, Gg, Ce, Ce, Gg, Gg^Vl, Ce, 3 Ke, Rr, Rr, Gg, Gg, Gll, Gd, Gg, Gg, Gs^Fdf, Gg, Gg, Re^Gvs, Re^Gvs, Rr, Rr, Gd, Gg, Gs, Gs, Gg, Gg, Gg, Gg, Re^Gvs, Re^Gvs, Gg, Hh, Hh, Hh
Gll^Fdw, Gll, Gg, Gg, Gs, Gg, Ce, Ce, Gg, Gg, Gg, Rr, Rr, Gg, Gg, Gg^Efm, Gs, Gg^Efm, Gg^Efm, Gg, Gg, Re^Gvs, Rr, Gg, Gs, Gs, Hh, Hh, Gg, Gll^Fdf, Gg, Gg^Es, Gg, Gg, Gg, Hh, Gg, Gg
Gs^Fdf, Gll^Fdf, Gll^Fdw, Gs, Gs, Gg, Gg, Gg, Gg, Gg, Re^Gvs, Gg, Re^Gvs, Rr, Rr, Gg, Gs, Gs^Efm, Gs, Gg, Gg, Gg, Rr, Gg, Gg, Hh, Hh, Hh, Gg^Gvs, Gg, Gg^Efm, Gg, Gg, Gg^Efm, Gg, Gg, Rr, Rr
Gg, Gll, Gg, Gg, Gg, Gg, Gll, Gg, Gg, Gg, Gg, Re^Gvs, Re^Gvs, Re^Gvs, Gg^Vh, Rr, Rr, Gg, Ce, Ce, Gs, Gg^Vhc, Rr, Gg, Gs, Gg, Ce, Gg^Gvs, Gs^Gvs, Gg^Gvs, Gg, Gg, Rr, Rr, Rr, Rr, Gg, Gg
Gg, Gg, Gg, Gg, Gg, Gg, Gg, Gll^Fdf, Gll, Gs, Gg, Gg, Gs^Fdf, Re^Gvs, Gg, Gg, Ce, Rr, Gg^Vhc, Gs, Rrc, Rrc, Ww^Bsb|, Rrc, Rrc, Gg^Vhc, Gg, Ce, Gs, Gs, Rr, Rr, Gg, Gg, Gg, Gg, Hh, Hh
Gg, Gs^Es, Gg, Hh, Hh, Gg, Gg^Vl, Gll^Fdw, Gll^Fdf, Gs, Gg, Gg, Gg, Gg, Hh, Ce, Gg^Vhc, Rrc, Rrc, Rrc, Ww, Ww, Rrc, Ww, Ww, Rrc, Rrc, Gs, Rr, Rr, Gg, Gg, Gg, Gs^Efm, Gg, Gg, Hh, Hh
Gs, Gg, Gg, Hh, Re^Gvs, Re^Gvs, Re^Gvs, Gll^Fdf, Gll^Fdw, Gll, Gll^Fdw, Gg, Gg^Efm, Gg, Hh, Gg, Gs, Rrc, Ww, Ww^Bsb\, Rrc, Rrc, Gg^Efm, Rrc^Vhc, Rrc, Ww, Ww^Bsb/, Rrc, Gg, Gg, Gg, Gd, Gg, Gs, Gg^Vl, Gg, Gs, Gg
Gs, Gs, Re^Gvs, Re^Gvs, Re^Gvs, Re^Gvs, Re^Gvs, Gll^Fdf, Gll, Gll, Gg, Gg, Gs, Gg, Gg, Gg, Gg^Vhc, Rrc, Ww, Rrc^Vhc, Gg^Efm, Gg^Efm, Ch, Gg^Efm, Gg^Efm, Rrc, Ww, Rrc, Gg^Vhc, Ce, Gg, Gs, Gs^Fdw, Gg, Gg, Gg, Gs, Gs
Gg, Gs, Re^Gvs, Re^Gvs, Re^Gvs, Re^Gvs, Re^Gvs, Gg, Gg^Efm, Gg, Gg^Efm, Gg^Efm, Gg, Gs^Es, Gg, Ce, Gg^Vhc, Rrc, Ww, Rrc, Rrc^Vhc, Ch, 5 Kh, Ch, Rrc, Rrc^Vhc, Ww, Rrc, Gg, Ce, Gg, Gg, Gll^Fdf, Gll, Gg, Gg, Gs, Gs
Gg, Gg, Gg, Re^Gvs, Re^Gvs, Re^Gvs, Gg, Gg, Gs^Efm, Gg, Gd, Gg, Hh, Gg, Gg, Ce, Gs, Rrc, Ww, Ww, Rrc, Ch, Ch, Ch, Rrc, Ww, Ww, Rrc, Gg^Vhc, Ce, Gg, Gg, Gll^Fdf, Hh, Gll, Gg, Gll^Fdf, Gs^Fdw
Gg, Gg, Gg^Vh, Re^Gvs, Gg, Gg, Gg, Gs, Gs, Gs, Gg, Hh, Hh, Hh, Gg, Ce, Gg^Vhc, Rrc, Ww^Bsb/, Ww^Bsb/, Ww, Rrc, Gg^Efm, Rrc, Ww, Ww^Bsb\, Ww^Bsb\, Rrc, Gs, Gg, Gs, Gg, Gg, Gll, Gll^Fdw, Gll^Fdf, Gll^Fdw, Gs^Fdf
Gg, Gg, Gs, Gg, Gg^Es, Gg, Gg, Gg, Gg, Gg^Efm, Gg^Efm, Gg, Gg, Gg, Gg, Gg, Rrc, Rrc, Rrc, Ww, Ww, Rrc^Vhc, Rrc, Rr^Vhc, Ww, Ww, Ww, Rrc, Rr, Rr, Rr, Gg, Gg^Efm, Gg, Gg, Gll^Fdf, Gg, Gll
Gll^Fdf, Gg, Gg, Gg, Gg, Gll^Fdw, Gg, Ce, Ce, Gg, Gg, Gg^Efm, Rr, Gg, Rr, Rr, Ce, Rrc^Vhc, Rrc, Rrc^Vhc, Rrc, Ww, Ww^Bsb|, Ww, Rrc, Rrc^Vhc, Ww, Gs^Vhc, Ww, Gg, Gs, Rr, Rr, Gg, Ds, Gg, Ww, Ww
Gs^Fdf, Gll^Fdw, Gll^Fdf, Re^Gvs, Re^Gvs, Re^Gvs, Gg, Gg^Vl, 4 Ke, Ce, Rr, Rr, Gg, Rr, Gg, Gg, Gg, Gg, Gg, Rrc, Rrc^Vhc, Rrc, Rrc, Rrc, Rrc, Rrc, Rrc^Es, Ww, Ww, Ww, Ww, Gg, Ww, Ww^Bsb\, Ww^Bsb\, Ww, Wo, Wo
Gg, Gll, Gg, Gll, Gg, Re^Gvs, Gg^Vh, Rr, Rr, Rr, Gg^Vhc, Gg, Re^Gvs, Gg, Re^Gvs, Gg, Gg, Ds, Ww, Rrc, Rrc, Rrc, Ch, Rrc, Rrc, Rrc, Ww, Ww, Ww, Ww, Ww, Ww, Ww, Ww, Ww, Wo^Bsb\, Ww^Bsb\, Ww
Gg, Gg, Gg, Gll^Fdw, Gg, Gg, Gg, Ce, Rr, Gg^Vh, Ce, Re^Gvs, Re^Gvs, Re^Gvs, Re^Gvs, Hh, Gg, Ww, Ww, Ds, Ww, Ww, Ww, Ww, Ww, Ww^Bsb|, Ww, Ww, Ww, Ww, Ww, Ww, Ww, Ww, Ww, Gg^Vhc, Gg, Rr
Gg, Gg, Gs, Gg, Gg, Gg, Rr, Gg, Rr, Ce, Gg, Gg, Gg, Gg, Gg, Hh, Ww, Ww, Ww, Ww, Ww, Ww, Ww, Ww, Ww, Ww^Bsb|, Ww, Ww, Ww, Wwf, Ds, Gs, Gs, Gg, Gg, Gg, Re^Gvs, Gg
Gg, Gs, Gd, Gg, Rr, Rr, Gg, Rr, Gg, Gg, Gg, Gs, Ds, Ww, Ww, Ww, Ww, Ww, Wo, Ww, Ww, Ww, Ww, Ww, Gg, Rr, Gg, Gg, Gg, Gg, Hh, Gg, Gg, Re^Gvs, Re^Gvs, Re^Gvs, Re^Gvs, Gg
Gg, Gg, Gg, Gg, Rr, Gg, Gg, Gg^Es, Gs, Gg, Ww, Ww, Ww, Ww, Wo, Wo, Wo, Wo, Ww, Ww, Gg, Gg, Gg, Gs, Gs^Es, Rr, Gg, Gd, Gg, Gg, Gg, Gg, Re^Gvs, Re^Gvs, Re^Gvs, Re^Gvs, Re^Gvs, Gg
Gs, Gs, Gs, Gg, Rr, Gg, Gg, Gs, Gg, Ds, Ww, Ww, Ww, Ww, Wo, Wo, Wo, Wo, Ww, Ds, Gg, Gs, Gg, Gg, Gg, Rr, Gg, Gg, Re^Gvs, Re^Gvs, Re^Gvs, Re^Gvs, Gg, Re^Gvs, Gg, Re^Gvs, Gg, Gg
