Gs^Fdf, Gs^Fdf, Gs^Fdw, Gll^Fdf, Gs^Fdf, Gll^Fdw, Gg, Gg, Gs, Gg, Gg, Gg, Gg, Gg, Gs, Gg, Gg, Gg, Gg, Gg, Gs, Gg, Gg^Es, Gg, Gd, Gg, Gg, Gg, Gs, Gg, Gll, Gs^Fdf, Gll^Fdw, Gs^Fdf, Gs^Fdw, Gs^Fdf, Gs^Fdw, Gs^Fdf, Gll^Fdf, Gll^Fdw, Gll^Fdf, Gll, Gll, Rr, Gs^Fdf, Gs^Fdf
Gs^Fdw, Gll^Fdf, Gll^Fdf, Gll^Fdw, Gll^Fdf, Gll^Fdw, Gg, Gg, Gs, Gs, Gs^Efm, Gg, Gs, Gs, Gg^Efm, Gg, Gg, Gg, Ce, Ce, Ce, Gg, Gg, Gd, Gs, Gs^Efm, Gs, Gs^Es, Gg, Gs, Gll, Gll^Fdf, Gll^Fdf, Gll^Fdw, Gll^Fdf, Gll^Fdf, Gll^Fdf, Gs^Fdw, Gll^Fdw, Gll^Fdf, Gll^Fdf, Gll, Rr, Rr, Gll^Fdw, Gll^Fdw
Gll^Fdf, Gll^Fdf, Gll^Fdf, Gll^Fdf, Gll, Gll, Gs, Gs^Efm, Gs, Gs, Gg, Gg, Gd, Gd, Gg, Gg^Vhh, Gg, Gg, Ce, 5 Ke, Ce, Gs, Gs, Gs^Vwm, Gs, Gs, Gg, Gg, Ds, Gg^Efm, Ds, Gg, Ww, Gg, Ww, Gll, Gg, Gll, Gll^Vl, Gll, Gg, Rr, Gll^Fdf, Gs^Fdf, Gll^Fdf, Gll^Fdf
Gll^Fdw, Gll^Fdf, Gll^Fdw, Gll, Gs^Es, Gs, Gs, Gg, Gg, Ds, Ds, Gg^Es, Gg, Gs, Ww, Gg^Vh, Ww, Gg, Rr, Ce, Ds, Gg, Gg^Vh, Gs, Ww, Ds, Ww, Ww, Ww, Ww, Ww, Ww, Ww, Ww, Ww, Ww, Ww, Gg, Gg^Es, Gg, Rr, Rr, Gg, Gll^Fdw, Gll^Fdf, Gs^Fdf
Gs^Fdf, Gll^Fdf, Gll, Gll, Gs, Gs, Ds, Ds, Ww, Ww, Ww, Ww, Ww, Ww, Ww, Ww, Ww, Ww, Ww^Bsb|, Ww, Ww, Ww, Ww, Ww, Ww, Ww, Ww, Ww, Ww, Ww, Ww, Ww, Wo, Wo, Wo, Ww, Ww, Ww, Rr, Rr, Gg, Gg, Gs, Gll^Vh, Gs, Gll
Rr, Rr, Rr, Gll, Gg, Gg^Vh, Ww, Ww, Ww, Ww, Ww, Ww, Ww, Ww, Ch, Ch, Ww, Ww, Rr, Ww, Ch, Ww, Ww, Ww, Wo, Ww, Wo, Ww, Wo, Wo, Wo, Wo, Hh, Ch, Ch, Ww, Ww^Bsb/, Ww^Bsb/, Ww, Gg, Ww, Gg^Vh, Gs, Gd, Gll, Gg
Gll^Fdw, Gll^Fdf, Gll^Fdw, Rr, Rr, Ww, Ww, Ww, Wo, Wo, Ch, Wo, Wo, Wo, Gg^Vh, Gg, Gg^Efm, Gg, Rr, Gg^Es, Gs, Ch, Gg^Vh, Hh, Hh, Wo, Hh, Wo, Hh, Hh, Hh, Hh, Rr, Gg^Vh, Rr, Gg, Rr, Ww, Ww, Ww, Ww, Gs, Gs^Es, Gg, Gll^Fdw, Gs^Fdf
Gg, Gll^Vl, Gll, Gll, Ww, Ww^Bsb\, Ww^Bsb\, Ww, Rr, Ch, Gg^Vh, Hh, Hh, Hh, Gg, Gg, Gs, Gs, Rr, Gs, Gg^Efm, Gg, Gg, Gg, Gg, Hh, Rr, Hh, Rr, Rr, Rr, Rr, Gg, Gs, Gs, Rr, Rr, Ch, Ch, Ww, Ww, Ds, Gll, Gll, Gll^Fdf, Gs^Fdw
Gs^Fdw, Gll^Fdf, Gll, Gg^Vh, Ww, Ww, Rr, Rr, Gs^Es, Rr, Rr, Gg, Rr, Rr, Rr, Rr, Rr, Rr, Rr, Rr, Rr, Gg, Rr, Gg, Rr, Rr, Gg, Rr, Ch, Ch, Gg, Rr, Gg, Ch, Ch, Gs, Rr, Gg, Gg^Vh, Wo, Ww, Ds, Gg, Gll^Fdf, Gll^Fdf, Gll^Fdw
Gs^Fdf, Gll^Fdw, Gll, Ww, Ww, Ww, Rr, Gd, Gs, Gs, Gg, Rr, Gg, Gg, Gs, Gs, Gg^Efm, Gg, Rr, Gg, Gs, Rr, Rr, Rr, Gll^Fdf, Rr, Rr, Gg, Ch, Rp^Vhc, Ch, Ch, Ch, Rp^Vhc, Ch, Gs, Rr, Gg, Hh, Wo, Ww, Gg, Gg, Gll^Fdf, Gs^Fdw, Gll^Fdf
Gll^Fdf, Gll^Fdf, Ww, Ww, Wo, Ch, Rr, Gg, Ch, Ch, Gg, Rr, Gg, Ch, Ch, Gs, Rr, Rr, Gll^Fdw, Rr, Ce, Ce, Rr, Gll^Fdw, Gll^Fdf, Gll^Fdf, Rr, Gg, Gg, Gg, Ch, 3 Kh, Ch, Gg, Gg, Gg, Rr, Gg, Hh, Wo, Ww, Ds, Gg, Gll, Gll^Fdf, Gll^Fdw
Gll^Fdw, Gll^Fdf, Ww, Wo, Wo, Ch, Rr, Gg, Ch, Rp^Vhc, Ch, Ch, Ch, Rp^Vhc, Ch, Gg, Rr, Gs^Fdf, Gs^Fdf, Rr, Gg^Es, Ce, Rr, Gs^Fdf, Gll^Fdw, Gll^Fdf, Rr, Gg, Rr, Rr, Gg, Ch, Gg, Rr, Rr, Rr, Rr, Gg, Hh, Wo, Wo, Ww, Ds, Gll, Gll^Fdw, Gll^Fdf
Gg, Gll, Ww, Ww, Wo, Gg^Vh, Rr, Gg, Gs, Gg, Ch, 2 Kh, Ch, Gg, Gg, Gg, Rr, Gs^Fdf, Gll^Fdf, Rr, Rr, Gg, Rr, Rr, Rr, Rr, Gg, Rr, Gs, Gg, Ch, Rp^Vhc, Ch, Gg, Ce, Gg, Rr, Gg^Es, Gg, Hh, Wo, Ww, Ds, Gg, Gg, Gg
Gg, Gs, Ww, Wo, Wo, Hh, Gg, Rr, Rr, Rr, Gg, Ch, Gs, Rr, Rr, Rr, Gll^Fdw, Gll^Fdf, Rr, Rr, Rr, Rr, Rr, Gg, Gg, Ce, Ce, Rr, Gs, Gs, Gg, Ch, Gg, Gg, Ce, Ce, Rr, Gs, Gs, Hh, Wo, Ww, Gs, Gs, Gs, Gg
Gg, Ds, Ww, Wo, Wo, Hh, Gg, Rr, Gg^Es, Gs, Ch, Rp^Vhc, Ch, Gg, Gg^Efm, Rr, Rr, Rr, Gg, Gg, Rr, Gg, Gs, Rr, Rr, Ce, Rr, Rr, Rr, Rr, Rr, Gg, Rr, Gg, Rr, Gg, Rr, Gs^Efm, Gg, Hh, Wo, Ww, Gg, Gd^Es, Gg^Efm, Gg
Gs, Ds, Ww, Wo, Wo, Hh, Gg, Rr, Gg, Gs, Gg, Ch, Gg, Gg, Rr, Rr, Gs, Gg, Ww, Ww, Ww^Bsb|, Ww, Ww, Gg, Gs, Rr, Rr, Rr, Gg, Gg, Gg^Efm, Rr, Gs^Fdf, Rr, Gs^Fdf, Rr, Rr, Gs, Gg, Hh, Wo, Ww, Gg, Gs, Gg, Gg
Gs, Gg, Ww, Ww, Wo, Hh, Hh, Rr, Rr, Rr, Rr, Gg, Rr, Gg, Rr, Gg, Wo, Ww, Ch, Rp^Vhc, Rr, Rp^Vhc, Ch, Ww, Wo, Gg, Rr, Gs, Ce, Ce, Gg, Rr, Gll^Fdf, Gll^Fdw, Gll^Fdf, Gll^Fdf, Rr, Gg, Hh, Hh, Wo, Ww, Ds, Gg^Efm, Gs, Gg
Gs^Es, Gg, Ww, Ww, Wo, Wo, Hh, Gg, Rr, Gg, Ce, Rr, Gs^Fdf, Rr, Rr, Wo, Ch, Ch, Gg, Gg, Rr, Gg^Efm, Gg, Ch, Ch, Wo, Rr, Gg, Gg, Ce, Gg, Rr, Gll^Fdf, Gll^Fdf, Gg^Fdf, Rr, Gg, Gg^Efm, Hh, Wo, Ww, Ww, Ds, Gs, Gs, Gg
Gs, Gg, Ds, Ww, Wo, Wo, Hh, Gg, Rr, Ce, Ce, Rr, Gll^Fdw, Gll^Fdf, Rr, Wo, Ch, Gg, Gg, Gg, Ch, Gg, Gg^Efm, Gg, Ch, Wo, Rr, Rr, Rr, Gs, Rr, Rr, Rr, Rr, Rr, Rr, Gg, Gg^Vh, Wo, Wo, Ww, Ds, Gg, Gs, Gs, Gg
Gll, Gll, Ds, Ww, Wo, Wo, Hh, Gg, Rr, Gg, Gg, Rr, Gll^Fdf, Gs^Fdw, Rr, Ww, Ch, Gg, Gg, Ch, 1 Kh, Ch, Gg, Gg, Ch, Ww, Rr, Gg, Ce, Rr, Rr, Gg, Ce, Gg, Rr, Gg, Gg, Ch, Ww, Ww, Ds, Ds, Gg, Gg^Efm, Gg, Gg
Gll^Fdw, Gll^Fdf, Ww, Ww, Ww, Wo, Gg^Vh, Gg, Rr, Gs, Rr, Rr, Rr, Rr, Rr, Ww, Rp^Vhc, Gg, Rr, Ch, Ch, Ch, Rr, Gg^Efm, Rp^Vhc, Ww, Rr, Ce, Ce, Gg, Rr, Ce, Ce, Gg, Rr, Gs, Ww, Ch, Ww, Ww, Gg, Gg, Gs, Gg, Gg, Gg
Gll^Fdf, Gll^Fdf, Gll, Ww, Ww, Wo, Ch, Gg, Gg, Rr, Gg, Gg^Es, Gg^Efm, Gg^Efm, Rr, Ww, Ww^Bsb/, Rr, Gg, Gg, Gg^Efm, Gg, Gg, Rr, Ww^Bsb\, Ww, Rr, Rr, Rr, Rr, Rr, Rr, Rr, Rr, Rr, Gg, Ww, Ww, Ds, Gg, Gg, Gs^Vwm, Gs^Es, Gd, Gd, Gg
Gll^Fdw, Gll^Fdw, Gg, Ds, Ww, Ww, Ww, Ch, Gs, Rr, Gg, Ce, Ce, Gg, Rr, Rr, Ww, Rp^Vhc, Ch, Gg, Gg, Gg, Ch, Rp^Vhc, Ww, Rr, Rr, Gg, Ce, Gs, Gg, Rr, Gg, Gs, Gg, Rr, Ww^Bsb\, Gg, Gg, Gg^Vh, Gg, Gg, Gs, Gd, Gs, Gg
Gg, Gg, Gs, Ds^Vh, Ds, Ww, Ww, Gg, Gs, Rr, Gg, Ce, Rr, Rr, Gll^Fdf, Rr, Rr, Ww, Ww, Ch, Ch, Ch, Ww, Ww, Rr, Rr, Rr, Gg, Ce, Ce, Gg, Rr, Gg, Gg^Efm, Ch, Ww, Ww, Rr, Rr, Gg, Ce, Gg, Gg, Gg^Vl, Gs, Gg
Gg, Gs^Vl, Gs, Gs, Gg, Gg^Vh, Ww, Ww, Ww^Bsb/, Rr, Rr, Rr, Rr, Gs^Fdf, Gll^Fdf, Gll^Fdf, Rr, Rr, Rr, Wo, Wo, Wo, Rr, Rr, Ce, Gs, Gg, Rr, Rr, Gg, Rr, Rr, Gg, Gg, Ch, Ww, Ww, Gg, Gg, Ce, 6 Ke, Ce, Gg, Gg, Gs, Gg
Gll, Gll, Gll^Fdf, Gg, Gg, Gg, Rr, Ww^Bsb/, Ww, Ww, Ch, Gg, Rr, Gll^Fdw, Rr, Rr, Gg, Gg, Ce, Rr, Rr, Rr, Gg^Efm, Gg, Ce, Ce, Rr, Rr, Gll^Fdf, Rr, Gll^Fdf, Rr, Hh, Gg^Vh, Wo, Ww, Ww, Ds, Gg, Ce, Ce, Ce, Rr, Gg, Gg, Gg
Gll^Fdf, Gll^Fdw, Ce, Ce, Ce, Rr, Ds, Ww, Wo, Ww, Ch, Gs, Rr, Rr, Gg, Rr, Rr, Ce, Ce, Gg, Rr, Gg, Rr, Rr, Rr, Rr, Rr, Gs^Fdf, Gll^Fdf, Gll^Fdw, Rr, Rr, Hh, Wo, Ww, Wo, Ww, Ww, Gg^Vhh, Gg, Gg, Gg, Gs, Rr, Rr, Rr
Gs^Fdw, Gll^Fdf, Ce, 7 Ke, Ce, Gg, Ds, Ww, Wo, Wo, Wo, Gg^Vh, Gg, Rr, Ce, Ce, Gg, Rr, Rr, Rr, Gs, Rr, Rr, Gs, Gg^Es, Rr, Gg, Rr, Rr, Gs^Fdw, Rr, Gg, Hh, Wo, Ww, Wo, Wo, Ww, Ww, Gg, Gg^Vh, Gs^Es, Gs, Gg, Gg, Gg
Rr, Rr, Gll^Fdw, Ce, Gs, Gg, Gg^Vh, Ww, Ww, Ww, Wo, Hh, Gg, Rr, Rr, Ce, Rr, Rr, Gg, Gg, Ch, Gg, Rr, Gg, Ch, Gg, Gg, Gg^Efm, Gg, Rr, Gs, Hh, Wo, Wo, Ww, Wo, Wo, Wo, Ww, Ds, Ds, Gd, Gs, Gs^Vh, Gg, Gg
Gs^Fdw, Gll^Fdf, Gll^Fdf, Gll, Gs, Gs^Es, Gg, Ds, Ww, Ww, Wo, Hh, Hh, Gg, Gg, Rr, Gg, Gg, Gg, Ch, Rp^Vhc, Gg, Ch, Gg, Rp^Vhc, Ch, Gg, Gg^Efm, Rr, Rr, Hh, Hh, Wo, Ww, Ww, Wo, Wo, Wo, Wo, Ww, Ww, Gg, Gg, Gg, Gg^Es, Gg
Gll^Fdf, Gll^Fdf, Gg, Gll, Gd, Gs, Gs^Vh, Gg, Ww, Ww, Ww, Wo, Wo, Hh, Gg, Rr, Gg, Gs, Gg, Ch, Gg, Ch, 4 Kh, Ch, Gg, Ch, Gs, Gg, Rr, Gg, Hh, Wo, Wo, Ww, Ww, Ww, Wo, Wo, Wo, Ww, Ww, Ww, Ww, Gg, Gg, Gg
Gs^Fdf, Gll^Fdw, Gs^Vh, Gg, Gs, Gg, Gg, Gg, Ds, Ww, Wo, Ww, Wo, Hh, Hh, Rr, Rr, Gg^Es, Gg, Gs, Rr, Ch, Ch, Ch, Rr, Gg, Gs, Rr, Gg, Hh, Wo, Wo, Wo, Wo, Wo, Wo, Wo, Wo, Wo, Wo, Wo, Ww, Ww, Ww, Ww, Ww
Gg, Gg, Gll, Gll, Gll, Gg^Vl, Gs, Gg, Ds, Ww, Wo, Wo, Wo, Wo, Hh, Gg, Gg, Rr, Rr, Rr, Gg, Gg, Rp^Vhc, Gg, Gs, Rr, Rr, Rr, Gg, Hh, Wo, Wo, Wo, Wo, Wo, Wo, Wo, Wo, Wo, Wo, Wo, Wo, Ww, Ww, Ww, Ww
Gll^Fdf, Gll^Fdf, Gll^Fdw, Gll^Fdf, Gll^Fdw, Gll, Gll, Gs, Ds, Ww, Ww, Ww, Wo, Wo, Wo, Hh, Hh, Gg, Rr, Gg, Gs, Ch, Ch, Ch, Gg, Rr, Gg, Gg, Hh, Hh, Wo, Wo, Wo, Wo, Wo, Wo, Ww, Wo, Wo, Wo, Wo, Wo, Wo, Wo, Ww, Ww
Gs^Fdf, Gll^Fdw, Gll^Fdf, Gll^Fdf, Gll^Fdf, Gll^Fdf, Gll, Gs, Gg, Ww, Ww, Wo, Wo, Wo, Wo, Wo, Wo, Gg^Vh, Ch, Rr, Rr, Gg, Gg, Gg, Rr, Rr, Ch, Gg^Vh, Wo, Wo, Wo, Wo, Wo, Wo, Wo, Ww, Wo, Wo, Wo, Ww, Ww, Wo, Wo, Wo, Wo, Wo
Gs^Fdw, Gll^Fdf, Gll^Fdw, Gll^Fdf, Gll, Gll^Fdf, Gll^Fdw, Gll, Gll, Gg, Ww, Ww, Wo, Ww, Wo, Wo, Wo, Wo, Ww, Ch, Gg, Rr, Rr, Rr, Gg, Ch, Wo, Wo, Wo, Wo, Wo, Ww, Ww, Wo, Wo, Wo, Wo, Wo, Ww, Wo, Wo, Wo, Wo, Wo, Wo, Wo
Gll^Fdf, Gs^Fdf, Gs^Fdf, Gll^Fdw, Gg^Fdf, Gll^Fdw, Gll^Fdf, Gll^Fdf, Gll^Fdf, Gll, Gg, Ww, Ww, Wo, Ww, Wo, Wo, Wo, Wo, Ww, Ww, Ww, Ww^Bsb|, Ww, Wo, Wo, Wo, Wo, Ww, Ww, Wo, Wo, Wo, Wo, Wo, Wo, Wo, Wo, Wo, Wo, Wo, Wo, Wo, Wo, Wo, Wo
Gll^Fdw, Gs^Fdf, Gll^Fdw, Gs^Fdf, Gg^Fdf, Gll^Fdf, Gll^Fdw, Gg^Fdf, Gll^Fdf, Gll, Gg, Gg, Gg, Ww, Ww, Wo, Ww, Wo, Ww, Wo, Wo, Ww, Ww^Bsb|, Ww, Ww, Ww, Ww, Ww, Ww, Ww, Ww, Ww, Ww, Wo, Ww, Wo, Ww, Wo, Wo, Wo, Wo, Wo, Wo, Wo, Wo, Wo
Gll^Fdf, Gll^Fdf, Gg^Fdf, Gg^Fdf, Gll^Fdf, Gll^Fdf, Gll^Fdf, Gll^Fdf, Gll, Gll, Gg, Gs, Gg, Gs, Gs^Vh, Ds, Ww, Ww, Ww, Ww, Ww, Ww, Ww^Bsb|, Ww, Gg, Ww, Ds^Vhh, Ds, Gg, Ds, Ds, Ww, Ss, Ww, Ss, Ww, Ww, Wo, Wo, Wo, Wo, Wo, Wo, Wo, Wo, Wo
Gll^Fdf, Gll^Fdw, Gll^Fdf, Gll^Fdw, Gll^Fdf, Gll^Fdf, Gll^Fdf, Gll^Fdf, Gll^Fdf, Gll, Gg, Gs, Gg, Gd, Gg, Ds, Ds, Ww, Gg, Ww, Ww, Ww, Rr, Gg, Gs, Gg, Gs, Gg, Gd^Es, Gs, Gs, Gg, Gg, Ss, Ss, Ss, Ww, Ww, Wo, Wo, Wo, Wo, Wo, Wo, Wo, Wo
Gll^Fdf, Gll^Fdw, Gll^Fdf, Gll^Fdf, Gll^Fdw, Gll^Fdw, Gll^Fdw, Gll^Fdw, Gll^Fdf, Gll^Fdf, Gg^Fdf, Gd, Gs, Gg, Gs, Gs, Gg, Gd, Gs^Es, Gg, Gg, Gg, Rr, Gg, Gs, Gg, Gs, Gd, Gd, Gs, Gg, Gg, Ss, Ss, Ss, Ss, Ww, Ww, Wo, Wo, Wo, Wo, Wo, Wo, Wo, Wo
Gll^Fdw, Gll^Fdf, Gll^Fdf, Gll^Fdf, Gg^Fdw, Gg^Fdf, Gg^Fdf, Gll^Fdf, Gg^Fdf, Gg^Fdw, Gg^Fdf, Gg, Gg, Gs, Gs, Gs^Fdw, Gg, Gg, Gs, Gs, Gg, Gg, Rr, Gg, Gg, Gs, Gg, Gg, Gg, Gg, Gg, Gg, Ss, Ss, Ss, Ss, Ww, Ww, Wo, Wo, Wo, Wo, Wo, Wo, Wo, Wo
