Xoc, Xoc, Xoc, Xoc, Xoc, Xoc, Xoc, Xoc, Xoc, Xoc, Xoc, Xoc, Xoc, Xoc, Xoc, Xoc, Xoc, Xoc, Xoc, Xoc, Xoc, Xoc
Xoc, Xoc, Mm, Xoc, Xoc, Xoc, Xoc, Xoc, Xoc, Xoc, Xoc, Xoc, Xoc, Xoc, Xoc, Xoc, Xoc, Xoc, Xoc, Xoc, Xoc, Xoc
Xoc, Xoc, Xoc, Xoc, Xoc, Xoc, Xoc, Xoc, Xoc, Xoc, Xoc, Xoc, Xoc, Xoc, Xoc, Xoc, Xoc, Xoc, Xoc, Xoc, Xoc, Xoc
Xoc, Xoc, Xoc, Xoc, Xoc, Xoc, Xoc, Xoc, Xoc, Xoc, Xoc, Xoc, Xoc, Xoc, Xoc, Xoc, Xoc, Xoc, Xoc, Xoc, Xoc, Xoc
Xoc, Xoc, Xoc, Xoc, Xoc, Xoc, Xoc, Xoc, Xoc, Xoc, Xoc, Xoc, Xoc, Xoc, Xoc, Xoc, Xoc, Xoc, Xoc, Xoc, Xoc, Xoc
Xoc, Xoc, Xoc, Xoc, Xoc, Xoc, Xoc, Xoc, Ch, Ch, Ch, Ch, Ch, Xoc, Xoc, Xoc, Xoc, Xoc, Xoc, Xoc, Xoc, Xoc
Xoc^_s, Xoc, Xoc, Xoc, Xoc, Xoc, Ch, Ch, Ch, Ch, Ch, Ch, Ch, Ch, Ch, Xoc, Xoc, Xoc, Xoc, Xoc, Xoc, Xoc^_s
Iwr^_s, Xoc, Xoc, Xoc, Xoc, Ch^Ebn, Iwr, Iwr, Iwr, Iwr, 2 Icn, Iwr, Iwr, Iwr, Iwr, Ch^Ebn, Xoc, Xoc, Xoc, Xoc, Iwr, Iwr^_s
Xoc^_s, Iwr, Iwr, Xoc, Xoc^Efs, Xoc^Efs, Iwr, Iwr, Iwr, Icn^Efs, Icn, Icn^Efs, 3 Iwr, Iwr, Iwr, Xoc^Efs, Xoc^Efs, Xoc, Iwr, Iwr, Xoc, Xoc^_s
Xoc, Xoc, Xoc, Iwr^Pr/, Iwr, Iwr, Iwr, Iwr, Iwr, Icn, 1 Icn, Icn, Iwr, Iwr, Iwr, Iwr, Iwr, Iwr^Pr\, Xoc, Xoc, Xoc, Xoc
Xoc, Xoc, Xoc, Xoc, Ch, Iwr, Xoc, Iwr, Iwr, Icn, Icn, Icn, Iwr, Iwr, Xoc, Iwr, Ch, Xoc, Xoc, Xoc, Xoc, Xoc
Xoc, Xoc, Xoc, Xoc, Ch^Ebn, Iwr, Iwr, Iwr, Iwr, Icn, Icn, Icn, Iwr, Iwr, Iwr, Iwr, Ch^Ebn, Xoc, Xoc, Xoc, Xoc, Xoc
Xoc, Xoc, Xoc, Xoc, Xoc, Iwr, Iwr, Iwr, Icn^Efs, Icn, Icn, Icn, Icn^Efs, Iwr, Iwr, Iwr, Xoc, Xoc, Xoc, Xoc, Xoc, Xoc
Xoc, Xoc, Xoc, Xoc, Xoc^Efs, Xoc^Efs, Iwr, Icn, Icn, Icn, Icn, Icn, Icn, Icn, Iwr, Xoc^Efs, Xoc^Efs, Xoc, Xoc, Xoc, Xoc, Xoc
Xoc, Xoc, Xoc, Xoc, Ch^Ebn, Iwr, Iwr, Iwr, Iwr, Icn, Icn, Icn, Iwr, Iwr, Iwr, Iwr, Ch^Ebn, Xoc, Xoc, Xoc, Xoc, Xoc
Xoc, Xoc, Xoc, Xoc, Ch, Iwr, Xoc, Iwr, Iwr, Icn, Icn, Icn, Iwr, Iwr, Xoc, Iwr, Ch, Xoc, Xoc, Xoc, Xoc, Xoc
Xoc, Xoc, Xoc, Xoc, Iwr, Iwr, Iwr, Iwr, Iwr, Icn, Icn, Icn, Iwr, Iwr, Iwr, Iwr, Iwr, Xoc, Xoc, Xoc, Xoc, Xoc
Xoc^_s, Xoc, Iwr, Iwr^Pr\, Xoc, Iwr, Iwr, Iwr, Iwr, Icn, Icn, Icn, Iwr, Iwr, Iwr, Iwr, Xoc, Iwr^Pr/, Iwr, Xoc, Xoc, Xoc
Iwr^_s, Iwr, Xoc, Xoc, Xoc, Xoc, Xoc, Xoc, Xoc, Icn, Icn, Icn, Xoc, Xoc, Xoc, Xoc, Xoc, Xoc, Xoc, Iwr, Iwr, Xoc^_s
Xoc, Xoc, Xoc, Xoc, Xoc, Xoc, Xoc, Xoc, Xoc, Icn, Icn, Icn, Xoc, Xoc, Xoc, Xoc, Xoc, Xoc, Xoc, Xoc, Xoc, Iwr^_s
Xoc, Xoc, Xoc, Xoc, Xoc, Xoc, Xoc, Ch^Ebn, Iwr, Icn, Icn, Icn, Iwr, Ch^Ebn, Xoc, Xoc, Xoc, Xoc, Xoc, Xoc, Xoc, Xoc
Xoc, Xoc, Xoc, Xoc, Xoc, Xoc, Xoc, Iwr^Pr|, Iwr, Icn, Icn, Icn, Iwr, Iwr^Pr|, Xoc, Xoc, Xoc, Xoc, Xoc, Xoc, Xoc, Xoc
