Gll^Fp, Gll^Fp, Gll^Fp, Hh^Fp, Hh^Fp, Hh, Mm, Mm, Mm, Mm, Mm, Mm, Mm, Mm, Mm, Mm, Mm, Mm^Xm, Mm^Xm, Mm^Xm, Xu, Xu, Cud, Uu, Uu, Xu, Uu, Rr, Rr^Br/
Gll^Fp, Gll^Fp, Gll^Fp, Gll^Fp, Hh^Fp, Hh, Mm, Mm, Mm, Mm, Mm, Mm, Mm, Mm, Mm, Mm, Mm, Mm^Xm, Mm^Xm, Mm^Xm, Xu, Xu, Uh^Vu, Uh, Uu^Vud, Uu^Vud, Rr^Br/, Rr^Br/, Rr
Gs, Gg^Ve, Gll^Fp, Gll^Fp, Gll^Fp, Hh^Vhh, Hh^Fp, Mm, Mm, Mm, Mm, Mm, Mm, Mm, Mm, Mm, Mm, Mm, Mm, Mm^Xm, Mm^Xm, Xu, Uh^Uf, Uu, Cud, Rr^Br/, Rr, Rr, Uu
Gll^Fp, Gll^Fp, Gll^Fp, Gll^Fp, Gs^Efm, Gll^Fp, Hh^Fp, Hh^Fp, Hh^Fp, Mm, Hh^Vhh, Mm, Mm, Mm, Mm, Hh, Mm, Mm, Mm, Mm, Mm^Xm, Xu, Xu, Cud, Cud, Cud, Uu, Uu^Vud, Uh
Gll^Fp, Gll^Fp, Gll, Gll, Gs, Gs, Gll^Fp, Hh^Fp, Gll^Fp, Hh, Mm, Mm, Hh^Fp, Hh^Fp, Hh, Hh, Mm, Mm, Mm, Mm, Mm^Xm, Xu, Xu, Cud, Re, 1 Kud, Cud, Uu, Uh
Gll^Fp, Gll^Fp, Gs^Efm, Gs, Gg^Efm, Gg^Efm, Gs, Gg, Gll^Fp, Gll^Fp, Gll^Fp, Hh^Fp, Gll^Fp, Hh, Gll^Fp, Mm, Hh^Vhh, Mm, Mm, Mm, Md^Vhh, Xu, Re^Es, Re^Es, Re, Cud, Cud, Cud, Uu
Gg, Gg^Ve, Gg, Gs, Ce, Gs, Gg, Gg, Gg, Gg, Gg, Gll^Fp, Gs, Gll^Fp, Gs^Fp, Gll^Fp, Hh, Hh, Hhd, Md, Hhd, Hhd, Re, Re, Xu, Xu, Uh^Vud, Uu, Uh
Gs^Fp, Gs^Fp, Gg, Ce, Ce, Ce, Ce, Ce, Re, Gs, Gg, Gs, Gg^Es, Gs, Gg, Gg^Efm, Gg, Hh, Ce, Hhd, Re, Re, Md, Xu, Mm^Xm, Xu, Xu, Uh^Vu, Cud
Gg, Gg, Gs, Gs, Ce, 3 Ke, Ce, Ce, Gs, Re, Gs, Gs^Es, Gg, Gs, Gg, Gg^Efm, Gg, Gg, Re, Re, Ce, Hhd, Hhd^Vhh, Md, Mm, Mm^Xm, Mm^Xm, Xu, Xu
Gg^Efm, Gs, Gs, Ce, Gg, Ce, Gg, Gg, Gs, Gg, Re, Gg, Gg^Vh, Gg^Efm, Gg^Efm, Gg, Gg, Re, Gg, Re, Gg, Hhd, Mm, Mm, Mm, Mm, Mm, Mm^Xm, Mm^Xm
Gg, Gs, Re, Re, Gg, Gg, Gg, Gg, Gs, Gg^Efm, Gg^Efm, Re, Gg, Gg, Rp, Gs, Re, Re, Gg^Efm, Gg, Gg, Hh, Mm, Mm, Hh, Hh, Hh, Mm^Vhh, Mm
Gs, Gg, Re, Gg, Gg, Gg^Efm, Gg^Efm, Gg, Gll^Fp, Gg, Gll, Gs, Gs, Gs, Gg, Rp, Gg, Rp, Rp, Gg, Gg, Gg, Hh, Hh, Mm, Mm, Mm, Mm, Mm
Gs, Gg, Re^Vh, Gg, Gll, Gs^Efm, Gll^Fp, Gll^Fp, Gll^Fp, Gs^Vl, Gll^Fp, Gs^Fp, Gs^Fp, Gs^Fp, Gll^Fp, Gg, Gg, Gg^Vh, Gg, Gg^Efm, Gg, Gg^Efm, Hh, Hh, Hh, Mm, Mm, Mm, Mm
Gg, Gg, Gg, Gg, Gll, Gll^Fp, Hh^Fp, Gg^Fet, Hh^Fp, Gll^Fp, Hh^Fp, Gll^Fp, Gll^Fp, Gll^Fp, Gll^Fp, Gll, Gll^Efm, Gg^Efm, Gg, Rp, Gg, Gg^Efm, Gg^Efm, Hh, Hh, Hh^Vhh, Hh, Hh, Hh
Gg, Gs, Gg, Gg, Hh^Fp, Hh^Fp, Mm, Hh, Hh, Hh^Fp, Hh, Hh, Mm, Hh^Fet, Hh^Fp, Gll^Fp, Gll^Fp, Gg^Efm, Gg^Efm, Rp, Rp, Gg, Gg, Gll, Gs, Gll^Fp, Hh^Fp, Hh, Hh^Fp
Gg, Gs, Gg, Gg^Efm, Hh, Mm, Mm, Mm, Mm, Mm, Hh, Mm, Mm, Mm, Mm, Hh, Mm, Hh, Hh, Hh, Gg, Gg, Gg, Gs, Gs, Gs^Fp, Gll^Fp, Hh^Fp, Hh^Fp
Gs, Gs^Es, Gg, Hh, Hh, Mm, Mm, Mm, Mm, Mm, Hh, Mm, Mm, Mm, Mm, Mm, Mm, Mm, Hh^Vhh, Hh, Gg, Re, Re, Gg, Gs, Gll^Fp, Gll^Fp, Gll^Fp, Gll^Fp
Gg, Gg, Gg, Gg, Gll^Fp, Hh, Hh, Mm, Mm, Mm, Hh, Hh^Vhh, Mm, Mm, Mm, Mm, Mm, Mm, Mm, Hh, Hh, Gg, Rp, Gll, Gll, Gll^Fp, Gg^Fet, Gll^Fp, Gll^Fp
Ds, Ds, Gg, Gll^Fp, Hh^Fp, Hh^Vhh, Hh, Hh, Hh^Fp, Hh, Hh, Mm, Mm, Mm, Mm, Mm, Mm, Mm, Mm, Hh, Gg, Gs, Rp, Gs, Ce, Gll^Fp, Gll^Fp, Gll^Fp, Gll^Fp
Ww, Ww, Ds, Gll^Fp, Hh^Fp, Hh^Fp, Hh^Fp, Hh^Fp, Hh^Fet, Hh^Fp, Hh^Fp, Hh, Hh, Mm, Hh, Hh, Hh, Mm, Hh^Vhh, Hh, Gg, Ce, Ce^Es, Ce^Es, Ce, Ce, Hh^Fp, Gll^Fp, Gll^Fp
Ww, Ww, Ket, Gg^Fet, Gll^Fp, Ket, Hh^Fp, Hh^Fp, Gll^Fp, Gs^Ve, Gll^Fp, Gll, Gll^Fp, Hh, Gg, Hh, Gg, Hh, Gg, Gg, Re, Re, Ce, 4 Ke, Ce, Hh, Mm, Hh, Hh
Wo, Wo, Wo, Ww, Re, Gll^Fp, Ds, Gg, Ket, Gs^Fp, Gg, Gll^Fet, Re, Gg, Gg, Gg, Rp, Rp, Rp, Re, Gg, Ce, Hh^Fp, Ce, Hh, Mm, Mm, Mm, Mm
Wo, Wo, Ce, Wo, Ww, Wwf, Ce, Gs, Re, Gg, Re, Re, Gg, Re, Gg, Rp, Gg^Efm, Gg^Efm, Gg, Gg, Gg, Gll^Fp, Hh^Fp, Hh^Fp, Mm, Hh, Hh, Mm, Mm
Wo, Wo, Ce, Ce, 2 Ket, Ce, Ce^Edt, Re, Gs^Edt, Gs, Gg, Gs^Edb, Gg, Gs, Gg, Gg, Gg^Efm, Gs^Vc, Gg, Gs, Gll^Fp, Gll^Fp, Gll^Fp, Gg^Ve, Mm, Mm, Hh^Vhh, Hh, Hh
Wo, Ce, Ce^Es, Ket, Ket, Ket, Ce, Ce, Gs^Edb, Ket, Gs, Gs, Gg^Vh, Gg^Edt, Gs, Gg, Gs, Gs, Gg^Efm, Gs, Gs^Fp, Gs^Fp, Hh, Hh, Hh, Hh, Mm, Mm, Mm
Wo, Wo, Ce, Ce, Wwf, Ce, Ce, Gg, Gll, Gll, Gll, Gll, Gll^Fp, Gs, Gll, Gll, Gg, Gg^Efm, Gg^Efm, Gs, Hh, Hh, Mm, Mm, Mm, Mm, Mm, Mm, Mm
Ww, Ww, Ww, Wo, Wwf, Wwf^Edt, Gll, Gd^Edb, Gll^Fp, Ket, Gll^Fp, Gll^Fp, Gll^Fp, Gll^Fp, Gll^Fp, Gll^Fp, Gg^Fet, Gll, Gg, Gg^Efm, Mm, Hh, Hh^Vhh, Mm, Mm, Mm, Mm, Mm^Xm, Mm^Xm
Gs, Ww, Gll^Edb, Wwf^Em, Gll^Fp, Ds, Gll^Fp, Gll^Fp, Gll^Fp, Gll^Fp, Gg^Fet, Gll^Fp, Gll^Fp, Gll^Fet, Gll^Vl, Gll^Fp, Gll^Fp, Gll^Fp, Gll, Gg^Efm, Mm, Hh, Hh, Mm, Mm, Mm, Mm^Xm, Mm^Xm, Mm^Xm
Gd, Gd, Gd, Gll^Fp, Gll^Fp, Gll^Fp, Gll^Fp, Gll^Fp, Gll^Fp, Gll^Fp, Gll^Fp, Gll^Fp, Gs^Fp, Gll^Fp, Gg, Gll^Fp, Gll^Fp, Gll^Fp, Gg, Gg^Efm, Mm, Hh, Hh, Mm, Mm, Mm, Mm^Xm, Mm^Xm, Mm^Xm
