Rp, Rp, Hh, Hh^Fp, Hh^Fms, Gll^Fp, Gll^Fp, Gg, Hh, Mm, Hh, Mm, Mm, Mm, Mm, Mm, Mm, Mm, Wog, Hh, Hh, Mm, Mm, Mm, Mm, Mm, Mm, Mm, Mm, Mm^Xm, Mm^Xm, Mm^Xm
Gs^Fp, Rp, Rp, Rp, Rp, Gll^Fp, Gd^Fp, Gll^Fp, Gll^Fp, Hh^Fp, Mm, Mm, Mm, Mm, Mm, Mm, Mm, Mm, Wog, Hh, Sm, Mm, Mm, Mm, Mm, Mm, Mm, Mm, Mm, Mm^Xm, Mm^Xm, Mm^Xm
Gll^Fp, Gll^Fp, Gll^Em, Gg, Rp, Gs, Gll, Gll^Fmw, Ss, Gll^Fp, Hh, Hh^Fp, Hh^Fp, Mm, Hh^Fp, Mm, Hh, Wwg, Wwg, Wog, Ss, Mm, Hh, Hh^Vud, Gs^Fms, Mm, Hh, Hh, Mm, Mm, Mm, Mm^Xm
Gll^Fp, Gd^Fmf, Gll^Fmf, Ce, Ce, Ce, Ce, Gll^Fmf, Ss, Sm, Gll^Fp, Hh^Fmf, Hh^Fmf, Hh^Fp, Hh, Hh, Hh, Wwg, Hh, Ss, Ss, Hh, Gg, Gg, Rp, Gs^Fms, Gg, Hh, Hh, Mm, Mm, Mm
Gll^Fmw, Gll^Fmw, Gll, Ce, Ce, 1 Ke, Ce, Gll^Fmf, Gs, Ss, Gg, Hh^Fmf, Hh, Hh, Gg^Fet, Hh, Gs^Efm, Hh, Hh, Gs, Rp, Gg, Rp, Rp, Hh, Rp, Rp, Rp, Rp, Hh, Hh, Hh
Gll^Fp, Gll^Fp, Gll^Fmf, Ce, Gg, Ce, Rp, Gs, Rp, Rp, Rp, Re, Re, Gg, Gs, Gg^Efm, Gg, Gg, Rp, Rp, Gg, Rp, Hh, Gg, Hh, Hh, Mm, Hh, Hh, Rp, Rp, Rp
Hh^Fp, Gll^Fp, Hh^Fp, Gs, Hh, Gg, Gg, Rp, Gg, Gg^Efm, Gs^Efm, Gg, Gg, Rp, Rp, Rp, Rp, Rp, Hh, Hh, Hh, Hh, Mm, Hh, Cud, Cud, Cud, Mm, Hh, Rp, Gg, Gg
Hh, Hh^Fp, Mm, Gg, Hh^Vhh, Hh, Hh, Hh, Hh, Hh, Hh, Gs^Efm, Hh, Gs, Rp, Rp, Hh, Hh, Hh^Vhh, Mm, Mm, Mm, Mm, Mm, Cud, 2 Kud, Cud, Hh, Rp, Rp, Gs^Vud, Gg
Mm, Mm, Mm, Mm, Mm, Mm, Mm, Hh, Mm, Hh, Mm, Hh, Hh, Gg, Rp, Gg, Hh, Hh, Mm, Mm, Mm, Mm, Ds, Mm, Mm, Cud, Mm, Hh, Mm, Rp, Hh, Hh
Mm, Mm, Mm^Xm, Mm, Mm, Mm, Mm, Mm, Mm, Mm, Hh, Hh, Wwg, Ch^Fet, Wwf, Ch^Fet, Hh, Hh, Hh, Mm, Hh, Mm, Ds, Mm, Hh, Hh, Hh, Mm, Rp, Rp, Hh, Hh
Mm, Mm, Mm, Mm, Hh, Mm, Ds, Mm, Mm, Mm, Hh, Wwg, Wog, Wwg, Wwg, Wwf, Wwf, Hh, Wwg, Hh, Wwg, Ds, Wwg, Ds, Wwg, Hh, Wwg, Mm, Rp, Hh, Mm, Mm
Mm, Mm, Mm, Mm, Ds, Ds^Es, Wwg, Mm, Ss, Hh, Wwg, Wwg, Wog, Wog, Wwg, Wwf, Wwf^Es, Wwg, Wog, Wwg, Wog, Wwg, Wog, Wog, Wog, Wwg, Wwg, Hh, Rp, Mm, Mm, Mm
Wog, Wog, Wog, Wog, Wog, Ds, Wog, Wwg, Wwg, Wwg, Wwg, Wwg, Wog, Wog, Wog, Wwg, Wwf^Es, Wwg, Wog, Wog, Wog, Wog, Wog, Wog, Wog, Wog, Hh, Hh^Vhh, Rp, Mm, Mm, Mm
Wog, Wog, Wog, Wog, Wog, Wog, Wog, Wog, Wog, Wog, Wog, Wog, Wog, Wog, Wwg, Wwg, Wwf, Wwg, Wwg, Wwg, Wwg, Wog, Wwg, Wog, Ds, Wog, Mm, Hh, Rp, Mm, Hh, Hh
Wog, Wog, Wog, Wog, Wog, Wog, Wog, Wog, Wog, Wog, Wog, Wog, Wwg, Wwg, Wwf, Wwg, Wwf, Wwf, Hhd, Wwg, Hhd^Fp, Wwg, Wwg, Gll^Fet, Gll^Fp, Wwg, Wwg, Hh, Wwg^Bw|, Hh, Wwg, Wwg
Wwg, Wwg, Ss, Wog, Wwg, Wog, Wwg, Wog, Wog, Wog, Wog, Wog, Wwg, Hh, Hh, Hh, Gg, Re^Es, Re, Hhd^Fp, Hhd^Fp, Hh^Fp, Gll^Fp, Gll^Fp, Gll^Fp, Ds, Re, Wwg, Rp, Wwg, Mm, Mm^Xm
Wwg, Wwg, Ss, Ss, Ss, Wwg, Hh^Vh, Wwg, Ss, Ss, Ss, Ss, Hh, Hh, Gs, Hh, Gs, Rp, Rp, Hhd^Fp, Gll^Fp, Hh^Fp, Re^Fp, Gll^Fp, Gs, Rp, Re, Re, Mm, Gs^Vl, Mm, Mm
Hh, Hh, Hh, Ss, Hh, Hh, Mm, Hh, Mm, Ss, Hh, Ss, Hh, Hh, Hh, Gg, Gg^Efm, Gs^Vh, Rp, Gll^Fp, Gll^Fp, Hh^Fp, Re^Fp, Gs^Em, Rr, Rr, Hh, Mm, Mm, Mm, Mm, Mm
Mm, Mm, Mm, Hh, Mm, Mm, Mm, Mm, Mm, Mm, Mm, Hh, Hh, Gs, Gs, Gg, Gg, Gs, Rp, Rr, Gll^Fp, Gll^Fp, Gll^Fp, Gg, Rr, Hh, Hh, Mm, Mm, Mm, Mm, Mm
Mm, Mm, Mm, Mm, Mm, Mm, Mm, Mm, Mm, Mm, Mm, Hh, Hh, Gg, Hh, Gs^Efm, Gs, Gs^Efm, Re, Rr, Rr, Rp, Rp, Rr, Gg, Gg, Chr, Mm, Chr, Mm, Mm, Mm
Mm, Mm, Mm, Mm, Mm^Vhcr, Mm, Hh, Hh, Hh, Mm, Hh, Hh^Vhcr, Chr, Hh^Fp, Gll^Fp, Rr, Rr, Rr, Re, Rr, Rp, Rp, Rp, Rp, Gg, Chr, Hh, Chr, Gg, Chr, Hhd^Fmw, Mm
Mm, Mm, Mm, Mm, Mm, Hh, Mm, Hh, Hh, Hh, Gs, Hh, Gg, Hh, Rp, Re, Hh, Re, Hh, Gg, Chr, Gg, Gg, Rp, Rp, Hh, Hh, Gs, Re, Gll^Fmw, Re^Fmw, Hhd
Hh, Hh, Hh, Mm, Hh, Mm, Gg, Hh, Gg, Gs, Gs, Gs, Gg, Rp, Chr, Hh, Mm, Mm, Hh, Gg, Chr, Re, Gll^Fp, Gll^Fmw, Rp, Rp, Re, Re, Gll, Re^Fmw, Gs, Hhd
Hh, Hh, Re, Re, Re, Re, Re, Gg, Re, Gs, Re, Re, Rp, Rp, Mm, Hh, Mm, Mm, Mm, Chr, Hh, Re, Gll^Fp, Gll, Chr^Dr, Rp, Chr, Chr, Chr, Re, Hh, Hh
Gg, Gg, Re, Gg, Gs^Fp, Gg, Hh, Re, Hh, Re, Hh, Hh, Hh, Mm, Mm, Mm, Mm, Mm, Mm, Chr, Hh^Fmw, Re^Fmw, Gs, Re, Chr^Dr, Chr, Chr, 3 Khr, Chr, Hh, Hh^Fp, Hh
Re, Re, Gg, Gs^Fp, Hh, Hh, Mm, Mm, Mm, Hh^Vl, Mm, Mm, Mm^Xm, Mm, Mm, Mm, Mm, Mm, Mm, Mm, Hhd, Hhd^Fmw, Re, Re, Gs, Rd, Chr, Chr, Hh, Hh, Hh^Fp, Hh^Fp
Re, Re, Hh, Hh, Hh, Mm, Mm^Xm, Mm^Xm, Mm^Xm, Mm, Mm, Mm, Mm, Mm^Xm, Mm^Xm, Mm, Mm, Mm, Mm, Mm, Hhd, Mm, Hhd, Re, Hh, Gs, Gg, Hh, Hh, Hh^Fmw, Hh^Fp, Mm
Re, Re, Rp, Hh, Hh, Mm, Mm, Mm, Mm, Mm, Mm, Mm, Mm, Mm, Mm, Mm, Mm, Mm, Mm^Xm, Mm, Mm, Mm, Mm, Chr, Chr, Hh, Chr, Mm, Mm, Mm, Mm, Mm
Gg, Gg, Re, Rp, Hh, Hh, Gg^Ve, Hh, Hh, Mm, Hh, Mm, Hh, Mm, Mm, Mm, Mm, Mm, Mm, Mm, Mm, Mm, Mm, Mm, Hh, Chr, Hh, Mm, Mm, Mm, Mm, Mm
Hh, Gg, Re, Rp, Gg, Hh, Hh, Hh, Hh, Hh^Fp, Hh^Fms, Hh^Fms, Hh^Fp, Hh, Mm, Mm, Hh^Ve, Hh, Hh, Mm, Mm, Mm, Mm, Hh, Hh, Hh, Hh, Hh, Mm, Mm, Mm, Mm
Hh, Gg, Hh, Rp, Rp, Gg^Efm, Gg, Gg^Efm, Gg^Efm, Gs^Fms, Gg^Fms, Hh^Fms, Gg^Fms, Hh^Fms, Hh, Hh, Gll^Fp, Hh, Hh, Hh, Hh, Hh, Hh, Hh, Hh^Fms, Hh^Fms, Hh, Hh, Hh, Mm, Mm, Mm
Mm, Mm, Mm, Hh, Hh, Rp, Rp, Rp, Rp, Gg, Gg, Gs^Fms, Rp, Gg, Rp, Gg, Gll^Fp, Gll^Fp, Gll^Fp, Gll^Fp, Gg, Gg, Gll^Fp, Hh^Fms, Hh^Fp, Hh^Fp, Hh^Fp, Hh, Hh, Hh, Mm, Mm
Mm, Mm, Mm, Mm, Mm^Xm, Hh^Fp, Hh, Gs, Hh, Rp, Rp, Rp, Gg, Rp, Gs, Re, Re, Hh, Hh, Gll^Fms, Gll^Fp, Gll^Fms, Hh^Fp, Gll^Fp, Hh^Fp, Mm, Mm, Hh, Hh^Fp, Mm, Mm, Hh
Hh, Hh, Mm, Mm, Mm, Mm, Hh, Hh, Gg, Gg^Efm, Gll^Fp, Gg, Gg, Gs^Efm, Gg^Efm, Gg^Efm, Re, Hh, Gg^Efm, Hh, Gll^Fp, Hh^Fp, Hh, Hh, Hh^Fp, Mm, Mm, Mm, Mm, Mm, Mm, Hh
Mm, Mm, Mm, Hh^Fp, Mm, Hh, Hh^Fp, Hh^Fp, Gll^Fms, Gs, Gll^Fp, Gll^Fp, Gll^Fp, Gg^Efm, Gs, Re, Gg, Gg^Eff, Gs^Eff, Gs, Gll^Fp, Gll^Fp, Hh^Fp, Hh^Fp, Mm, Mm, Mm, Mm, Mm, Hh^Fp, Hh, Hh
Mm, Mm, Mm, Hh, Hh, Hh^Fp, Gll^Fp, Gll^Fp, Gll^Fp, Gll^Fp, Gll^Fp, Gll^Fp, Gg, Gg, Gg, Re, Gs, Gg^Efm, Gg, Gg, Gll^Fp, Gll^Fp, Gll^Fp, Hh^Fp, Hh, Mm, Mm, Mm, Mm, Mm, Mm, Gll^Fp
Mm, Mm, Hh, Mm, Hh, Hh^Fp, Gll^Fp, Gll^Fms, Gll^Fp, Gll^Fp, Gg, Gll^Fp, Gg^Efm, Gg, Re, Re, Gg, Gg, Gg, Gg, Gg, Gll^Fp, Gll^Fp, Gll^Fp, Hh, Hh, Hh, Mm, Mm, Mm, Hh^Fp, Hh^Fp
Hh, Hh, Hh, Hh, Hh^Fp, Hh^Fp, Gll^Fp, Gll^Fp, Gll^Fp, Gg, Gg, Gg, Gg^Efm, Gg, Re, Ket, Re, Gll^Fp, Gg, Gg, Gll^Fp, Gll^Fp, Gll^Fp, Hh, Hh^Fp, Hh, Hh^Fms, Mm, Hh, Hh^Fp, Hh^Fp, Hh^Fp
Gll^Fms, Hh, Hh, Hh^Fp, Gll^Fp, Hh^Fp, Gg, Gg, Gll^Fp, Gll^Fp, Gg, Gg, Gll^Fp, Re, Gg, Re, Re, Gll^Fp, Gll^Fp, Gg, Gll^Fp, Gll^Fp, Gll^Fp, Gll^Fp, Gll^Fms, Hh^Fms, Hh^Fp, Hh^Fp, Hh^Fp, Hh^Fp, Hh^Fp, Hh^Fp
Gg, Gll^Fms, Gg, Hh^Fp, Gll^Fp, Gll^Fp, Gg, Gg, Gg, Gg, Gg, Gg, Gll^Fp, Re, Gg, Re, Re, Gll^Fp, Gll^Fp, Gg, Gll^Fp, Gll^Fp, Gll^Fp, Gll^Fp, Gll^Fp, Hh^Fp, Gll^Fp, Hh^Fp, Hh^Fp, Hh^Fp, Hh^Fp, Hh^Fp
