Xu, Xu, Xu, Xu, Xu, Xu, Xu, Xu, Xu, Xu, Xu, Xu, Xu, Xu, Xu, Xu, Xu, Xu, Xu, Xu, Xu, Xu
Xu, Xu, Xu, Xu, Xu, Xu, Xu, Xu, Xu, Xu, Xu, Xu, Xu, Xu, Xu, Xu, Xu, Xu, Xu, Xu, Xu, Xu
Xu, Xu, Xu, Xu, Uu^Vud, Uu^Vud, Rr, Rr, Rr, Rr, Rr, Uu^Vud, Uu^Vud, Xu, Xu, Uu^Vud, Rr, Uu^Vud, Rr, Uu^Vud, Xu, Xu
Uu, Uu, Uu, Xu, Rr, Rr, Rr, Rr, Cud, Rr, Rr, Rr, Rr, Xu, Xu, Rr, Rr, Rr, Cud, Cud, Xu, Xu
Xu, Xu, Xu, Uu, Rr, Rr, Cud, Cud, 1 Kud, Cud, Cud, Rr, Rr, Xu, Xu, Rr, Rr, Rr, Cud, 2 Kud, Xu, Xu
Xu, Xu, Xu, Xu, Rr, Rr, Rr, Cud, Cud, Cud, Rr, Rr, Rr, Xu, Xu, Rr, Rr, Rr, Rr, Cud, Xu, Xu
Xu, Xu, Xu, Xu, Cud, Rr, Cud, Rr, Rr, Rr, Cud, Rr, Cud, Xu, Xu, Rr, Rr, Rr, Rr, Rr, Xu, Xu
Xu, Xu, Xu, Xu, Cud, Cud, Rr, Rr, Rr, Rr, Rr, Cud, Cud, Xu, Xu, Uu^Vud, Rr, Rr, Rr, Rr, Xu, Xu
Xu, Xu, Xu, Xu, Rr, Rr, Rr, Rr, Rr, Rr, Rr, Rr, Rr, Xu, Xu, Xu, Xu, Uu^Vud, Rr, Rr, Xu, Xu
Xu, Xu, Xu, Xu, Rr, Rr, Rr, Rr, Rr, Rr, Rr, Rr, Rr, Rr, Rr, Xu, Xu, Xu, Xu, Uu^Vud, Xu, Xu
Xu, Xu, Xu, Xu, Rr, Rr, Rr, Uu^Vud, Rr, Rr, Rr, Uu^Vud, Rr, Rr, Rr, Rr, Uu^Vud, Xu, Xu, Xu, Xu, Xu
Xu, Xu, Xu, Xu, Rr, Rr, Rr, Rr, Rr, Rr, Cud, Rr, Cud, Rr, Rr, Rr, Rr, Rr, Rr, Xu, Xu, Xu
Xu, Xu, Xu, Xu, Rr, Rr, Cud, Rr, Cud, Rr, Rr, 4 Kud, Rr, Rr, Cud, Rr, Cud, Rr, Rr, Xu, Xu, Xu
Xu, Xu, Xu, Xu, Cud, Cud, Rr, Rr, Rr, Cud, Cud, Rr, Cud, Cud, Rr, Rr, Rr, Cud, Cud, Xu, Xu, Xu
Xu, Xu, Xu, Xu, Rr, Rr, Rr, Rr, Rr, Rr, Rr, Rr, Rr, Rr, Rr, Rr, Rr, Rr, Rr, Xu, Xu, Xu
Xu, Xu, Xu, Xu, Rr, Rr, Rr, Rr, Rr, Rr, Rr, Rr, Rr, Rr, Rr, Rr, Rr, Rr, Rr, Xu, Xu, Xu
Xu, Xu, Xu, Xu, Rr, Rr, Rr, Uu^Vud, Rr, Rr, Rr, Rr, Rr, Rr, Rr, Uu^Vud, Rr, Re, Rr, Xu, Xu, Xu
Xu, Xu, Xu, Xu, Rr, Re, Chr, Rr, Re, Rr, Rr, Uu^Vud, Rr, Rr, Rr, Rr, Re, Re, Rr, Xu, Xu, Xu
Xu, Xu, Xu, Xu, Rr, Re, Re, Chr, Rr, Rr, Rr, Rr, Rr, Rr, Re, Chr, Re, Re, Rr, Xu, Xu, Xu
Xu, Xu, Xu, Xu, Rr, Rr, Rr, Rr, Rr, Chr, Chr, Re, Re, Chr, Rr, Rr, Rr, Rr, Rr, Xu, Xu, Xu
Xu, Xu, Xu, Xu, Rr, Rr, Rr, Rr, Rr, Re, Re, Re, Re, Chr, Rr, Rr, Rr, Rr, Rr, Xu, Xu, Xu
Xu, Xu, Xu, Xu, Rr, Rr, Rr, Rr, Rr, Chr, Re, Chr, Rr, Chr, Rr, Rr, Re, Rr, Rr, Xu, Xu, Xu
Xu, Xu, Xu, Xu, Re, Re, Re, Chr, Rr, Rr, Rr, Rr, Rr, Rr, Rr, Chr, Chr, Re, Re, Xu, Xu, Xu
Xu, Xu, Xu, Xu, Rr, Chr, Rr, Re, Rr, Rr, Rr, Rr, Rr, Rr, Rr, Re, Rr, Re, Re, Xu, Xu, Xu
Xu, Xu, Xu, Xu, Rr, Rr, Rr, Rr, Rr, Re, Re, Re, Rr, Rr, Re, Rr, Rr, Rr, Rr, Xu, Xu, Xu
Xu, Xu, Xu, Xu, Rr, Rr, Rr, Uu^Vud, Rr, Rr, Rr, Re, Rr, Rr, Re, Uu^Vud, Rr, Rr, Re, Xu, Xu, Xu
Xu, Xu, Xu, Xu, Re, Rr, Re, Rr, Re, Rr, Chr, Rr, Chr, Rr, Rr, Rr, Rr, Re, Chr, Xu, Xu, Xu
Xu, Xu, Xu, Xu, Rr, Chr, Chr, Rr, Chr, Re, Re, Rr, Rr, Chr, Chr, Rr, Chr, Re, Re, Xu, Xu, Xu
Xu, Xu, Xu, Xu, Rr, Re, Rr, Re, Re, Rr, Rr, Rr, Rr, Re, Re, Rr, Rr, Rr, Re, Xu, Xu, Xu
Xu, Xu, Xu, Xu, Rr, Rr, Rr, Rr, Re, Rr, Rr, Rr, Re, Re, Rr, Rr, Rr, Rr, Rr, Xu, Xu, Xu
Xu, Xu, Xu, Xu, Rr, Re, Re, Rr, Rr, Rr, Rr, Rr, Rr, Re, Rr, Rr, Rr, Rr, Rr, Xu, Xu, Xu
Xu, Xu, Xu, Xu, Rr, Rr, Rr, Rr, Uu^Vu, Rr, Rr, Rr, Rr, Rr, Rr, Rr, Re, Rr, Rr, Xu, Xu, Xu
Xu, Xu, Xu, Xu, Rr, Rr, Rr, Rr, Re, Re, Chr, Rr, Ce, Uu^Vu, Ce, Rr, Re, Rr, Rr, Xu, Xu, Xu
Xu, Xu, Xu, Xu, Rr, Uu^Vu, Chr, Chr, Rr, Chr, Re, Re, Ce, Re, Uu^Vu, Chr, Chr, Rr, Rr, Xu, Xu, Xu
Xu, Xu, Xu, Xu, Rr, Chr, Re, Re, Rr, Uu^Vu, Rr, Ce, Ce, 3 Ke, Ce, Rr, Re, Re, Uu^Vu, Xu, Xu, Xu
Xu, Xu, Xu, Xu, Rr, Rr, Uu^Vu, Uu^Vu, Re, Rr, Rr, Uu^Vu, Rr, Ce, Rr, Uu^Vu, Uu^Vu, Re, Rr, Xu, Xu, Xu
Xu, Xu, Xu, Xu, Xu, Xu, Xu, Xu, Xu, Xu, Xu, Xu, Xu, Xu, Xu, Xu, Xu, Xu, Xu, Xu, Xu, Xu
