Ww, Ww, Wo, Wo, Wo, Ww, Ww, Ww, Ds, Re, Gg^Efm, Gg, Gs, Gg, Gg, Hh, Hh^Fp, Hh, Mm, Mm, Mm, Mm, Mm, Gs^Fp, Hh, Gll^Fp, Gll^Fp, Gll^Fp, Gll^Fp, Gll^Fp
Gg, Ww, Wo, Wo, Wo, Wo, Ww, Ww, Ds, Gg, Gg^Efm, Gg, Gs, Gs^Efm, Gg, Ce, 1 Ke, Ce, Hh^Fp, Mm, Mm, Mm, Mm, Hh, Gg^Ve, Gll^Fp, Gll^Fp, Gll^Fp, Gll^Fp, Gll^Fp
Gg, Gg, Ww, Wo, Wo, Wo, Wwf, Ds, Ds^Fms, Gg^Efm, Gs^Fms, Re^Vct, Gll, Gs^Efm, Ce, Ce, Ce, Ce, Ce, Hh^Fp, Mm, Mm, Mm, Hh^Fp, Gll^Fp, Gll^Fp, Gg^Fet, Gll^Fp, Gs^Vl, Gg
Gg, Gs, Ww, Wo, Wo, Ww, Wwf, Ds, Ds, Gll^Fp, Gll^Fmw, Gll^Fms, Gll, Gg, Gs, Gs, Gg, Ce, Hh, Mm, Mm, Mm, Hh^Fp, Hh^Fp, Gll^Fp, Gll^Fp, Gs, Gs, Gs, Gll^Fp
Gs, Gg, Gg, Wwf, Wwf, Wwf^Es, Ww, Wwf, Ww, Ds^Efm, Gll^Fmw, Gs^Fms, Gs, Gs, Re^Vct, Gg, Gg, Gg, Gll^Fp, Hh^Fetd, Mm, Mm, Gg^Ve, Gll^Fp, Gll, Gll, Gg, Gg, Gll^Fp, Gll^Fp
Gs, Gs, Gs, Ds, Ds, Wwf, Ss, Ss, Ww, Gll^Fp, Gg^Efm, Gll^Fp, Gg, Gg^Efm, Gg, Gg^Edt, Gs, Gll^Fp, Hh^Fp, Mm, Hh^Fmw, Hh^Fp, Gll^Fp, Gg, Re, Gg, Gg, Gs, Gll^Fp, Hh^Fp
Gs, Gg^Vc, Gs, Ds, Hh, Ww, Ss, Ss, Ww, Ds, Gg, Re, Re, Gg, Re, Gg^Edt, Gs, Gll^Fp, Hh^Fp, Hh^Fmw, Gll^Fmw, Hh^Fmw, Gg, Re, Gg, Gll^Fp, Gg, Gs, Hh, Hh
Gg, Gg, Gll^Fp, Hh, Hh, Ss, Hh^Dr, Ww, Ss, Gg, Sm^Xo, Hh^Dr, Gg, Gg^Edb, Gg, Re, Gs, Gg, Gg, Gll^Fp, Gg, Gll^Fmw, Gg, Re, Gg, Gll^Fp, Gg^Efm, Gg^Efm, Hh, Hh
Gg^Efm, Gg^Efm, Gg^Efm, Hh, Gg, Ss, Hh^Dr, Sm^Xo, Sm^Xo, Sm^Xo, Wog, Hh^Dr, Gs, Gg, Gg, Rp, Gg, Gg, Gg^Efm, Gg, Re, Gg^Gvs, Re^Gvs, Gg, Gg^Efm, Gg^Efm, Gg^Edb, Gg, Hh, Hh
Re, Gg, Gs^Efm, Ch, Gg, Gg, Hh^Dr, Sm^Xo, Hh^Dr, Hh^Dr, Wog, Hh^Dr, Wog, Gg, Gg, Rp, Rp, Rr, Rr, Re^Gvs, Re^Gvs, Re^Gvs, Re, Gd^Vo, Gs^Efm, Re^Edb, Re, Gg, Hh, Hh
Gg, Re, Re, Gs, Gg, Wog, Wog, Hh^Dr, Wog, Wog, Wog, Wog, Wog, Ch, Wog, Gg, Gg, Re, Gg, Re^Gvs, Gg^Fet, Re^Gvs, Re, Gs, Gg^Ecf, Re^Es, Re^Es, Re^Edb, Re, Re
Gs, Gg, Re, Gs, Wog, Wog, Co, Wog, Rr^Vo, Wwg, Co, Wwg, Wwg, Wog, Wog, Wog, Wog, Wog, Gg, Gg, Re^Gvs, Re^Gvs, Gg, Rr, Gg^Es, Re, Co, Gs, Gg, Re
Gg, Gs, Gg, Wog^Bsb\, Co, Co, Re, Rb, Rr^Edt, Rr^Edt, Rr^Edt, Re^Edt, Re, Co, Co, Ko, Co, Wog, Wog^Bsb/, Gg, Gg, Gg, Gg, Rp^Es, Re, Rb, 2 Ko, Co, Rb, Gg
Gg, Gg^Vc, Wog, Wog, Ko, Re, Re, Rr^Edt, Ch, Ch, Ch, Rb^Edt, Re^Vo, Rr, Re^Es, Rr, Rr, Co, Wog, Wog, Gg, Gs^Vh, Gg^Ecf, Rp^Es, Rb, Co, Co, Co, Re^Es, Re
Gg, Gg, Wog, Co, Rr, Rr^Es, Rb^Es, Rr, Ch, Rr, Ch, Sm^Em, Sm, Re^Edt, Rb, Re^Es, Rr, Co, Wwg, Wog, Hh, Gg, Rr, Rb, Re, Co, Gg, Co, Re^Es, Rb^Es
Gg^Eff, Gg^Efm, Wog, Co, Rr, Rr^Edt, Rb^Edt, Wwg, Wwg, Ch, Wwg, Wwg, Wwg, Rr^Edt, Ch, Rr, Rr^Vo, Rr, Wwg, Wog, Ch, Gg, Re, Rr, Gg, Re, Gg^Ecf, Gg, Re, Rb
Rp, Gg^Eff, Gg, Wog, Rb, Rb^Vo, Re^Edt, Re^Edt, Re, Wwg, Re, Wwg, Rr, Rr^Edt, Ch, Rr, Rr^Edt, Rr, Wwg^Bsb\, Wog, Wog, Gg, Rp, Rp, Gs^Edb, Gg, Re^Vo, Re, Gll^Fmw, Gll^Fmw
Gg, Rp, Rp, Wog^Bsb/, Wog, Rr, Rr, Rb^Edt, Khr, Ch, Rb, Rr, Rb, Ch, Rb^Edt, Rr^Edt, Co, Wwg, Wog, Wog^Bsb\, Rp, Rp, Gg, Gg, Gg^Edb, Gg, Gs^Edb, Gll^Fmw, Hh^Fmw, Hh
Gll, Gll^Vo, Gll^Fp, Wog, Wog, Co, Ko, Rb, Rb^Edt, Rr, Rr^Edt, Rb^Vo, Re, Rr^Edt, Rb, Rb^Es, Co, Wwg, Wog, Wog, Wog, Hh^Dr, Hh^Dr, Ds, Ds, Ds, Gs^Edb, Gg^Edb, Hh^Fmw, Hh
Gll^Fp, Gll^Fp, Gll^Fp, Wog, Wog, Wwg, Co, Rb, Co, Rr^Edt, Co, Re, Co, Re, Co, Co, Co, Wwg, Wog, Wog, Hh^Dr, Hh^Dr, Sm^Xo, Sm^Xo, Ww, Ds, Hh, Hh^Fmw, Mm, Mm
Gll^Fp, Gll^Fp, Gll^Fp, Gg^Efm, Wog, Wwg, Wog, Co, Wog, Wog, Wog, Co, Wog, Ko, Wog, Wog, Wog, Wog, Hh^Dr, Hh^Dr, Sm^Xo, Sm^Xo, Wo, Wo, Wo, Ww, Mm, Hh, Mm, Mm
Gll^Fp, Gll^Fms, Gll^Fp, Gll^Fms, Gll^Fp, Wog, Wog, Wog, Wog, Wog, Gll^Em, Wog, Wog, Wog, Gg^Efm, Wog, Gg^Efm, Wog, Gs^Fp, Sm^Xo, Ww, Ww, Wo, Wo, Wo, Wo, Mm, Mm, Mm, Mm
Gll^Fp, Gll^Fms, Gll^Fp, Gll^Fp, Gll^Fms, Gll^Fp, Gll^Fp, Gg, Gll^Fp, Gll^Es, Gs^Fp, Gll, Gs^Fp, Gs, Gll, Gg, Gg, Re^Vo, Gg, Ds, Ds, Ds, Ww, Wo, Wo, Hh, Wo, Hh, Mm, Hh
Gll^Fp, Gll^Fms, Gll^Fp, Gll^Fms, Gll^Fp, Gll^Fp, Gs^Fms, Gs^Fms, Gll^Fp, Gll^Fp, Gll^Fms, Gll^Fms, Gll^Fms, Gll^Fms, Gll, Gll^Fms, Gg^Fms, Gg, Gg, Gg, Ds, Ds, Ww, Ww, Wo, Wo, Wo, Mm, Gg, Hh
