Uu, Ur, Re, Xu, Xu, Qxu, Qxu, Xu, Xu, Xu, Qxu, Qxu, Xu, Xu, Xu, Xu, Xu, Xu, Xu, Xu, Xu, Xu
Uu, Ur^Es, Ur, Xu, Xu, Qxu, Qxu, Xu, Xu, Xu, Qxu, Qxu, Xu, Xu, Xu, Xu, Xu, Xu, Xu, Xu, Xu, Xu
Uu, Ur, Ur, Qxu, Qxu, Qxu, Xu, Xu, Xu, Xu, Qxu, Xu, Xu, Xu, Xu, Xu, Qxu, Qxu, Qxu, Xu, Xu, Xu
Uh^Es, Uu, Ur^Es, Rd, Uu, Qxu, Uu, Xu, Uh, Uh^Uf, Uh, Qxu, Uh, Uh, Uh, Uh, Xu, Xu, Qxu, Xu, Xu, Xu
Uh, Uu, Uu, Uu, Uu, Uu^Es, Uu, Uu, Uu, Uh, Rd, Uue^Es, Uue, Uue, Xu, Xu, Xu, Xu, Qxu, Xu, Xu, Xu
Uh, Uh, Xu, Qxu, Qxu, Uu, Qxu, Ur, Ur, Rd, Rd^Es, Uue, Rd, Uue, Xu, Xu, Qxu, Qxu, Xu, Qxu, Qxu, Qxu
Xu, Xu, Qxu, Qxu, Xu, Qxu, Xu, Xu, Uh, Ur, Re^Es, Re^Es, Uue, Uue, Uue, Qxu, Uu, Xu, Xu, Xu, Qxu, Qxu
Xu, Xu, Xu, Xu, Xu, Qxu, Qxu, Xu, Uh, Ur, Uue, Uu, Qxu, Qxu, Qxu, Uue, Xu, Uh, Uh^Uf, Uh^Uf, Qxu, Qxu
Xu, Xu, Xu, Xu, Xu, Xu, Xu, Qxu, Uue^Edb, Uue^Edb, Uue, Xu, Xu, Xu, Xu, Xu, Xu, Qxu, Uh, Uh^Uf, Xu, Xu
Xu, Xu, Wog, Wwf^Em, Rb^Es, Xu, Uh, Uh, Uue, Uue^Edb, Uue, Qxu, Qxu, Xu, Xu, Xu, Xu, Qxu, Qxu, Uh, Xu, Xu
Wwg, Wwg, Wog, Wwf, Uu, Rb, Uu, Uu, Uue, Ur, Re^Es, Xu, Qxu, Xu, Xu, Xu, Xu, Xu, Xu, Uh, Xu, Xu
Wwg, Wwg, Wog, Uu, Uu^Uf, Uu, Qxu, Qxu, Uh, Ur, Ur^Es, Qxu, Xu, Xu, Xu, Xu, Qxu, Qxu, Rb, Uu, Xu, Xu
Xu, Xu, Xu, Wog, Xu, Qxu, Xu, Xu, Ur, Ur, Uu, Xu, Xu, Xu, Xu, Xu, Qxu, Xu, Xu, Uu, Qxu, Qxu
Xu, Xu, Xu, Xu, Xu, Qxu, Xu, Xu, Uu, Uu, Uu, Uh, Qxu, Qxu, Xu, Xu, Qxu, Xu, Xu, Uu, Qxu, Qxu
Xu, Xu, Xu, Xu, Qxu, Qxu, Uu^Ii, Uu^Ii, Rd, Rd, Re, Uue^Ii, Uue, Qxu, Uu, Qxu, Xu, Xu, Uh, Uh, Qxu, Qxu
Xu, Xu, Xu, Xu, Uh^Emf, Uh^Uf, Uu, Uu^Ii, 1 Uu, Re^Ii, Re, Uue, Uue^Ii, Uue, Uu, Uu, Uu, Uu, Uh^Uf, Qxu, Xu, Xu
Xu, Xu, Xu, Xu, Uh, Uh^Uf, Uh, Uu, Uu, Rd^Ii, Uu, Uu^Ii, Uu^Ii, Uu, Qxu, Uu, Uh, Uh, Uh^Uf, Uh^Uf, Xu, Xu
Xu, Xu, Qxu, Xu, Qxu, Re, Re^Ii, Uue^Ii, Uue, Uu, Xu, Uu, Uu^Uf, Qxu, Xu, Xu, Xu, Uh, Qxu, Xu, Xu, Xu
Xu, Xu, Xu, Qxu, Xu, Qxu, Qxu, Uue^Ii, Uue^Ii, Xu, Xu, Xu, Xu, Qxu, Xu, Xu, Xu, Rb^Es, Uu, Qxu, Xu, Xu
Xu, Xu, Xu, Xu, Xu, Xu, Uue, Uue, Re^Ii, Xu, Xu, Xu, Xu, Qxu, Qxu, Xu, Xu, Rb^Es, Rb^Es, Qxu, Xu, Xu
Xu, Xu, Xu, Xu, Xu, Xu, Uue^Ii, Uue^Ii, Re^Ii, Re, Uue, Xu, Xu, Xu, Xu, Xu, Xu, Xu, Xu, Qxu, Qxu, Qxu
Xu, Xu, Xu, Xu, Xu, Xu, Xu, Re, Re, Re^Ii, Uue, Xu, Xu, Xu, Xu, Xu, Xu, Xu, Xu, Qxu, Qxu, Qxu
