Mm, Mm, Mm, Mm, Mm, Mm, Mm, Mm, Mm, Mm, Mm, Mm, Mm, Mm, Mm, Mm, Mm, Mm, Mm, Mm, Mm, Mm, Mm, Mm, Mm, Mm, Mm, Mm, Mm, Mm, Mm, Mm, Mm, Mm, Mm, Mm, Mm, Mm, Mm, Mm, Mm, Mm
Mm, Mm, Mm, Mm, Mm, Mm, Mm, Mm, Mm, Mm, Mm, Mm, Mm, Mm, Mm, Mm, Mm, Mm, Mm, Mm, Mm, Mm, Mm, Mm, Mm, Mm, Mm, Mm, Mm, Mm, Mm, Mm, Mm, Mm^Vhh, Mm, Mm, Mm, Mm, Mm, Mm, Mm, Mm
Mm, Mm, Mm, Mm^Vhh, Mm, Mm, Mm, Mm, Mm, Mm, Mm, Mm, Mm, Mm, Mm, Mm, Mm, Mm, Mm, Mm, Mm, Mm, Mm, Mm, Mm, Mm, Mm, Mm^Vhh, Mm, Mm, Mm, Mm^Vhh, Mm, Mm, Mm, Mm^Vhh, Mm, Mm, Mm, Mm, Mm, Mm
Mm, Mm, Mm, Mm, Mm, Mm, Mm, Mm, Mm, Mm, Mm, Mm, Mm, Mm, Mm, Mm, Mm, Mm, Mm, Mm, Mm, Mm, Mm, Mm, Mm, Mm, Mm^Vhh, Mm, Mm^Vhh, Mm, Mm^Vhh, Mm, Mm, Mm^Vhh, Mm, Mm, Mm, Mm, Mm, Mm, Mm, Mm
Mm, Mm, Mm, Mm^Vhh, Mm, Mm, Mm, Mm, Mm, Mm, Mm^Vhh, Mm, Mm, Mm, Mm, Mm^Vhh, Mm, Mm, Mm, Mm, Mm, Mm, Mm, Mm, Mm, Mm, Mm, Mm, Mm, Mm, Mm, Mm, Mm^Vhh, Mm, Mm, Mm, Mm, Mm, Mm, Mm, Mm, Mm
Mm, Mm, Mm, Mm, Mm, Mm, Mm, Mm, Mm^Vhh, Mm, Mm, Mm, Mm, Mm, Mm, Mm, Mm, Mm^Vhh, Mm, Mm, Mm, Mm, Mm, Mm, Mm, Mm, Mm, Mm^Vhh, Mm, Mm, Ce, Mm, Mm, Mm, Mm, Gs^Fp, Gs^Fp, Mm, Gs^Fp, Mm, Mm, Mm
Mm, Mm, Mm, Mm^Vhh, Mm, Mm, Mm, Mm, Mm, Mm, Mm, Mm, Mm^Vhh, Mm, Mm, Mm, Mm, Mm, Mm, Mm^Vhh, Mm, Mm, Mm, Mm, Mm, Mm, Mm, Mm, Mm, Ce, 7 Ke, Ce, Ce, Mm, Gs^Fp, Gs^Fp, Gs^Fp, Gs^Fp, Gs^Fp, Gs^Fp, Mm, Mm
Mm, Mm, Mm, Mm, Hh, Hh, Hh, Mm, Mm, Mm, Mm, Mm, Mm, Mm, Mm, Mm, Mm, Mm, Mm, Mm, Mm, Mm, Mm, Mm, Mm, Mm, Mm, Mm^Vhh, Mm, Ce, Ce, Ce, Ce, Gs^Fp, Gg, Gs^Fp, Gg, Gs^Fp, Gg^Vh, Gg, Gg, Gg
Hh, Hh, Mm, Hh, Hh, Hh, Co, Ko, Co, Mm, Hh, Hh, Mm, Mm^Vhh, Mm, Mm, Mm, Mm, Mm, Mm^Vhh, Mm, Mm, Mm, Mm, Mm, Mm, Gg^Ve, Mm, Hh, Mm, Hh, Ce, Gg, Gs^Fp, Gg, Gg^Vh, Gg, Gg, Gg, Gg, Gg, Gg
Hh, Hh, Hh, Hh, Co, Co, Co^Vo, Co, Co^Vo, Co, Co, Hh, Mm, Mm, Mm, Mm, Mm, Mm, Mm, Mm, Mm, Mm^Vhh, Mm, Gs^Fp, Gs^Fp, Gs^Fp, Gs^Fp, Hh, Hh, Hh, Gg, Gg, Gg^Vh, Gg, Ce, Gg, Gg, Gg^Vh, Re, Gg^Vh, Gg^Vh, Gg
Gg, Gg, Co, Co, Re, Re, Co, Co, Co, Hh, Re, Co, Co, Gs^Fp, Gs^Fp, Mm, Mm, Mm, Mm, Mm, Mm, Mm, Gs^Fp, Gs^Fp, Gg^Ve, Gs^Fp, Gs^Fp, Gs^Fp, Gg, Gg, Gg, Gg, Gg, Ce, Ce, Ce, Re, Re, Gg^Vh, Re, Gg, Gg
Gg, Co, Co^Vo, Ko, Co, Co, Co, 3 Ko, Co, Co, Co, Co^Vo, Ko, Co, Gs^Fp, Gs^Fp, Gs^Fp, Mm, Mm, Mm, Mm, Hh, Gs^Fp, Gs^Fp, Gs^Fp, Gs^Fp, Gg, Gs^Fp, Gg, Gg, Gg, Gg^Vh, Re, Ce, 1 Ke, Ce, Gs^Fp, Gg, Ds, Gg, Ww, Ww
Gg, Co^Vo, Co^Vo, Co, Co, Co, Gg, Co^Vo, Gg, Co, Co, Co, Co^Vo, Co, Gs^Fp, Gs^Fp, Gs^Fp, Mm, Mm, Mm, Hh, Hh, Gg, Gg, Gg, Gg, Gg, Gg, Gg, Gg, Re, Re, Gg, Ce, Ce, Ce, Ww, Gs^Fp, Ww, Ww, Ww, Ww
Gg, Co^Vo, Co^Vo, Co, 6 Ko, Gg, Co, Co, Co, Gg, 5 Ko, Co, Re, Co, Gg, Gs^Fp, Gs^Fp, Hh, Hh, Hh, Hh, Gg, Gg, Gg^Vh, Gg, Gg, Re, Gg, Re, Re, Gg, Gg^Vh, Gs^Fp, Gs^Fp, Ww, Ww, Ww, Ww, Gs^Fp, Ds, Ds, Ds
Gg, Co^Vo, Co^Vo, Re, Ko, Co^Vo, Co, 2 Ko, Co, Co^Vo, Ko, Re, Re, Re, Gg, Gg, Re, Re, Re, Gg, Re, Gg, Re, Re, Re, Re, Gg^Vh, Re, Gg, Gg, Gg, Gg, Ds, Ds, Ww, Ww, Gs^Fp, Gg^Ve, Gs^Fp, Gs^Fp, Gs^Fp, Gs^Fp
Gg, Co^Vo, Co^Vo, Co, Co, Gg, Gg, Co, Gg, Gg, Co, Co, Co^Vo, Co, Re, Re, Ww, Ww, Ww, Re, Ww, Re, Ds, Gg, Gg, Gg, Gg, Gg, Ww, Ds, Ww, Ww, Ww, Ww, Ds, Gg^Ve, Gs^Fp, Gs^Fp, Gs^Fp, Gg^Ve, Ww, Ww
Gg, Co^Vo, Hh, Co, Co, Co, Co, Co^Vo, Co, Co, Co, Co, Ko, Co, Ww, Ww, Ww, Ww, Ww, Ww, Gs^Fp, Ww, Ww, Ds, Ww, Ds, Ww, Ds, Ww, Ww, Ww, Ww, Ww, Ww, Ww, Gs^Fp, Ww, Gg^Ve, Ww, Ww, Ww, Ww
Gg, Co, Co, Ko, Re, Co, Co, 4 Ko, Co, Co, Re, Co^Vo, Co, Co, Ww, Ww, Ww, Ds, Gs^Fp, Gs^Fp, Gs^Fp, Gs^Fp, Ww, Ww, Ww, Ww, Ds, Ww, Gll^Fp, Ww, Gll^Fp, Ww, Gg^Ve, Ds, Ds, Ww, Ds, Ww, Gll^Fp, Gll^Fp, Gll^Fp, Gll^Fp
Mm, Mm, Mm, Co, Co, Re, Co^Vo, Co, Co^Vo, Re, Co, Co, Ww, Ww, Ww, Ww, Gg, Gg, Gs^Fp, Gs^Fp, Gg^Ve, Ww, Ds, Ds, Ww, Ww, Gg^Ve, Gll^Fp, Gll^Fp, Gll^Fp, Gll^Fp, Gll^Fp, Gll^Fp, Gll^Fp, Gll^Fp, Gll^Fp, Gll^Fp, Gll^Fp, Gll^Fp, Gll^Fp, Hh, Hh
Mm, Mm, Mm, Mm, Mm, Co, Co, Co, Co, Co, Re, Re, Ww, Ww, Ww, Gg^Ve, Gs^Fp, Gs^Fp, Gs^Fp, Gs^Fp, Ww, Ww, Ww, Ww, Gll^Fp, Gll^Fp, Gll^Fp, Gll^Fp, Mm, Gg^Ve, Mm, Gll^Fp, Hh, Hh, Mm, Mm, Mm, Hh, Hh, Hh, Mm, Mm
Mm, Mm, Mm, Gll^Fp, Gll^Fp, Mm, Hh, Ko, Re, Re, Re, Re, Ww, Ww, Ds, Gs^Fp, Gs^Fp, Gs^Fp, Gs^Fp, Gs^Fp, Ww, Ww, Ds, Gll^Fp, Gll^Fp, Gll^Fp, Gll^Fp, Gll^Fp, Gll^Fp, Mm, Mm, Mm, Mm, Mm, Mm, Mm, Mm, Hh, Hh, Hh, Mm, Mm
Mm, Mm, Gll^Fp, Gll^Fp, Gg^Ve, Mm, Mm, Re, Re, Re, Re, Gg, Ww, Ww, Ds, Gs^Fp, Gs^Fp, Gg^Ve, Ds, Ww, Ww, Ds, Gg^Ve, Gll^Fp, Gll^Fp, Gll^Fp, Mm, Gll^Fp, Hh, Hh, Hh, Mm, Mm, Mm^Vhh, Mm, Mm, Mm, Mm, Mm, Mm, Mm, Mm
Mm, Mm, Gll^Fp, Gll^Fp, Gll^Fp, Gll^Fp, Gg, Gg, Re, Re, Gg^Vh, Gg, Gg, Ww, Ww, Gs^Fp, Ds, Ds, Ww, Ww, Ww, Ds, Gll^Fp, Gll^Fp, Gg^Ve, Mm, Mm, Hh, Hh, Hh, Hh, Mm, Mm, Mm, Mm, Mm, Mm, Mm, Mm, Mm, Mm, Mm
Mm, Mm, Gll^Fp, Gll^Fp, Gll^Fp, Gg, Gg, Gg^Vh, Re, Re, Gg, Gg, Gg, Gg, Gll^Fp, Ww, Ww, Ww, Ww, Ww, Ww, Gll^Fp, Gll^Fp, Gll^Fp, Mm, Mm, Mm, Mm^Vhh, Mm, Mm, Mm, Mm, Mm, Mm, Mm, Mm, Mm, Mm, Mm^Xm, Mm^Xm, Mm^Xm, Mm^Xm
Mm, Mm, Gll^Fp, Gll^Fp, Gg, Gg, Gg, Re, Gg, Gg, Gg, Gg, Gg^Ve, Gll^Fp, Gll^Fp, Ww, Gll^Fp, Ww, Ww, Ww, Gll^Fp, Gg^Ve, Gll^Fp, Gll^Fp, Mm, Mm, Mm, Mm, Mm, Mm, Mm, Mm, Mm, Mm, Mm, Mm, Mm, Mm, Mm^Xm, Mm^Xm, Mm^Xm, Mm^Xm
Mm, Mm, Hh, Gg^Ve, Gg, Gg, Gg, Re, Re, Gg, Gg, Gg, Gll^Fp, Gll^Fp, Ww, Ww, Gll^Fp, Gg, Ww, Ww, Gll^Fp, Gll^Fp, Gll^Fp, Gll^Fp, Hh, Hh, Hh, Mm, Mm, Mm, Mm, Mm, Mm, Mm, Mm, Mm, Mm, Mm, Mm^Xm, Mm^Xm, Mm^Xm, Mm^Xm
Mm, Mm, Mm, Hh, Hh, Gg, Gg, Gg, Gg, Re, Gg, Gll^Fp, Gll^Fp, Ww, Ww, Gll^Fp, Gg^Ve, Ds, Ww, Ww, Ww, Ds, Ds, Gll^Fp, Gll^Fp, Hh, Hh, Mm, Mm, Mm, Mm, Mm, Mm, Mm, Mm, Mm, Mm, Mm, Mm^Xm, Mm^Xm, Mm^Xm, Mm^Xm
Mm, Mm, Mm, Mm, Mm, Mm^Vhh, Mm, Mm, Gg, Re, Gg^Vh, Gg, Gg, Ww, Ww, Ds, Ww, Ww, Ds, Ww, Ww, Ww, Ds, Gg^Ve, Gll^Fp, Gll^Fp, Hh, Mm, Mm, Mm, Mm, Mm, Mm, Mm, Mm, Mm, Mm^Xm, Mm^Xm, Mm^Xm, Mm^Xm, Mm^Xm, Mm^Xm
Mm, Mm, Mm, Mm, Mm, Mm, Gll^Fp, Gg, Gg, Re, Gg, Gg, Gg, Ww, Ds, Ww, Gg, Ww, Gs^Fp, Gs^Fp, Ww, Ww, Gll^Fp, Gll^Fp, Gll^Fp, Gll^Fp, Mm, Mm^Vhh, Mm, Mm, Mm, Mm, Mm, Mm, Mm, Mm, Mm^Xm, Mm^Xm, Mm^Xm, Mm^Xm, Mm^Xm, Mm^Xm
Mm, Mm, Mm, Mm, Mm, Mm, Gll^Fp, Gll^Fp, Gg, Re, Re, Gg, Gg^Vh, Ww, Ww, Ww, Gs^Fp, Gg^Ve, Gs^Fp, Ww, Ds, Gg^Ve, Gll^Fp, Gll^Fp, Hh, Mm, Mm, Mm, Mm, Mm, Mm, Mm, Mm, Mm, Mm^Xm, Mm, Mm^Xm, Mm^Xm, Mm^Xm, Mm^Xm, Mm^Xm, Mm^Xm
Mm, Mm, Mm, Mm^Vhh, Gll^Fp, Gll^Fp, Gll^Fp, Gg, Gg^Vh, Gg, Re, Gg, Gg, Ww, Ww, Ww, Gs^Fp, Gs^Fp, Ww, Ww, Gll^Fp, Gll^Fp, Gll^Fp, Gg^Ve, Hh, Hh, Mm, Mm, Mm, Mm, Mm, Mm, Mm, Mm, Mm, Mm^Xm, Mm^Xm, Mm^Xm, Mm^Xm, Mm^Xm, Mm^Xm, Mm^Xm
Mm, Mm, Mm, Mm, Gll^Fp, Gll^Fp, Gll^Fp, Gg, Gg, Gg, Re, Gg, Gg, Ww, Ww, Ww, Gs^Fp, Gs^Fp, Ww, Ww, Gll^Fp, Gll^Fp, Gll^Fp, Gg, Hh, Hh, Mm, Mm, Mm, Mm, Mm, Mm, Mm, Mm, Mm, Mm^Xm, Mm^Xm, Mm^Xm, Mm^Xm, Mm^Xm, Mm^Xm, Mm^Xm
