Hh, Hh, Hh, Hh, Mm, Hh, Mm, Hh, Mm, Mm, Mm, Hh, Hh, Hh, Hh, Hh, Gll^Fp, Gll^Fp, Gll^Fp, Gll^Fp, Hh, Hh, Mm, Mm, Mm, Mm, Mm, Mm, Mm, Mm, Mm, Mm, Mm, Mm, Mm, Mm, Mm, Hh, Hh, Hh, Hh, Ds, Ds, Ww, Ww, Ww, Wo, Wo, Wo, Wo, Wo, Wo, Wo, Wo, Wo, Wo, Wo, Wo, Wo, Wo, Wo, Wo
Hh, Hh, Hh, Hh, Mm, Hh, Mm, Hh, Mm, Mm, Mm, Hh, Hh, Hh, Hh, Hh, Gll^Fp, Gll^Fp, Gll^Fp, Gll^Fp, Hh, Hh, Mm, Mm, Mm, Mm, Mm, Mm, Mm, Mm, Mm, Mm, Mm, Mm, Mm, Mm, Mm, Hh, Hh, Hh, Hh, Ds, Ds, Ww, Ww, Ww, Wo, Wo, Wo, Wo, Wo, Wo, Wo, Wo, Wo, Wo, Wo, Wo, Wo, Wo, Wo, Wo
Mm, Mm, Mm, Mm, Mm, Mm, Mm, Mm, Mm, Mm, Mm, Mm, Hh, Hh, Gll^Fp, Gll^Fp, Gll^Fp, Gll^Fp, Gll^Fp, Hh, Hh, Hh, Mm, Mm, Mm, Mm, Mm, Mm, Mm, Mm, Mm, Mm, Mm, Mm, Mm, Mm, Mm, Mm, Mm, Hh, Hh, Ds, Ds, Ww, Wo, Wo, Wo, Wo, Wo, Wo, Wo, Wo, Wo, Wo, Dd, Dd, Ww, Wo, Ww, Wo, Wo, Wo
Mm, Mm, Mm, Mm, Mm, Mm, Mm, Mm, Mm, Mm, Mm, Mm, Gll^Fp, Gll^Fp, Gll^Fp, Gll^Fp, Gll^Fp, Hh, Hh, Gll^Fp, Gll^Fp, Hh, Hh, Mm, Mm, Mm, Mm, Mm, Mm, Mm, Mm, Mm, Mm, Mm, Mm, Mm, Mm, Mm, Mm, Hh, Hh, Ds, Ww, Ww, Wo, Wo, Wo, Wo, Wo, Wo, Wo, Wo, Wo, Wo, Ww, Ww, Ds, Wo, Ww, Ww, Wo, Wo
Mm, Mm, Mm, Mm, Mm, Mm, Mm, Mm, Mm, Mm, Hh, Hh, Gll^Fp, Gll^Fp, Gll^Fp, Gll^Fp, Hh, Hh, Gll^Fp, Gll^Fp, Mm, Gll^Fp, Hh, Hh, Hh, Mm, Hh, Mm, Mm, Mm, Mm, Mm, Mm, Mm, Mm, Mm, Mm, Mm, Mm, Hh, Hh, Ds, Ww, Wo, Ww, Wo, Wo, Wo, Wo, Wo, Ww, Wo, Ww, Ww, Ds, Ds, Gg, Ds, Ds, Ww, Wo, Wo
Mm, Mm, Mm, Mm, Mm, Mm, Mm, Mm, Mm, Hh, Hh, Hh, Gll, Gll^Fp, Hh, Hh, Mm, Mm, Mm, Mm, Mm, Gll^Fp, Mm, Mm, Mm, Hh, Hh, Hh, Hh, Hh, Hh, Mm, Mm, Mm, Hh, Mm, Mm, Mm, Hh, Hh, Hh, Ds, Ds, Ww, Ww, Ww, Ww, Wo, Ww, Ww, Ds, Ww, Ww, Ww, Ds, Gg, Ds, Ds, Ds, Ww, Wo, Wo
Mm, Mm, Mm, Mm, Mm, Mm, Mm, Mm, Hh, Hh, Gll^Fp, Gll, Gg, Hh, Hh, Mm, Mm, Mm, Mm, Mm, Mm, Mm, Mm, Mm, Mm, Hh, Hh^Vhh, Hh, Hh, Hh^Vhh, Hh, Hh, Hh, Hh, Hh, Hh, Hh, Hh, Hh, Hh, Gs^Fp, Ds, Gs^Fp, Ds, Ds, Ww, Wo, Wo, Ww, Ds, Ds, Ds, Ds, Ds, Gg, Gg, Ds, Ww, Ww, Ww, Wo, Wo
Mm, Mm, Mm, Mm, Mm, Mm, Mm, Hh, Hh, Gll^Fp, Gll^Fp, Gg, Gg, Gg, Hh, Mm, Mm, Mm, Mm, Mm, Mm, Mm, Mm, Mm, Mm, Mm, Mm, Hh, Hh^Vhh, Gs^Fp, Gg, Gg^Vh, Gg, Hh, Gg, Hh, Gg, Hh, Gs^Fp, Gs^Fp, Gs^Fp, Gs^Fp, Gg, Gg, Ds, Ww, Wo, Wo, Ww, Ww, Ds, Gg, Gg^Efm, Gg, Gg, Gg, Ds, Ds, Ww, Wo, Wo, Wo
Mm, Mm, Mm, Mm, Mm, Mm, Hh, Hh, Gll^Fp, Gll^Fp, Gll, Gg, Gg^Efm, Gg^Efm, Hh, Hh, Hh, Mm, Mm, Mm, Mm, Mm, Mm, Mm, Mm, Mm, Mm, Hh, Gll^Fp, Gs^Fp, Gg, Gg^Vh, Gg, Gg^Vh, Gg, Ce, Gg, Gg, Re, Gg, Gg, Gg, Gg, Gg, Ds, Ww, Wo, Wo, Ww, Ds, Ds, Gg, Gg^Efm, Gg^Efm, Ds, Ds, Ww, Ww, Ds, Ww, Ww, Ww
Mm, Mm, Mm, Mm, Hh, Hh, Hh, Hh, Gll^Fp, Gll^Fp, Gll, Gg, Gg^Efm, Gll^Fp, Gll^Fp, Hh, Hh, Mm, Mm, Mm, Mm, Mm, Mm, Mm, Mm, Mm, Mm, Gll^Fp, Gll, Gg^Vh, Gg, Gg, Gg, Gg^Vh, Gg^Vh, Ce, Gg, Re^Gvs, Re^Gvs, Re^Gvs, Re, Re, Gg, Gg, Ds, Ww, Ww, Wo, Wo, Ww, Ds, Gg, Ds, Ds, Ww, Ww, Ds, Ds, Gg, Ds, Ds, Ds
Hh, Hh, Hh, Hh, Hh, Hh, Hh, Gll^Fp, Gll^Fp, Gll, Gg, Gg^Efm, Gll^Fp, Gll^Fp, Gll^Fp, Gll^Fp, Hh, Hh, Mm, Mm, Mm, Mm, Mm, Mm, Mm, Mm, Gg, Gg^Vh, Ce, Gg^Vh, Ce, Gg^Vh, Ce, Gg, Gg, Ce, Gg, Re^Gvs, Re^Gvs, Re^Gvs, Re^Gvs, Re, Re^Gvs, Gg, Gg, Ds, Ds, Ww, Ww, Ww, Ds, Gg, Ds, Ww, Ds, Ds, Gg, Gg, Gg, Gg, Gg, Gg
Hh, Hh, Hh, Hh, Hh, Hh, Hh, Hh, Gg, Gg, Gg, Gg^Efm, Gg, Gll^Fp, Hh, Gll^Fp, Hh, Hh, Hh, Mm, Mm, Mm, Mm, Mm, Ce, Gg^Vh, Gg, Gg^Vh, Ce, Ce, 7 Ke, Ce, Ce, Gg, Gg^Vh, Ce, Gg, Re, Re^Gvs, Re^Gvs, Re^Gvs, Re^Gvs, Re^Gvs, Gg, Re^Gvs, Gg, Gg, Ds, Ds, Ds, Gg, Ds, Ww, Ww, Ds, Gg, Re^Gvs, Gg, Re, Gg, Gg, Gg
Hh, Hh, Hh, Hh, Hh, Hh, Hh, Hh, Hh, Gg, Gg, Gg^Efm, Gg^Efm, Gll^Fp, Hh, Hh, Hh, Hh, Hh, Hh, Hh, Hh, Hh, Hh, Ce, Gg, Gg^Vh, Gg, Ce, Ce, Ce, Ce, Ce, Gg, Gg, Ce, Gg, Re, Re, Re^Gvs, Re^Gvs, Re^Gvs, Rd, Re^Gvs, Re^Gvs, Gg, Rd, Gg, Gg, Gg, Gg, Ww, Re^Gvs, Ds, Re^Gvs, Re^Gvs, Re^Gvs, Gg, Re, Gg, Gg, Gg
Hh, Hh, Mm, Mm, Mm, Hh, Hh, Hh, Hh, Gg, Gg, Gg, Gg, Gg, Gg, Hh, Hh, Hh, Hh, Hh, Hh, Hh, Hh, Hh, Ce, Gg, Gg^Vh, Gs^Fp, Gg, Gg^Vh, Gg, Gg^Vh, Gg, Gg^Vh, Gg, Ce, Gg, Gg, Re^Gvs, Re^Gvs, Re^Gvs, Rd, Re^Gvs, Rd, Rd, Rd, Gg, Rd, Rd, Gg, Ww, Ww, Re^Gvs, Re^Gvs, Re^Gvs, Re^Gvs, Re, Re, Re, Gg, Gg, Gg
Hh, Hh, Mm, Mm, Mm, Mm, Mm, Mm, Mm, Hh, Hh, Gg^Efm, Gg, Gs^Fp, Gg, Re^Gvs, Re^Gvs, Re^Gvs, Re, Re, Re^Gvs, Hh, Re, Re, Gll^Fp, Ce, Ce, Ce, Ce, Gg, Gs^Fp, Gg, Ce, Ce, Ce, Ce, Gg, Re^Gvs, Re, Re^Gvs, Rd, Rd, Gll^Fp, Gll^Fp, Gll^Fp, Gll^Fp, Ww, Gg^Efm, Ww, Ww^Bw\, Rd, Rd, Rd, Re, Re, Re, Re^Gvs, Re, Re^Gvs, Gg, Gg, Gg
Mm, Mm, Mm, Mm, Mm, Mm, Mm, Mm, Mm, Mm, Hh, Gg, Gg, Gg, Re^Gvs, Re^Gvs, Re^Gvs, Re^Gvs, Re^Gvs, Gg, Re, Re^Gvs, Re^Gvs, Gll^Fp, Re, Re, Re, Re^Gvs, Re^Gvs, Hh, Hh, Hh, Gs^Fp, Gs^Fp, Hh, Gg, Hh, Gg, Re, Re^Gvs, Rd, Gg^Efm, Gll^Fp, Gll^Fp, Ww, Ww, Gg, Ww, Re^Gvs, Rd, Re^Gvs, Re^Gvs, Re^Gvs, Re^Gvs, Re^Gvs, Re^Gvs, Re^Gvs, Re^Gvs, Gg, Gg^Efm, Gg, Gg
Mm^Xm, Mm^Xm, Mm^Xm, Mm^Xm, Mm^Xm, Mm, Mm, Mm, Mm, Mm, Hh, Hh, Re^Gvs, Re^Gvs, Gg, Re^Gvs, Gs^Fp, Re^Gvs, Re^Gvs, Gg, Rd, Re^Gvs, Gg, Re^Gvs, Gg, Gg, Re^Gvs, Re^Gvs, Re^Gvs, Re^Gvs, Re, Hh, Hh, Hh, Hh, Hh, Hh, Hh, Gg, Rd, Gg, Gg^Efm, Ww, Ww, Gs^Fp, Gs^Fp, Re^Gvs, Re^Gvs, Re^Gvs, Rd, Re^Gvs, Re^Gvs, Re^Gvs, Re^Gvs, Re^Gvs, Re^Gvs, Re^Gvs, Re, Re^Gvs, Gg, Gg, Gg
Mm^Xm, Mm^Xm, Mm^Xm, Mm^Xm, Mm, Mm, Mm, Mm, Mm, Mm, Hh, Gg, Gg, Re^Gvs, Re^Gvs, Gg, Re^Gvs, Re^Gvs, Rd, Rd, Hh, Rd, Rd, Rd, Rd, Gg, Rd, Gg, Rd, Re^Gvs, Re, Hh, Hh, Hh, Hh, Hh, Hh, Hh, Gs^Fp, Rd, Gg, Gg^Efm, Ww, Ww, Gs^Fp, Gg, Re^Gvs, Re^Gvs, Re^Gvs, Rd, Re^Gvs, Re^Gvs, Re^Gvs, Re^Gvs, Re^Gvs, Re^Gvs, Re^Gvs, Re^Gvs, Re^Gvs, Gg, Gg, Gg
Mm^Xm, Mm^Xm, Mm, Mm, Mm, Mm, Mm, Mm, Mm, Hh, Hh, Gg, Gg^Efm, Re, Re, Re^Gvs, Re, Re^Gvs, Rd, Gg^Efm, Gs^Fp, Hh, Rd, Re^Gvs, Re^Gvs, Rd, Re^Gvs, Rd, Re^Gvs, Rd, Rd, Re, Rd, Gs^Fp, Gs^Fp, Hh, Hh, Hh, Rd, Rd, Gg, Gg^Efm, Ww, Gs^Fp, Gg^Efm, Gg^Efm, Re^Gvs, Re^Gvs, Re^Gvs, Rd, Re, Re^Gvs, Re^Gvs, Re^Gvs, Re^Gvs, Re^Gvs, Re^Gvs, Re^Gvs, Re^Gvs, Gg, Gg, Gg
Mm^Xm, Mm^Xm, Mm, Mm, Mm, Mm, Mm, Mm, Mm, Hh, Gll^Fp, Gll^Fp, Gg^Efm, Re^Gvs, Gg, Re, Re^Gvs, Rd, Gg^Efm, Gg^Efm, Gs^Fp, Gg, Rd, Re^Gvs, Re^Gvs, Re^Gvs, Re, Re, Re^Gvs, Re^Gvs, Rd, Rd, Re^Gvs, Rd, Rd, Rd, Rd, Rd, Gg, Gg, Gg, Gg^Efm, Ww, Ww, Re^Gvs, Re^Gvs, Re, Gg, Gg, Rd, Re^Gvs, Re^Gvs, Re^Gvs, Re^Gvs, Re^Gvs, Re^Gvs, Re^Gvs, Re, Gg, Gg, Gg, Gg
Mm, Mm, Mm, Mm, Mm, Mm, Mm, Mm, Hh, Hh, Gg^Efm, Gg^Efm, Re^Gvs, Re^Gvs, Re^Gvs, Re^Gvs, Rd, Rd, Hh, Hh, Hh, Rd, Re, Re^Gvs, Re^Gvs, Re^Gvs, Re, Re^Gvs, Re^Gvs, Re^Gvs, Rd, Re^Gvs, Re^Gvs, Re^Gvs, Re^Gvs, Re^Gvs, Re, Re, Re, Gg, Ww, Ww, Re^Gvs, Re^Gvs, Re^Gvs, Re^Gvs, Re, Re^Gvs, Re^Gvs, Rd, Gg, Re, Gg, Gg^Efm, Re, Re, Gg, Gg, Hh, Gg, Gg, Gg
Mm, Mm, Mm, Mm, Mm, Mm, Mm, Hh, Gg, Gg, Gg, Re^Gvs, Re^Gvs, Re^Gvs, Re^Gvs, Re^Gvs, Rd, Re^Gvs, Rd, Gs^Fp, Hh, Rd, Gg, Re^Gvs, Gg^Efm, Re, Ww, Re^Gvs, Ww, Re^Gvs, Rd, Re^Gvs, Ww, Re^Gvs, Ww, Re^Gvs, Ww, Gg^Efm, Ww, Ww^Bw\, Re, Re^Gvs, Re^Gvs, Gg^Efm, Re^Gvs, Re, Re^Gvs, Re^Gvs, Re^Gvs, Rd, Gg, Gg^Efm, Hh, Gg, Hh, Hh, Hh, Hh, Gg, Gg, Gg, Gg
Mm, Mm, Mm, Mm, Mm, Mm, Mm, Hh, Hh, Gg, Gg, Re^Gvs, Gg, Re^Gvs, Re^Gvs, Re^Gvs, Rd, Rd, Re^Gvs, Rd, Rd, Rd, Gg^Efm, Gg, Ww, Ww, Co, Ww, Co, Ww, Ww^Bw|, Ww, Co, Ww, Co, Ww, Ww, Ww, Ww, Gg^Efm, Re, Re^Gvs, Re, Re^Gvs, Re^Gvs, Re^Gvs, Re^Gvs, Re^Gvs, Re^Gvs, Rd, Re, Hh, Hh, Hh, Hh, Hh, Mm, Mm, Gg, Gg, Gg^Efm, Gg^Efm
Mm, Mm, Mm, Mm, Mm, Mm, Mm, Mm, Hh, Gg, Gg, Gg, Gg, Re^Gvs, Rd, Rd, Gg, Re^Gvs, Re^Gvs, Re^Gvs, Re^Gvs, Gg^Efm, Ww, Ww, Co, Co, Mm, Co, Mm, Co, Rd, Co, Mm, Co, Mm, Co, Co, Ww, Ww, Gg^Efm, Re^Gvs, Re, Re^Gvs, Re, Re^Gvs, Re^Gvs, Re^Gvs, Re^Gvs, Re^Gvs, Rd, Re, Gg^Efm, Gg^Efm, Hh, Mm, Mm, Mm, Mm, Gg, Gg, Gg^Efm, Gg^Efm
Mm^Xm, Mm^Xm, Mm^Xm, Mm, Mm, Mm, Mm, Mm, Mm, Hh, Mm, Gg, Gg, Rd, Re^Gvs, Re^Gvs, Re^Gvs, Re^Gvs, Re^Gvs, Re^Gvs, Ww, Ww, Co, Co, Mm, Mm, Mm, Mm, Mm, Mm, Rd, Mm, Mm, Mm, Mm, Mm, Mm, Co, Co, Ww, Ww, Re^Gvs, Re^Gvs, Re, Re^Gvs, Re^Gvs, Rd, Re^Gvs, Rd, Rd, Re, Gg^Efm, Hh, Hh, Hh, Mm, Gg, Gg, Gg, Gg^Efm, Gg, Gg
Mm^Xm, Mm^Xm, Mm^Xm, Mm^Xm, Mm, Mm, Mm, Mm, Mm, Mm, Mm, Mm, Hh, Rd, Rd, Re^Gvs, Gg, Re^Gvs, Re^Gvs, Ww, Co, Co, Mm, Mm, Mm, Mm, Co, Mm, Mm^Vo, Mm, Rd, Mm, Mm^Vo, Mm, Co, Mm, Mm, Mm, Mm, Co, Co, Ww, Gg, Re, Rd, Rd, Re^Gvs, Rd, Gg, Gg, Gg, Re, Hh, Hh, Gg, Gg, Gg, Gg, Gg, Gg, Gg, Gg
Mm^Xm, Mm^Xm, Mm^Xm, Mm^Xm, Mm, Mm, Mm, Mm, Mm, Mm, Mm, Mm, Mm, Hh, Gg, Rd, Gs^Fp, Re^Gvs, Gg, Ww, Co, Mm, Mm, Mm, Co, Co, Co, Mm^Vo, Mm^Vo, Mm, Rd, Mm, Mm^Vo, Mm^Vo, Co, Co, Co, Mm, Mm, Mm, Co, Ww, Gg^Efm, Rd, Re^Gvs, Gg, Re^Gvs, Re^Gvs, Re^Gvs, Re^Gvs, Re, Re, Re, Gg, Ce, Ce, Ce, Ce, Ce, Ce, Ce, Ce
Mm^Xm, Mm^Xm, Hh, Mm, Mm, Mm, Mm, Mm, Mm, Mm, Mm^Vhh, Mm, Mm^Vhh, Hh, Gg, Rd, Re^Gvs, Gg, Gg, Ww, Co, Mm, Mm, Co, Co, 5 Ko, Co, Co, Mm^Vo, Mm^Vo, Rd, Mm^Vo, Mm^Vo, Co, Co, 4 Ko, Co, Co, Mm, Mm, Co, Ww, Gg^Efm, Rd, Re^Gvs, Re^Gvs, Gg^Efm, Re^Gvs, Re^Gvs, Re^Gvs, Re^Gvs, Gg, Ce, Ce, Gg^Vh, Gg, Gg^Vh, Gg, Gg^Vh, Gg, Gg^Vh, Gg
Hh, Hh, Hh, Mm, Mm, Mm, Mm, Mm^Vhh, Mm, Mm^Vhh, Mm, Mm, Mm, Mm, Gg, Rd, Re^Gvs, Re^Gvs, Re^Gvs, Ww, Co, Mm, Mm, Mm^Vo, Co, Co, Mm^Vo, Mm^Vo, Rd, Rd, Rd, Rd, Rd, Mm^Vo, Mm^Vo, Co, Co, Mm^Vo, Mm, Mm, Co, Ww, Gg, Rd, Re^Gvs, Re^Gvs, Re^Gvs, Re^Gvs, Re^Gvs, Re^Gvs, Gg, Gg, Ce, Gg, Gg, Gg, Gg, Gg, Gg^Vh, Gg, Gg^Vh, Gg
Hh, Hh, Hh, Mm, Mm, Mm, Mm, Mm, Mm^Vhh, Mm, Mm, Mm^Vhh, Mm, Mm, Ce, Rd, Re^Gvs, Re^Gvs, Rd, Ww, Co, Mm, Mm, Mm^Vo, Mm, Mm^Vo, Mm^Vo, Rd, Mm^Vo, Co, Co, Co, Mm^Vo, Rd, Mm^Vo, Mm^Vo, Mm, Mm^Vo, Mm, Mm, Co, Ww, Rd, Rd, Re, Re^Gvs, Re^Gvs, Re^Gvs, Re, Gg, Re, Gg, Ce, Gg^Vh, Gg, Ce, Ce, Ce, Gg^Efm, Gg, Gg, Gg
Hh, Hh, Hh, Hh, Hh, Mm, Mm, Mm^Vhh, Hh^Vhh, Mm, Ce, Mm, Ce, Gg, Ce, Rd, Re^Gvs, Re, Rd, Ww^Bw\, Rd, Rd, Rd, Rd, Rd, Rd, Rd, Rd, Rd, Co, 2 Ko, Co, Rd, Rd, Rd, Rd, Rd, Rd, Rd, Rd, Rd, Ww^Bw/, Re, Re, Re, Re, Re, Re, Re^Gvs, Re, Re^Gvs, Re, Rd, Gg, Gg, Ce, 1 Ke, Ce, Gg^Efm, Gg^Vh, Gg, Gg
Re, Re, Re, Re, Re, Re, Re, Re, Re, Hh, Ce, Ce, Ce, Gg, Ce, Rd, Rd, Rd, Rd, Ww^Bw/, Co, Rd, Mm, Rd, Mm, Rd, Mm^Vo, Rd, Mm^Vo, Co, Co, Co, Mm^Vo, Rd, Mm^Vo, Rd, Mm, Rd, Mm, Rd, Co, Ww^Bw\, Rd, Re, Re^Gvs, Re^Gvs, Re^Gvs, Gg^Efm, Re^Gvs, Re^Gvs, Re^Gvs, Rd, Ce, Gg, Gg, Ce, Ce, Ce, Gg^Vh, Gg, Gg^Vh, Gg
Hh, Hh, Mm, Hh, Mm, Hh, Mm, Hh^Vhh, Hh, Re, Ce, 8 Ke, Ce, Re, Re, Re, Rd, Re^Gvs, Re^Gvs, Ww, Co, Mm, Mm, Mm^Vo, Co, Mm^Vo, Mm^Vo, Rd, Rd, Co, Rd, Co, Rd, Rd, Mm^Vo, Mm^Vo, Co, Mm^Vo, Mm, Mm, Co, Ww, Gg^Efm, Rd, Re^Gvs, Re^Gvs, Re^Gvs, Re^Gvs, Re^Gvs, Re^Gvs, Rd, Rd, Ce, Gg, Gg, Ce, Gg^Vh, Ce, Gg, Gg, Gg, Gg
Mm, Mm, Mm, Mm, Mm, Mm, Mm, Mm^Vhh, Mm, Hh^Vhh, Ce, Ce, Ce, Gg, Ce, Re^Gvs, Re^Gvs, Rd, Re^Gvs, Ww, Co, Mm, Mm, Mm^Vo, Co, Co, Co, Mm^Vo, Mm^Vo, Rd, Rd, Rd, Mm^Vo, Mm^Vo, Co, Co, Co, Mm^Vo, Mm, Mm, Co, Ww, Gg^Efm, Rd, Re^Gvs, Re^Gvs, Re^Gvs, Re^Gvs, Re^Gvs, Rd, Re^Gvs, Re^Gvs, Ce, Gg^Vh, Gg, Gg, Gg, Gg, Gg, Gg^Vh, Gg, Gg
Mm, Mm, Mm, Mm, Mm, Mm, Mm, Mm, Mm^Vhh, Hh, Hh^Vhh, Gll^Fp, Gll^Fp, Gll^Fp, Ce, Re^Gvs, Re^Gvs, Rd, Rd, Ww, Co, Mm, Mm, Co, Co, 6 Ko, Co, Co, Mm^Vo, Mm^Vo, Rd, Mm^Vo, Mm^Vo, Co, Co, 3 Ko, Co, Co, Mm, Mm, Co, Ww, Gg, Rd, Rd, Re^Gvs, Re^Gvs, Re^Gvs, Gg^Efm, Rd, Re^Gvs, Re^Gvs, Gg, Ce, Ce, Gg^Vh, Ce, Gg^Vh, Ce, Gg^Vh, Ce, Ce
Mm, Mm, Mm^Xm, Mm, Mm, Mm, Mm, Mm^Vhh, Mm^Vhh, Mm, Mm, Mm, Mm, Hh, Ce, Re^Gvs, Re^Gvs, Rd, Re^Gvs, Ww, Co, Mm, Mm, Mm, Mm, Co, Co, Mm^Vo, Mm^Vo, Mm, Rd, Mm^Vo, Mm, Mm, Co, Co, Mm, Mm, Mm, Mm, Co, Ww, Re^Gvs, Re^Gvs, Gg, Rd, Rd, Re^Gvs, Re^Gvs, Rd, Re, Re, Re, Gg, Gg, Ce, Re, Ce, Re^Gvs, Ce, Re^Gvs, Re^Gvs
Mm^Xm, Mm^Xm, Mm^Xm, Mm^Xm, Mm, Mm, Mm, Mm, Mm, Mm, Mm^Vhh, Mm^Vhh, Mm, Hh, Gg, Re^Gvs, Re^Gvs, Rd, Re, Ww, Ww, Co, Co, Mm, Mm, Mm, Mm, Mm, Mm, Mm, Rd, Mm, Mm, Mm, Mm, Mm, Mm, Mm, Co, Co, Ww, Ww, Re^Gvs, Re^Gvs, Re^Gvs, Re^Gvs, Re, Rd, Rd, Rd, Re^Gvs, Re^Gvs, Re^Gvs, Re, Re, Re, Re^Gvs, Re^Gvs, Re^Gvs, Re^Gvs, Re^Gvs, Re^Gvs
Mm^Xm, Mm^Xm, Mm^Xm, Mm^Xm, Mm, Mm, Mm, Mm, Mm, Mm, Mm, Mm, Mm, Hh, Hh, Re^Gvs, Rd, Rd, Gg, Re, Gg, Ww, Ww, Co, Co, Mm, Mm, Mm, Mm, Mm, Rd, Mm, Mm, Mm, Mm, Mm, Co, Co, Ww, Ww, Gg^Efm, Re^Gvs, Re, Re^Gvs, Re^Gvs, Re^Gvs, Re^Gvs, Rd, Gg^Efm, Re^Gvs, Re^Gvs, Re^Gvs, Gg^Efm, Re^Gvs, Re^Gvs, Re, Re, Re^Gvs, Re^Gvs, Re^Gvs, Re^Gvs, Re^Gvs
Mm^Xm, Mm^Xm, Mm^Xm, Mm^Xm, Mm, Mm, Mm, Mm, Mm, Mm, Hh, Mm, Hh, Hh, Rd, Rd, Re^Gvs, Gg, Re^Gvs, Gg, Re^Gvs, Re^Gvs, Ww, Ww, Ww, Co, Co, Mm, Co, Mm, Rd, Mm, Co, Mm, Co, Co, Ww, Ww, Re^Gvs, Re^Gvs, Re, Gg^Efm, Re^Gvs, Re^Gvs, Re^Gvs, Re^Gvs, Rd, Rd, Re^Gvs, Re^Gvs, Gg^Efm, Re^Gvs, Gg^Efm, Re^Gvs, Gg, Gg, Re, Re, Re^Gvs, Re^Gvs, Re^Gvs, Re^Gvs
Mm^Xm, Mm^Xm, Mm^Xm, Mm^Xm, Mm, Mm, Mm, Mm, Mm, Mm, Hh, Hh, Gs^Fp, Gg, Rd, Re^Gvs, Hh, Re^Gvs, Re^Gvs, Re^Gvs, Re^Gvs, Re^Gvs, Ww, Ww, Re^Gvs, Ww, Ww, Co, Ww, Co, Ww^Bw|, Co, Ww, Co, Ww, Ww, Rd, Re^Gvs, Rd, Rd, Rd, Re, Rd, Re^Gvs, Rd, Rd, Gg, Re, Re, Re^Gvs, Re^Gvs, Re^Gvs, Re^Gvs, Gg, Re^Gvs, Re^Gvs, Re, Re^Gvs, Re, Re^Gvs, Re^Gvs, Re^Gvs
Mm^Xm, Mm^Xm, Mm^Xm, Mm^Xm, Mm, Mm, Mm, Mm, Mm, Hh, Hh, Hh, Gs^Fp, Gg, Rd, Re^Gvs, Re^Gvs, Re^Gvs, Ww, Ww, Ww, Ww, Re^Gvs, Re^Gvs, Re, Gg, Gg, Ww, Re^Gvs, Ww, Rd, Ww, Re^Gvs, Ww, Re^Gvs, Rd, Re^Gvs, Rd, Re^Gvs, Re^Gvs, Re^Gvs, Rd, Re^Gvs, Rd, Re^Gvs, Re, Re^Gvs, Re^Gvs, Re^Gvs, Re, Re, Gg, Re^Gvs, Re^Gvs, Re^Gvs, Re^Gvs, Re, Gg, Gg^Efm, Re, Re, Re
Mm^Xm, Mm^Xm, Mm, Mm, Mm, Mm, Mm, Mm, Mm, Mm, Mm, Gg, Gg, Gg, Rd, Re^Gvs, Re^Gvs, Re^Gvs, Ww, Gg, Re^Gvs, Re^Gvs, Re^Gvs, Re^Gvs, Re, Re^Gvs, Re^Gvs, Re^Gvs, Re^Gvs, Re^Gvs, Rd, Re^Gvs, Re^Gvs, Re^Gvs, Re, Re, Re^Gvs, Re^Gvs, Gll^Fp, Re^Gvs, Gll^Fp, Gg, Re^Gvs, Re^Gvs, Re^Gvs, Re, Re^Gvs, Re^Gvs, Re^Gvs, Re^Gvs, Re^Gvs, Re, Re, Re^Gvs, Re, Re^Gvs, Gg, Gg, Gg, Gg, Gg, Gg
Mm, Mm, Mm, Mm, Mm, Mm, Mm, Mm, Hh, Mm, Re^Gvs, Gg, Re^Gvs, Gg, Re, Rd, Rd, Ww, Ww, Re, Re^Gvs, Re^Gvs, Re^Gvs, Re^Gvs, Re, Re^Gvs, Re^Gvs, Re^Gvs, Re^Gvs, Re^Gvs, Rd, Re^Gvs, Re^Gvs, Rd, Re^Gvs, Re^Gvs, Re^Gvs, Re^Gvs, Gll^Fp, Gll^Fp, Gll^Fp, Gll^Fp, Gg, Re^Gvs, Re^Gvs, Re, Re^Gvs, Re^Gvs, Re^Gvs, Re^Gvs, Re^Gvs, Gg, Gg, Re, Gg, Gg, Gg, Gg, Gg, Gg, Gg, Gg
Mm, Mm, Mm, Mm, Hh, Hh, Hh, Hh, Hh, Re^Gvs, Re^Gvs, Re^Gvs, Re, Re, Gg, Gg, Gg, Ww^Bw\, Rd, Re^Gvs, Re^Gvs, Re, Rd, Re^Gvs, Gg, Re^Gvs, Re, Re^Gvs, Re^Gvs, Re, Rd, Re^Gvs, Re^Gvs, Rd, Gll^Fp, Gll^Fp, Gll^Fp, Gll^Fp, Gll^Fp, Gll^Fp, Gll^Fp, Gll^Fp, Gg, Gg^Efm, Re^Gvs, Re, Re, Gg, Re^Gvs, Re^Gvs, Re^Gvs, Gg, Gg, Gg, Gll^Fp, Gg, Gll^Fp, Gll^Fp, Gll^Fp, Gg, Gg, Gg
Mm, Mm, Mm, Hh, Hh, Hh, Gs^Fp, Gs^Fp, Re^Gvs, Re^Gvs, Re^Gvs, Re, Gll^Fp, Gs^Fp, Gs^Fp, Gs^Fp, Ww, Ww, Re, Rd, Rd, Rd, Re^Gvs, Rd, Rd, Rd, Rd, Re, Rd, Rd, Re, Re^Gvs, Rd, Rd, Gg, Gll^Fp, Gll^Fp, Gg^Fet, Gll^Fp, Gg^Fet, Gll^Fp, Gll^Fp, Gll^Fp, Gg, Gll, Gg^Efm, Gg, Gg, Gg, Gg, Gll^Fp, Gg, Gll^Fp, Gll^Fp, Gll^Fp, Gll^Fp, Hh, Gll^Fp, Hh, Gll^Fp, Gg, Gg
Mm, Mm, Mm, Mm, Mm, Hh, Hh, Gs^Fp, Re^Gvs, Re^Gvs, Re, Gll, Gll^Fp, Gg^Fet, Ww, Ww, Gll^Fp, Gll^Fp, Gg, Re, Gg, Re^Gvs, Gll^Fp, Gll^Fp, Gll^Fp, Gll^Fp, Gll^Fp, Rd, Gll^Fp, Gll^Fp, Gll^Fp, Re, Gg^Efm, Gg^Efm, Gg, Gg, Gll^Fp, Gll^Fp, Gll^Fp, Gll^Fp, Gll^Fp, Gll^Fp, Gll^Fp, Gll^Fp, Gg, Gg, Gg, Gg, Gll, Gg, Gll^Fp, Gll^Fp, Gll^Fp, Hh, Hh, Hh, Hh, Gll^Fp, Hh, Hh, Gg, Gg
Mm, Mm, Mm, Mm, Mm, Hh, Hh, Hh, Hh, Re^Gvs, Re^Gvs, Re, Ww, Ww, Gll^Fp, Gll^Fp, Gg^Fet, Gll^Fp, Gll, Gll, Gll^Fp, Gll^Fp, Gll^Fp, Gll^Fp, Hh, Hh, Hh, Gll^Fp, Gll^Fp, Gll^Fp, Gll^Fp, Gg, Gg, Gg, Gll^Fp, Gll^Fp, Gll^Fp, Gll^Fp, Gll^Fp, Gll^Fp, Gll^Fp, Gll^Fp, Gll^Fp, Gll^Fp, Gll, Gg, Gll, Gll, Gg, Gll^Fp, Gll^Fp, Hh, Hh, Hh, Hh, Hh, Hh, Hh, Hh, Gg, Gg, Gg
Mm, Mm, Ww, Mm, Mm, Mm, Mm, Mm, Mm, Hh, Re^Gvs, Re^Gvs, Ww, Gll^Fp, Gg, Gll^Fp, Gll^Fp, Gll^Fp, Gg, Gll^Fp, Gll, Gg^Fet, Hh, Hh, Hh, Hh, Hh, Hh, Hh, Gll^Fp, Gll^Fp, Gll^Fp, Gll^Fp, Gg^Efm, Gg^Efm, Gll^Fp, Gll^Fp, Gg^Fet, Gll^Fp, Gll^Fp, Gll^Fp, Gg^Fet, Gll^Fp, Gll^Fp, Gg, Gll, Gll, Gg, Gll^Fp, Gll^Fp, Gll^Fp, Hh, Gll^Fp, Hh, Gll^Fp, Gll^Fp, Hh, Hh, Gll^Fp, Gll^Fp, Gll^Fp, Gll^Fp
Ww, Ww, Mm, Ww, Mm, Mm, Mm, Mm, Mm, Mm, Gg, Gg, Ww, Gg, Gg^Efm, Gg^Efm, Gll^Fp, Gg, Gg, Gll^Fp, Gll^Fp, Gll^Fp, Gll^Fp, Gll^Fp, Hh, Hh, Hh, Hh, Hh, Gll^Fp, Gg^Fet, Gll^Fp, Gll^Fp, Gll^Fp, Gg^Efm, Gll^Fp, Gll^Fp, Gll^Fp, Gg^Efm, Gg, Gll^Fp, Gll^Fp, Gll^Fp, Gll, Gll, Gg, Gll, Gg, Gll, Gll^Fp, Gll^Fp, Gll^Fp, Gll^Fp, Gll^Fp, Gll^Fp, Gll^Fp, Hh, Gg, Gll^Fp, Gll^Fp, Gg, Gg
Mm, Mm, Mm, Ww, Mm, Mm, Mm, Mm, Mm, Mm, Hh, Hh, Ww, Gg^Efm, Gll, Gll, Gll^Fp, Gll^Fp, Gll^Fp, Gll^Fp, Gll^Fp, Gll^Fp, Gg^Fet, Gll^Fp, Gll^Fp, Hh, Gll^Fp, Hh, Hh, Gll^Fp, Gll^Fp, Gll^Fp, Gg^Fet, Gll^Fp, Gll^Fp, Gg^Efm, Gg^Efm, Gg^Efm, Gll^Fp, Gg^Efm, Gg^Efm, Gll^Fp, Gg, Gll^Fp, Gll^Fp, Gll^Fp, Gll^Fp, Gll, Gll, Gll^Fp, Gll^Fp, Gll^Fp, Gll^Fp, Gll^Fp, Gll^Fp, Gll^Fp, Gll^Fp, Gll^Fp, Gll^Fp, Gg, Gg, Gg
Mm, Mm, Mm, Ww, Ww, Mm, Mm, Mm, Mm, Mm, Ww, Ww, Gg^Efm, Gg^Efm, Gll^Fp, Gll^Fp, Gll^Fp, Gll^Fp, Gll^Fp, Gg^Fet, Gll^Fp, Gll^Fp, Gll^Fp, Gll^Fp, Gll^Fp, Gll^Fp, Gll^Fp, Gll^Fp, Gll^Fp, Gll^Fp, Gll^Fp, Gll^Fp, Gll^Fp, Gll^Fp, Gll^Fp, Gll^Fp, Gg^Efm, Gll^Fp, Gll^Fp, Gg, Gg, Gg^Efm, Gs^Fp, Gg^Fet, Hh, Gll^Fp, Gll^Fp, Gll, Gg, Gll^Fp, Gll^Fp, Gll^Fp, Gll^Fp, Gll^Fp, Gll^Fp, Gll^Fp, Gg, Gll^Fp, Gg, Gg, Gg, Gg
Mm, Mm, Mm, Mm, Mm, Ww, Ww, Mm, Mm, Hh, Ww, Gg, Gll^Fp, Gg, Gg^Fet, Gll^Fp, Gll^Fp, Gg^Fet, Gll^Fp, Gll^Fp, Hh, Gll^Fp, Gll^Fp, Gll^Fp, Gll^Fp, Gg^Ve, Gll^Fp, Gll^Fp, Gg^Ve, Gll^Fp, Gg^Efm, Gg^Ve, Gll^Fp, Gg^Efm, Gg^Efm, Gg^Ve, Gll^Fp, Gll^Fp, Hh, Hh, Hh, Gs^Fp, Hh, Gs^Fp, Hh, Hh, Gll^Fp, Gll^Fp, Gll^Fp, Gg, Gll^Fp, Gll^Fp, Gll^Fp, Gll^Fp, Gg, Gll^Fp, Gg, Gg, Gg, Gg, Gg, Gg
Mm, Mm, Mm, Mm, Mm, Mm, Hh, Ww, Hh, Hh, Ww, Gll^Fp, Gll^Fp, Gll^Fp, Gll^Fp, Gll^Fp, Hh, Gll^Fp, Hh, Hh, Hh, Hh, Hh, Gg^Ve, Gll^Fp, Gll, Gll^Efm, Gg^Efm, Gg^Efm, Gg^Efm, Gg^Efm, Gg^Efm, Gg, Gll^Fp, Gll^Efm, Gll^Efm, Gll^Fp, Gg^Fet, Gll^Fp, Hh, Hh, Hh, Hh, Hh, Hh, Hh, Gll^Fp, Gll^Fp, Gll^Fp, Gg, Gg, Gll^Fp, Gg, Gg, Gg, Gg, Gll^Fp, Gll^Fp, Gll^Fp, Gll^Fp, Gll^Fp, Gll^Fp
Mm, Mm, Mm, Mm, Mm, Hh, Ww, Ww, Ww, Ww, Gg, Gll^Fp, Gll^Fet, Gll^Fp, Gll^Fp, Gll^Fp, Gll, Hh, Hh, Hh, Gll^Fp, Hh, Gll^Fp, Gg^Efm, Gll^Efm, Gll^Ve, Gll, Gg^Efm, Gll^Efm, Ce, Ce, Ce, Ce, Ce, Gll^Efm, Gll^Efm, Gll^Fp, Gll^Fp, Gg^Ve, Gg^Ve, Hh, Hh, Hh, Hh, Gll^Fp, Gll^Fp, Gll^Fp, Gll^Fp, Gll^Fp, Gg, Gg, Gll^Fp, Gg, Gg, Gg, Gg, Gll^Fp, Gll^Fp, Gll^Fp, Gll^Fp, Gll^Fp, Gll^Fp
Mm, Mm, Mm, Mm, Mm, Hh, Ww, Ww, Gg^Fet, Gg, Gll, Gg, Gll^Fp, Gll^Fp, Gll^Fp, Gll, Gll^Fp, Gll^Fp, Hh, Gll^Fp, Gll^Fp, Gg^Fet, Gll^Fp, Gll^Fp, Gll^Efm, Gll^Efm, Gll^Ve, Gll^Efm, Gg, Ce, Ce, 9 Ke, Ce, Ce, Gg^Efm, Gll^Ve, Gll^Fp, Gll^Fp, Hh, Hh, Gll^Fp, Hh, Gll^Fp, Hh, Gll^Fp, Gll^Fp, Gll^Fp, Gll^Fp, Gg^Fet, Gll^Fp, Gll^Fp, Gg, Gll^Fp, Gll^Fp, Gll^Fp, Gll^Fp, Gll^Fp, Gll^Fp, Gll^Fp, Gll^Fp, Gll^Fp, Gll^Fp
Mm, Mm, Mm, Mm, Mm, Ww, Ww, Gg^Fet, Gll^Fp, Gll^Fp, Gll, Gg^Efm, Gll^Fp, Gll^Fp, Gll^Fp, Gll^Fp, Gll^Fp, Gll^Fp, Gll^Fp, Gll^Fp, Gll^Fp, Gll^Fp, Gg^Ve, Gll^Fp, Gg^Ve, Gg^Efm, Gll^Efm, Gg^Efm, Gg^Efm, Ce, Gg^Ve, Ce, Gg^Ve, Ce, Gg^Efm, Gll^Fp, Gll^Fp, Gll^Fp, Hh, Gll^Fp, Gll^Fp, Gll^Fp, Gll^Fp, Gll^Fp, Gg, Gll^Fp, Gll^Fp, Gll^Fp, Gll^Fp, Gll^Fp, Gll^Fp, Gg, Gll^Fp, Gll^Fp, Gll^Fp, Gll^Fp, Gll^Fp, Gll^Fp, Gll^Fp, Gll^Fp, Gg, Gg
Mm, Mm, Mm, Mm, Mm, Ww, Gg, Gll^Fp, Gll^Fp, Gll^Fp, Gll^Efm, Gll^Efm, Gll, Gll^Fp, Gg^Fet, Gll^Fp, Gll^Fp, Gll^Fp, Gll^Fp, Gg^Fet, Gll^Fp, Gll^Fp, Gll^Fp, Gll^Fp, Gll^Fp, Gg^Efm, Gll^Fp, Gll^Fp, Gll^Fp, Gll^Fp, Gll^Fp, Gg^Efm, Gg^Efm, Gg^Efm, Gg^Efm, Gll^Fp, Gll^Fp, Gll^Fp, Gll^Fp, Gll^Fp, Gll^Fp, Gll^Fp, Gll^Fp, Gll^Fp, Gll^Fp, Gg^Fet, Gll^Fp, Gll^Fp, Gll^Fp, Gll^Fp, Gll^Fp, Gll^Fp, Gg, Gll^Fp, Gll^Fp, Gll^Fp, Gll^Fp, Gll^Fp, Hh, Hh, Hh, Hh
Hh, Hh, Hh, Mm, Ww, Ww, Gg, Gll^Fp, Gll^Fp, Gll^Fp, Gg^Efm, Gll, Gll^Fp, Gll^Fp, Gll^Fp, Gll^Fp, Gll^Fp, Gll^Fet, Gll^Fp, Gll^Fp, Gll^Fp, Gg^Fet, Gll^Fp, Gll^Fp, Gg^Ve, Gll^Fp, Gll^Fp, Gg^Ve, Gll^Fp, Gll^Fp, Gg^Ve, Gll^Fp, Gg^Fet, Gg^Ve, Gg^Efm, Gg, Gll^Fp, Gg^Ve, Gll^Fp, Gll^Fp, Gg^Fet, Gll^Fp, Gg^Fet, Gll^Fp, Gll^Fp, Gll^Fp, Gll^Fp, Gll^Fp, Gg^Fet, Gll^Fp, Gll^Fp, Gll^Fp, Gll^Fp, Gg, Gll^Fp, Gll^Fp, Hh, Hh, Hh, Hh, Hh, Hh
Hh, Hh, Hh, Ww, Gll^Fp, Gg^Fet, Gll^Fp, Gg, Gll, Gg, Gg, Gll^Fp, Gll^Fp, Gll^Fp, Gll^Fp, Gll^Fp, Gll^Fet, Gll^Fp, Gll^Fp, Hh, Hh, Hh, Gll^Fp, Gll^Fp, Gll^Fp, Gll^Fp, Gg^Ve, Gll^Fp, Gll^Fp, Gll^Fp, Hh, Gll^Fp, Gll^Fp, Gg^Efm, Gg, Gll, Gll^Fp, Gll^Fp, Gll^Fp, Gll^Fp, Gll^Fp, Gll^Fp, Gll^Fp, Gll^Fp, Gll^Fp, Gll^Fp, Gll^Fp, Gll^Fp, Gll^Fp, Gg^Fet, Gll^Fp, Gll^Fp, Gll^Fp, Gll^Fp, Gll^Fp, Hh, Hh, Hh, Mm, Hh, Mm, Mm
Hh, Hh, Ww, Ww, Gll^Fp, Gll^Fp, Gll^Fp, Gll, Gg, Gg, Gll^Fp, Gll^Fp, Gll^Fp, Gll^Fp, Gll^Fp, Gll^Fp, Gll^Fp, Gll^Fp, Hh, Hh, Hh, Gll^Fp, Hh, Gll^Fp, Gll^Fp, Gll^Fp, Hh, Hh, Hh, Hh, Hh, Gll^Fp, Hh, Gg, Gll, Gll^Fp, Gll, Gll^Fp, Gll^Fp, Gll^Fp, Gll^Fp, Gll^Fp, Gll^Fp, Gll^Fp, Gg^Fet, Gll^Fp, Gll^Fp, Gll^Fp, Gll^Fp, Gll^Fp, Gll^Fp, Gll^Fp, Gll^Fp, Gg, Gll^Fp, Hh, Hh, Hh, Mm, Mm, Mm, Mm
Ww, Ww, Gll^Fp, Gll^Fp, Gll^Fp, Gll^Fp, Gll, Gg, Gg, Gll^Fp, Gll^Fp, Gll^Fp, Gll^Fp, Gll^Fp, Gll^Fp, Gll^Fp, Gll^Fp, Hh, Hh, Hh, Hh, Hh, Hh, Hh, Hh, Hh, Hh, Hh, Hh, Hh, Hh, Hh, Gs^Fp, Gg, Gg, Gg, Gll^Fp, Gll^Fp, Gll^Fp, Gg^Fet, Gll^Fp, Gll^Fp, Gll^Fp, Gll^Fp, Gll^Fp, Gll^Fp, Gll^Fp, Gll^Fp, Gll^Fp, Gll^Fp, Gll^Fp, Gll^Fp, Gll^Fp, Gg, Hh, Gll^Fp, Hh, Hh, Mm, Mm, Mm, Mm
Ww, Ww, Gll^Fp, Gll^Fp, Gll^Fp, Gll^Fp, Gg, Gg, Gg, Gll^Fp, Gll^Fp, Gll^Fp, Gll^Fp, Gll^Fp, Gll^Fp, Gll^Fp, Gll^Fp, Hh, Hh, Hh, Hh, Hh, Hh, Hh, Hh, Hh, Hh, Hh, Hh, Hh, Hh, Hh, Gs^Fp, Gg, Gg, Gg, Gll^Fp, Gll^Fp, Gll^Fp, Gll^Fp, Gll^Fp, Gll^Fp, Gll^Fp, Gll^Fp, Gll^Fp, Gll^Fp, Gll^Fp, Gll^Fp, Gll^Fp, Gll^Fp, Gll^Fp, Gll^Fp, Gll^Fp, Gg, Hh, Gll^Fp, Hh, Hh, Mm, Mm, Mm, Mm
