Mdd, Mdd, Re^Es, Hhd, Mdd, Mdd, Mdd, Mdd, Mdd, Mdd, Mdd, Hhd, Hhd, Hhd^Ftp, Dd, Dd^Ftr, Dd^Esd, Hd, Hd, Dd^Fts, Hd, Ds, Hd^Fts, Dd, Dd, Dd, Dd^Fts, Dd^Fts
Re, Rd, Rd, Hhd^Edpp, Hhd^Ftd, Mdd, Mdd, Mdd, Mdd, Mdd, Hd^Ftp, Mdd, Hhd^Em, Hd, Ds^Fts, Dd, Ds^Esd, Dd^Esd, Dd^Fts, Hd^Em, Ds^Edb, Dd, Ds^Edp, Ds, Dd, Dd^Edp, Hd^Em, Hd^Fts
Hhd, Mdd, Hhd^Ftd, Rd^Es, Hhd^Em, Mdd, Hd, Mdd, Ds^Edp, Ds^Em, Dd^Fts, Hd^Ftp, Hhd^Fts, Ds^Ftd, Ds^Do, Ds^Em, Ds^Ftd, Ds^Esd, Ds^Edb, Ds^Es, Ds, Dd^Edp, Ds^Edb, Ds^Em, Dd, Hd, Dd^Dc, Dd
Mdd, Mdd, Hhd, Rd^Es, Hhd, Hhd, Hd^Fts, Hd^Fts, Hd^Em, Hhd, Dd, Hhd^Em, Dd^Fts, Wwt, Wwt, Wwt, Hd, Hd^Ftd, Hd, Dd, Dd, Dd, Dd^Es, Dd, Hd^Edb, Dd^Edb, Ds, Ds
Hhd^Ft, Hhd, Hd^Fts, Rd, Rd, Hhd, Hd^Esd, Mdd, Mdd, Hhd^Em, Hhd, Ds, Dd, Dd^Edp, Wwt, Wwt, Hd, Hd^Em, Rd, Dd, Dd^Edb, Rd, Rd^Edb, Hd, Hd^Edb, Ds^Edb, Ds, Dd^Fts
Mdd, Hhd, Hd, Dd^Fts, Dd^Esd, Rd^Es, Ds^Esd, Hd^Ftd, Hd^Ftd, Hhd^Edb, Dd, Ds, Dd, Dd, Dd^Ftd, Dd, Ds, Hd, Rd^Edb, Rd^Dr, Rd, Rb^Edb, Cyd^Edb, Hd^Edb, Rb, Dd^Es, Ds, Dd
Hhd, Hd^Fts, Hd^Fts, Ds^Edp, Rd, Rd, Hd^Esd, Hd^Esd, Hd, Hd, Dd, Dd, Hd^Ftd, Dd, Hd, Ds, Dd, Dd, Dd^Dc, Rd^Edb, Rb^Edb, Rb^Es, Cyd^Edb, 3 Kyd, Cyd, Rd, Dd^Edb, Dd^Dr
Mdd, Mdd, Hhd^Em, Ds, Rd, Hhd, Hhd, Hhd, Hd^Ftd, Hd^Edb, Dd^Edb, Hd, Hd^Edb, Hd, Hd, Ds, Dd, Dd, Dd^Edp, Rd, Dd^Es, Rb^Edb, Cyd, Cyd, Dd^Dc, Rb^Edb, Dd^Edb, Dd
Mdd, Hhd^Ft, Hd^Ftd, Hd, Hhd, Rd, Rd, Rd, Dd, Dd^Dc, Dd^Dr, Dd, Hd, Hd^Em, Hd^Fts, Hd, Hd, Dd, Dd, Dd^Edb, Dd, Dd^Edb, Rb^Edb, Hd, Hd, Dd^Es, Dd^Edb, Dd^Edb
Hhd^Ftp, Hhd, Hhd^Em, Hhd, Hd, Hhd, Dd, Rd, Dd, Dd^Edb, Dd, Hd, Hd^Em, Hd, Hd, Hd^Em, Dd, Dd, Dd^Esd, Dd, Dd, Rb^Edb, Dd^Edb, Hd, Dd, Dd, Dd, Dd
Hhd^Em, Hhd, Hd, Hhd^Em, Hd, Hhd, Dd, Dd, Dd, Dd^Esd, Dd^Esd, Rd, Rd^Es, Rd, Dd^Ecf, Hd^Edpp, Dd^Vdt, Dd, Ds, Dd, Dd, Dd, Rd, Dd, Dd, Dd^Edp, Dd, Dd
Hhd^Ftd, Hhd, Dd, Hd, Hd, Hd^Fts, Dd, Dd^Edp, Dd, Dd^Esd, Dd, Dd^Es, Hd, Dd, Hd, Hd^Fts, Dd, Dd, Ds, Ds, Dd^Edpp, Dd, Rd, Rd^Es, Hd, Dd, Dd, Dd
Hhd^Ftd, Hhd^Ftd, Dd, Dd^Fts, Dd^Edp, Dd, Hd^Fts, Dd, Dd, Dd, Dd, Dd^Vdt, Hd^Edpp, Dd^Esd, Dd, Dd, Rd, Ds, Dd, Dd^Vdt, Dd, Rd, Dd, Rd^Es, Hd, Dd, Dd, Dd
Hd, Hd^Em, Hd, Dd, Dd, Hd, Hd, Hd, Rd, Rd, Dd, Hd, Dd, Dd, Dd, Dd^Vdt, Dd, Rd^Es, Dd, Dd^Esd, Hd^Ftd, Hd, Dd, Dd, Hd^Ftd, Hd, Hd^Ftd, Hd
Hhd, Hd, Dd, Dd, Dd, Dd, Rd, Hd, Rd^Es, Dd, Dd^Edpp, Dd, Dd, Dd, Dd, Dd^Edpp, Dd, Dd, Dd^Esd, Dd^Edpp, Hd, Dd^Vdt, Dd, Rd, Hd, Hd, Hhd, Hd^Ftd
Hhd, Hd^Ftd, Ds, Hd^Em, Dd, Dd, Ce, Rd^Es, Dd, Dd, Wwt, Ds^Edp, Ds, Ds, Ds, Ds, Dd^Ecf, Dd, Dd, Dd, Dd, Dd, Rd, Rd^Es, Dd, Hd^Ftd, Mdd, Mdd
Dd, Dd, Ds^Fts, Ds, Dd, Ce, 1 Ke, Ce, Ds^Ftd, Wwt, Wwt, Wwt, Ds^Fts, Ds^Vdt, Dd, Dd, Dd^Edb, Dd, Dd^Vdt, Dd, Hd, Dd, Dd, Dd, Rd, Hhd, Rd^Es, Mdd
Dd, Dd^Edp, Hd^Em, Ds, Dd, Ce, Ce, Ce, Ds, Ds^Edp, Wwt, Wwt, Ds^Edp, Ds, Dd^Edb, Dd^Edpp, Dd^Dr, Dd, Dd, Dd, Hd, Dd^Esd, Hd, Dd, Rd, Rd, Rd^Es, Hhd^Ftd
Dd^Ftd, Dd, Dd^Edp, Dd, Dd^Esd, Dd^Esd, Ds, Ds^Es, Ds^Edpp, Wwt, Ds^Edp, Wwt, Ds, Dd, Dd^Vdt, Dd^Edb, Dd^Edb, Dd^Dc, Dd, Dd^Vdt, Dd, Dd^Esd, Hd^Ftd, Dd, Dd, Dd^Edb, Ds, Ds
Dd, Dd, Dd, Dd, Dd^Esd, Dd, Dd, Dd, Rd, Rd, Ds^Vdt, Ds, Dd, Rd, Rd, Dd^Edb, Dd^Edb, Dd^Edb, Dd, Dd, Dd^Esd, Hd, Hd, Dd, Dd^Edb, Dd, Dd, Ds
Dd^Edp, Dd, Hd^Ftd, Dd, Rd, Rd, Dd, Rd, Dd, Rd^Es, Ds, Dd, Dd, Rd^Ecf, Rd^Es, Dd, Dd^Esd, Dd^Vdt, Dd, Dd^Esd, Dd^Esd, Hd, Dd^Edb, Rd, Dd, Hd, Dd^Edp, Dd
Ds, Ds, Dd, Dd, Dd, Rd^Es, Rd^Es, Dd^Esd, Dd^Esd, Dd, Hd, Ds, Mdd, Hd^Edpp, Hd, Dd^Esd, Dd, Dd^Edb, Dd^Edb, Dd, Dd, Dd^Es, Rd^Edb, Rd^Edb, Hd, Hd^Ftd, Dd, Dd
Ds, Dd, Dd, Dd, Dd^Edb, Dd^Edp, Hd, Hd, Dd^Esd, Dd^Dc, Hd, Hd^Ftd, Hd^Esd, Hd^Vdt, Hd, Dd, Dd, Dd^Edb, Dd^Es, Rd^Edb, Cyd, Dd^Dc, Rb^Edb, Dd^Es, Dd^Edp, Dd, Hd^Ftd, Dd
Dd, Dd^Dc, Dd^Edp, Dd^Edb, Dd^Edb, Dd^Dr, Hhd, Hhd^Em, Mdd, Dd, Dd, Mdd, Hd^Edpp, Hd^Esd, Dd, Dd, Hd, Hd, Rb^Edb, Rb^Edb, Cyd^Edb, Cyd, Cyd, Rb, Dd, Dd, Hd, Dd
Hd^Fts, Hd, Hd, Dd^Edb, Hd, Hhd^Em, Hhd^Ftd, Mdd, Mdd, Hhd, Ds, Hd, Dd, Hd, Dd^Esd, Dd^Edb, Rd, Hd, Rb^Edb, Rb^Edb, Cyd^Edb, 2 Kyd, Rb^Edb, Rb, Hd, Hd, Hd^Ftd, Hd
Hd, Hd, Dd^Fts, Hd, Hd, Hd, Dd, Dd^Edp, Mdd, Dd^Do, Ds, Dd, Dd^Dc, Dd, Dd^Esd, Dd, Rd^Dr, Rd, Rd, Dd^Dc, Dd, Dd^Edb, Rd^Edb, Dd, Mdd, Hd^Ftd, Mdd, Hd
Hd, Dd, Dd, Hd^Edp, Hd, Dd^Edp, Hd, Mdd, Hhd^Em, Hd^Ftd, Hd, Ds, Dd^Edb, Dd^Edp, Dd, Rd^Edb, Dd^Edb, Dd^Edb, Dd, Dd, Dd^Edp, Rd^Edb, Dd^Dr, Rd^Edb, Mdd, Mdd, Mdd, Mdd
Hd, Dd, Hd, Dd^Edp, Dd, Hd, Hd, Hhd, Dd, Hd, Dd, Ds, Dd, Dd, Dd, Dd, Dd, Dd, Dd, Hd, Hd, Hd^Ftd, Hd, Hd, Hd, Mdd, Hd, Mdd
