Xu, Xu, Xu, Xu, Xu, Xu, Xu, Xu, Xu, Xu, Xu, Xu, Xu, Xu, Xu, Xu, Xu, Xu, Xu, Xu, Xu, Xu, Xu, Xu, Xu, Xu, Xu, Xu, Xu, Xu, Xu, Xu, Xu, Xu, Xu, Xu, Xu, Xu, Xu, Xu, Xu, Xu, Xu, Xu, Xu, Xu, Xu, Xu, Xu, Xu, Xu, Xu, Xu, Xu, Xu, Xu, Xu, Xu
Xu, Xu, Xu, Xu, Xu, Xu, Xu, Xu, Xu, Xu, Xu, Xu, Xu, Xu, Xu, Xu, Xu, Xu, Xu, Xu, Xu, Xu, Xu, Xu, Xu, Xu, Xu, Xu, Xu, Xu, Xu, Xu, Xu, Xu, Xu, Xu, Xu, Xu, Xu, Xu, Xu, Xu, Xu, Xu, Xu, Xu, Xu, Xu, Xu, Xu, Xu, Xu, Xu, Xu, Xu, Xu, Xu, Xu
Xu, Xu, Xu, Xu, Xu, Xu, Xu, Xu, Xu, Xu, Xu, Xu, Xu, Xu, Xu, Xu, Xu, Xu, Xu, Xu, Xu, Xu, Xu, Xu, Xu, Xu, Xu, Xu, Xu, Xu, Xu, Xu, Xu, Xu, Xu, Xu, Xu, Xu, Xu, Xu, Xu, Xu, Xu, Xu, Xu, Xu, Xu, Xu, Xu, Xu, Xu, Xu, Xu, Xu, Xu, Xu, Xu, Xu
Xu, Xu, Xu, Xu, Xu, Xu, Xu, Xu, Xu, Xu, Xu, Xu, Xu, Xu, Xu, Xu, Xu, Xu, Xu, Xu, Xu, Xu, Xu, Xu, Xu, Xu, Xu, Xu, Xu, Xu, Xu, Xu, Xu, Xu, Xu, Xu, Xu, Xu, Xu, Xu, Xu, Xu, Xu, Xu, Xu, Xu, Xu, Xu, Xu, Xu, Xu, Xu, Xu, Xu, Xu, Xu, Xu, Xu
Xu, Xu, Xu, Xu, Xu, Xu, Xu, Qlf, Xu, Xu, Xu, Qlf, Xu, Xu, Xu, Xu, Xu, Xu, Xu, Xu, Xu, Xu, Xu, Xu, Xu, Xu, Xu, Xu, Xu, Xu, Xu, Xu, Xu, Xu, Xu, Xu, Xu, Xu, Xu, Xu, Xu, Xu, Xu, Xu, Xu, Xu, Xu, Xu, Xu, Xu, Xu, Xu, Xu, Xu, Xu, Xu, Xu, Xu
Xu, Xu, Xu, Xu, Xu, Xu, Xu, Xu, Xu, Qlf, Xu, Xu, Xu, Xu, Xu, Xu, Xu, Xu, Xu, Xu, Xu, Xu, Xu, Xu, Xu, Xu, Xu, Xu, Xu, Xu, Xu, Xu, Xu, Xu, Xu, Xu, Xu, Xu, Xu, Xu, Xu, Xu, Xu, Xu, Xu, Xu, Xu, Xu, Xu, Xu, Xu, Xu, Xu, Xu, Xu, Xu, Xu, Xu
Xu, Xu, Xu, Xu, Xu, Xu, Xu, Xu, Xu, Xu, Xu, Xu, Xu, Xu, Xu, Xu, Xu, Xu, Xu, Xu, Xu, Xu, Xu, Xu, Xu, Xu, Xu, Xu, Xu, Xu, Xu, Xu, Xu, Xu, Xu, Xu, Xu, Xu, Xu, Xu, Xu, Xu, Xu, Xu, Xu, Xu, Xu, Xu, Xu, Xu, Xu, Xu, Xu, Xu, Xu, Xu, Xu, Xu
Xu, Xu, Xu, Xu, Xu, Xu, Xu, Xu, Qlf, Qlf, Qlf, Xu, Xu, Xu, Xu, Xu, Xu, Xu, Xu, Xu, Xu, Xu, Xu, Xu, Xu, Xu, Xu, Xu, Xu, Xu, Xu, Xu, Xu, Xu, Xu, Xu, Xu, Xu, Xu, Xu, Xu, Xu, Xu, Xu, Xu, Xu, Xu, Xu, Xu, Xu, Xu, Xu, Xu, Xu, Xu, Xu, Xu, Xu
Xu, Xu, Xu, Xu, Xu, Xu, Xu, Xu, Xu, Qlf, Xu, Xu, Xu, Xu, Xu, Xu, Xu, Xu, Xu, Xu, Xu, Xu, Xu, Xu, Xu, Xu, Xos^Efs, Xu, Uh^Vud, Xos, Xu, Xu, Xu, Xu, Xu, Xu, Xu, Xu, Xu, Xu, Xu, Xu, Xu, Xu, Xu, Xu, Xu, Xu, Xu, Xu, Xu, Xu, Xu, Xu, Xu, Xu, Xu, Xu
Xu, Xu, Xu, Xu, Xu, Xu, Xu, Xu, Xu, Xu, Xu, Xu, Xu, Xu, Xu, Xu, Xu, Xu, Xu, Xu, Xu, Xu, Xu, Xu, Xos, Xos^Efs, Uu^Emf, Uh^Uf, Uu^Ebn, Xos, Xos, Xu, Xu, Xu, Xu, Xu, Xu, Xu, Xu, Xu, Xu, Xu, Xu, Xu, Xos, Xu, Xu, Xu, Xos, Xos, Xu, Xu, Xu, Xu, Xu, Xu, Xu, Xu
Xu, Xu, Xu, Xu, Xu, Xu, Xu, Xu, Xu, Xu, Xu, Xu, Xu, Xu, Xu, Xu, Xu, Xu, Xu, Xu, Xu, Xu, Xu, Xos, Uu^Vud, Uu^Em, Ur, Uu, Ur^Es, Uu^Em, Uh^Uf, Xu, Xos, Xu, Xu, Xu, Xu, Xu, Xu, Xu, Xu, Xu, Xu, Xos, Uh^Em, Uu^Ebn, Uh^Emf, Uu^Vud, Uh^Emf, Uh^Uf, Xos, Xu, Xu, Xu, Xu, Xu, Xu, Xu
Xu, Xu, Xu, Xu, Xu, Xu, Xu, Xu, Xu, Xu, Xu, Xu, Xu, Xu, Xu, Xu, Xu, Xu, Xu, Xu, Xu, Xu, Xu, Xu, Ur^Es, Uu, Cud, Ur^Es, Ur, Uu^Emf, Uh^Uf, Xu, Xos, Xu, Xu, Xu, Xu, Xu, Xu, Xu, Xos, Xos, Uu^Ebn, Uh^Emf, Uu, Uu^Em, Uu^Em, Uu^Ii, Uu^Em, Uh^Uf, Xos, Xu, Xu, Xu, Xu, Xu, Xu, Xu
Xu, Xu, Xu, Xu, Xu, Xu, Xu, Xu, Xu, Xu, Xu, Xu, Xu, Xu, Xu, Xu, Xu, Xu, Xu, Xu, Xu, Xu, Xos, Uu^Emf, Ur, Cud, Kud, Cud, Uu^Em, Uu^Ii, Uu^Vud, Uh^Em, Xos, Xu, Xu, Xu, Xu, Xu, Xu, Xu, Xos^Efs, Rr, Uu, Ur, Cud, Cud, Cud, Uu, Uu^Vud, Uu^Ebn, Xu, Xu, Xu, Xu, Xu, Xu, Xu, Xu
Xu, Xu, Xu, Xu, Xu, Xu, Xu, Xu, Xu, Xu, Xu, Xu, Xu, Xu, Xu, Xu, Xu, Xu, Xu, Xu, Xu, Xu, Xos, Uu^Em, Uu^Ii, Cud, Cud, Cud, Uu, Uu^Em, Uu, Uu^Em, Uu, Xos, Uh^Emf, Xu, Xu, Xu, Xos, Xos^Efs, Rr^Br/, Rr^Br\, Ur^Br\, Ur^Es, Cud, Kud, Cud, Uu, Uu, Uu^Ii, Uu, Uu^Vud, Xu, Xu, Xu, Xu, Xu, Xu
Xu, Xu, Xu, Xu, Xu, Xu, Xu, Xu, Xu, Xu, Xu, Xu, Xu, Xu, Xu, Xu, Xu, Xu, Xu, Xu, Xu, Xu, Xos, Rr, Rr^Es, Ur^Es, Ur^Es, Uu, Uu^Vud, Uu^Ebn, Xu, Uu^Em, Uu^Ii, Ur^Br|, Ur^Br\, Uu^Vud, Uu^Em, Xu, Uu^Br/, Ur^Br/, Uu, Uu^Es, Uu^Emf, Ur^Br/, Uu^Es, Cud, Ur^Es, Rr, Rr, Uu^Em, Uh^Em, Xu, Xu, Xu, Xu, Xu, Xu, Xu
Xu, Xu, Xu, Xu, Xu, Xu, Xu, Xu, Xu, Xu, Xu, Xu, Xu, Xu, Xu, Xu, Xu, Xu, Xu, Xu, Xu, Xu, Xu, Xos, Rr^Br/, Ur, Uu, Uu^Emf, Uu^Em, Uh, Xu, Xu, Xu, Uu^Br/, Rr^Es, Ur^Br\, Uu^Br/, Uu^Br/, Uu^Ii, Ur^Br|, Xu, Xu, Xos, Uu^Vud, Uu^Uf, Ur, Uu, Rr, Uu^Em, Uh^Emf, Xos, Xos, Xu, Xu, Xu, Xu, Xu, Xu
Xu, Xu, Xu, Xu, Xu, Xu, Xu, Xu, Xu, Xu, Xu, Xu, Xu, Xu, Xu, Xu, Xu, Xu, Xu, Xu, Xu, Xu, Xu, Xos, Xos, Rr^Br\, Rr^Br|, Uu^Uf, Xos, Xos, Xu, Xos, Rr, Rr, Xos, Rr^Br|, Uu, Uu^Em, Ur, Xuc, Xuc, Xu, Xu, Xos, Xu, Ur, Uu^Es, Uh^Em, Xu, Uh^Uf, Xu, Xu, Xu, Xu, Qxu, Xu, Qxu, Qxu
Xu, Xu, Xu, Xu, Xu, Xu, Xu, Xu, Xu, Xu, Xu, Xu, Xu, Xu, Xu, Xu, Xu, Xu, Xu, Xu, Xu, Xu, Xu, Xu, Xu, Ur, Ur^Br\, Xuc, Xuc, Xu, Xuc, Xu, Ur^Es, Xos, Xu, Xuc, Uu^Vud, Uu^Emf, Uu, Ur, Xuc, Xu, Xu, Xu, Xu, Uu, Xu, Xu, Xu, Xu, Qxu, Xu, Qxu, Xu, Qxu, Qxu, Xu, Xu
Xu, Xu, Xu, Xu, Xu, Xu, Xu, Xu, Xu, Xu, Xu, Xu, Xu, Xu, Xu, Xu, Xu, Xu, Xu, Xu, Xu, Xu, Xu, Xu, Xu, Uh^Em, Uh^Emf, Ur^Br/, Uu^Em, Uh, Uu, Ur^Es, Xu, Xu, Xu, Xuc, Xuc, Uh^Em, Uu^Ii, Rr, Xu, Xu, Xu, Uu^Vud, Rr, Rr, Xu, Xu, Qxu, Qxu, Qxu, Qxu, Xu, Qxu, Qxu, Qxu, Xu, Xu
Xu, Xu, Xu, Xu, Xu, Xu, Xu, Xu, Xu, Xu, Xu, Xu, Xu, Xu, Xu, Xu, Xu, Xu, Xu, Xu, Xu, Xu, Xu, Xu, Xu, Xu, Xu, Uu, Uu^Vud, Uu^Ii, Uh, Uu, Xuc, Xu, Ur^Es, Ur^Es, Ur^Br|, Uu, Uu^Br/, Rr^Br/, Xu, Xu, Xuc, Xuc, Rr, Xu, Xu, Xu, Qxu, Qxu, Qxu, Xu, Xu, Qxu, Qxu, Xu, Xu, Xu
Xu, Xu, Xu, Xu, Xu, Xu, Xu, Xu, Xu, Xu, Xu, Xu, Xu, Xu, Xu, Xu, Xu, Xu, Xu, Xu, Xu, Xu, Xu, Xu, Xu, Xu, Xu, Xu, Xu, Xu, Uu^Em, Uu, Uu, Xuc, Uu^Ii, Uu^Em, Xuc, Xuc, Ur, Uu^Em, Uu^Emf, Xu, Uu, Ur^Es, Xu, Xu, Qxu, Qxu, Qxu, Qxu, Qxu, Xu, Xu, Xu, Qxu, Qxu, Xu, Xu
Xu, Xu, Xu, Xu, Re, Xu, Xu, Xu, Xu, Xu, Xu, Xu, Xu, Xu, Uh, Xu, Uh^Uf, Xu, Xu, Xu, Xu, Xu, Xu, Xu, Xu, Xu, Xu, Xu, Xu, Xu, Rr, Rr^Es, Uu^Ii, Uu^Em, Uu^Ii, Uu^Emf, Rr^Br|, Xu, Uu, Uu^Ii, Uu^Edb, Uh^Uf, Uu^Em, Ur^Es, Xuc, Xu, Qxu, Qxu, Qxu, Uu, Uu^Em, Xu, Xu, Xu, Xu, Xu, Xu, Xu
Xu, Xu, Xu, Re^Es, Uu^Em, Rb, Uu, Xu, Uu^Edb, Rb, Uh^Emf, Xu, Xu, Xu, Rb, Uu^Emf, Uu, Uh^Em, Uu, Rb, Re^Edb, Xu, Xu, Xu, Xu, Xu, Xu, Qxu, Qxu, Ur^Es, Ur, Uu, Uu, Ur^Es, Uu^Em, Rr^Br\, Uu^Br\, Ur^Es, Uu^Edb, Uu^Edb, Uu^Edb, Uu, Uh^Emf, Uh, Xuc, Xu, Qxu, Qxu, Qxu, Qxu, Rb^Emf, Xu, Xu, Xu, Xu, Xu, Xu, Xu
Xu, Xu, Xu, Uu, Uu, Uu^Em, Re, Re, Uu, Uu^Em, Uh, Uu^Em, Uu^Edb, Rb^Edb, Xu, Xu, Xu, Uu^Em, Xu, Xu, Rb^Edb, Re^Edb, Xu, Xu, Xu, Xu, Uh^Uf, Uh^Em, Qxu, Qxu, Uu, Qxu, Uu, Ur^Es, Uh^Emf, Uh^Em, Uh, Uu^Br|, Rr, Rr^Es, Ur^Es, Uu, Uu, Uu, Qxu, Qxu, Qxu, Qxu, Qxu, Xu, Rb^Em, Xu, Xu, Xu, Xu, Xu, Xu, Xu
Uu, Uu, Uu^Em, Uu, Uu, 1 Uu, Uu, Re^Es, Uu^Em, Uu, Rb^Es, Uu, Uh, Xu, Uu^Em, Xu, Uh^Emf, Uh^Uf, Xu, Xu, Xu, Uu^Edb, Xu, Xu, Xu, Xu, Xu, Uh^Emf, Uu^Vud, Rb^Edb, Uu, Qxu, Uu^Es, Qxu, Qxu, Xu, Xuc, Xuc, Xuc, Rr^Es, Uu^Edb, Uu^Em, Qxu, Uu^Em, Uh, Xu, Xu, Xu, Xu, Xu, Rb, Rb, Xu, Xu, Xu, Xu, Xu, Xu
Uu, Uu, Xu, Uu^Em, Uu^Es, Uu^Edb, Uu^Em, Uu, Uu^Uf, Uu^Em, Uu, Uu, Uu, Uu, Uu^Em, Uh, Uu^Em, Uh, Uh, Xu, Xu, Uu, Uh^Emf, Xu, Xu, Xu, Xu, Uu^Em, Rb, Rb^Edb, Cud, Uu, Rb^Es, Uu, Uu^Edb, Xu, Xu, Xu, Rr, Uu^Edb, Uu^Em, Uh^Em, Qxu, Uu^Em, Uh^Emf, Xu, Uu^Uf, Xu, Rb^Es, Rb^Es, Rb, Xu, Xu, Xu, Xu, Xu, Xu, Xu
Xu, Xu, Xu, Xu, Xu, Xu, Xu, Uu^Emf, Xu, Xu, Xu, Uu^Edb, Re, Re, Re^Es, Uu, Uu, Uu, Rb, Xu, Xu, Rb, Uu^Em, Xu, Xu, Xu, Uh^Em, Uu, Cud, Rb^Es, Cud, Cud, Uu^Em, Uh^Em, Uu^Edb, Uu^Edb, Uu^Em, Rb, Rb^Es, Uu, Uu^Vud, Qxu, Uu^Em, Uu, Uue^Emf, Uh^Uf, Wwg, Uu^Em, Wwg, Wwg, Wwg^Edb, Xu, Xu, Xu, Xu, Xu, Xu, Xu
Xu, Xu, Xu, Xu, Xu, Xu, Xu, Xu, Xu, Xu, Xu, Xu, Xu, Xu, Xu, Re^Es, Xu, Uu^Em, Uu^Edb, Re^Edb, Re^Es, Xu, Rb^Es, Xu, Xu, Uh^Uf, Uu^Em, Rb, Cud, Kud, Cud, Uu, Uu^Em, Uh^Edb, Uh, Uu^Vu, Uu, Rb^Es, Uu, Uu, Uu^Edb, Uu^Edb, Uu^Ii, Uue^Uf, Uue^Em, Wwg^Edb, Wwg, Wwg^Edb, Wwg^Edb, Wwg, Xu, Xu, Xu, Xu, Xu, Xu, Xu, Xu
Xu, Xu, Xu, Xu, Xu, Xu, Xu, Xu, Xu, Xu, Xu, Xu, Xu, Xu, Xu, Xu, Xu, Uh, Uh^Em, Rb, Uu, Rb, Uu, Xu, Uu^Em, Uu^Emf, Uu^Vud, Rb^Es, Rb, Cud, Cud, Rb^Edb, Rb^Edb, Uu^Em, Uu, Uu, Xu, Xu, Xu, Uu^Edb, Uu, Rb^Es, Uh^Uf, Uu^Dr, Uh^Vud, Wwg, Wwg, Wwg, Wwg, Wwg, Xu, Xu, Xu, Xu, Xu, Xu, Xu, Xu
Xu, Xu, Xu, Xu, Xu, Xu, Xu, Xu, Xu, Xu, Xu, Xu, Xu, Xu, Xu, Xu, Xu, Xu, Xu, Uu, Xu, Rb^Es, Uu, Uu^Em, Xu, Uu^Em, Rb^Em, Rb^Edb, Qxu, Uu, Uu^Edb, Rb^Edb, Uh^Em, Rb^Edb, Uu, Uu^Em, Xu, Xu, Rb^Em, Uu^Edb, Rb, Rb^Es, Uu^Em, Uu^Emf, Uh^Uf, Uh^Emf, Wwg, Wwg^Edb, Wwg^Edb, Xu, Xu, Xu, Xu, Xu, Xu, Xu, Xu, Xu
Xu, Xu, Xu, Xu, Xu, Xu, Xu, Xu, Xu, Xu, Xu, Xu, Xu, Xu, Xu, Xu, Xu, Xu, Xu, Xu, Xu, Xu, Xu, Xu, Xu, Qxu, Qxu, Qxu, Uu, Uu^Edb, Qxu, Uu^Vud, Qxu, Uu, Uu, Uu^Emf, Uu^Uf, Rb^Edb, Uu^Em, Uu^Emf, Qxu, Qxu, Uh^Uf, Uu^Em, Uu, Uu^Uf, Xu, Wwg^Edb, Xu, Xu, Xu, Xu, Xu, Xu, Xu, Xu, Xu, Xu
Xu, Xu, Xu, Xu, Xu, Xu, Xu, Xu, Xu, Xu, Xu, Xu, Xu, Xu, Xu, Xu, Xu, Xu, Xu, Xu, Xu, Xu, Qxu, Xu, Qxu, Qxu, Uu, Qxu, Rb^Es, Uu^Emf, Uu^Ii, Qxu, Uu, Uu^Em, Rb^Es, Uu^Ii, Uu^Em, Uu^Em, Qxu, Uh^Uf, Qxu, Uh^Uf, Uu^Edb, Rb, Rb, Uh^Uf, Xu, Xu, Xu, Xu, Xu, Xu, Xu, Xu, Xu, Xu, Xu, Xu
Xu, Xu, Xu, Xu, Xu, Xu, Xu, Xu, Xu, Xu, Xu, Xu, Xu, Xu, Xu, Xu, Xu, Xu, Xu, Xu, Xu, Xu, Qxu, Qxu, Qxu, Xu, Uu^Emf, Rb^Es, Uu^Em, Uh^Ufi, Uu^Dr, Uu^Em, Uu^Em, Rb, Uu^Edb, Uu, Uu^Vu, Uu, Qxu, Qxu, Uu^Ii, Uu^Dr, Uu^Edb, Uu^Em, Uue^Em, Uh^Emf, Xu, Xu, Xu, Xu, Xu, Xu, Xu, Xu, Xu, Xu, Xu, Xu
Xu, Xu, Xu, Xu, Xu, Xu, Xu, Xu, Xu, Xu, Xu, Xu, Xu, Xu, Xu, Xu, Xu, Xu, Xu, Xu, Xu, Xu, Xu, Qxu, Xu, Xu, Xu, Uu^Edb, Uu^Em, Uu^Em, Uh^Uf, Uu^Emf, Uu^Em, Uu^Edb, Uu^Edb, Uu^Ii, Uu^Ii, Qxu, Qxu, Qxu, Qxu, Uu^Edb, Uu^Em, Uu^Edb, Uue, Rb, Rb^Es, Uh^Uf, Uh, Xu, Xu, Xu, Xu, Xu, Xu, Xu, Xu, Xu
Xu, Xu, Xu, Xu, Xu, Xu, Xu, Xu, Xu, Xu, Xu, Xu, Xu, Xu, Xu, Xu, Xu, Xu, Xu, Xu, Xu, Qxu, Qxu, Qxu, Uue, Xu, Uue^Em, Uu^Es, Rb, Xu, Xu, Uh^Em, Xu, Uh^Emf, Rb, Uu^Edb, Xu, Uh^Emf, Qxu, Qxu, Xu, Xu, Uu^Es, Xu, Uue^Em, Uue, Uu, Uu^Em, Xu, Xu, Xu, Xu, Xu, Xu, Xu, Xu, Xu, Xu
Xu, Xu, Xu, Xu, Xu, Xu, Xu, Xu, Xu, Xu, Xu, Xu, Xu, Xu, Xu, Xu, Xu, Xu, Xu, Xu, Xu, Xu, Xu, Xu, Xu, Uue^Emf, Uue, Rb^Es, Xu, Xu, Xu, Xu, Xu, Uh^Em, Uue, Uu, Xu, Xu, Xu, Qxu, Xu, Xu, Rb^Es, Xu, Xu, Rb, Rb^Es, Uh, Xu, Xu, Xu, Xu, Xu, Xu, Xu, Xu, Xu, Xu
Xu, Xu, Xu, Xu, Xu, Xu, Xu, Xu, Xu, Xu, Xu, Xu, Xu, Xu, Xu, Xu, Qxu, Xu, Qxu, Xu, Rb^Es, Xu, Xu, Xu, Xu, Uue, Rb^Es, Uu, Xu, Xu, Xu, Xu, Uue^Uf, Uue, Rb^Es, Xu, Xu, Qxu, Qxu, Qxu, Uh, Uu, Uu, Xu, Xu, Rb, Rb^Es, Uu, Xu, Xu, Xu, Xu, Xu, Xu, Xu, Xu, Xu, Xu
Xu, Xu, Xu, Xu, Xu, Xu, Xu, Xu, Xu, Xu, Xu, Xu, Xu, Xu, Xu, Xu, Qxu, Qxu, Qxu, Qxu, Uu^Es, Xu, Xu, Xu, Uu^Ecf, Uue, Uu, Uh, Xu, Xu, Xu, Xu, Rb^Es, Uue, Xu, Xu, Rb^Es, Rb^Ii, Uu^Em, Uh^Emf, Uu^Em, Rb^Es, Uu, Xu, Uue^Em, Uu, Uue^Em, Xu, Xu, Xu, Xu, Xu, Xu, Xu, Xu, Xu, Xu, Xu
Xu, Xu, Xu, Xu, Xu, Xu, Xu, Xu, Xu, Xu, Xu, Xu, Xu, Xu, Xu, Xu, Xu, Qxu, Qxu, Uu, Xu, Xu, Xu, Xu, Uh^Emf, Uu^Uf, Uu^Edb, Uue^Dr, Uue^Uf, Xu, Uu, Rb^Es, Rb, Uu, Uu, Rb, Xu, Rb^Es, Uu, Xu, Xu, Xu, Xu, Uu^Uf, Uue, Uue, Uue^Em, Xu, Xu, Xu, Uu^Vu, Xu, Xu, Xu, Xu, Xu, Xu, Xu
Xu, Xu, Xu, Xu, Xu, Xu, Xu, Xu, Xu, Xu, Xu, Xu, Xu, Xu, Qxu, Xu, Qxu, Qxu, Qxu, Qxu, Qxu, Xu, Qxu, Rb^Vu, Rb^Es, Uu^Edb, Cte^Edb, Uue, Uue, Uh, Uue, Uue, Uh^Emf, Uh^Em, Uue, Xu, Xu, Xu, Xu, Xu, Xu, Uu^Vu, Uh, Uu^Em, Uh^Em, Uh^Em, Uu, Uu^Em, Uue, Uue^Em, Uu, Uu^Ecf, Xu, Xu, Xu, Xu, Xu, Xu
Xu, Xu, Xu, Xu, Xu, Xu, Xu, Xu, Xu, Xu, Xu, Xu, Xu, Xu, Xu, Qxu, Qxu, Qxu, Qxu, Qxu, Xu, Qxu, Qxu, Rb^Es, Uu, Cte^Edb, Kte, Cte, Uue, Uu^Edb, Rb^Edb, Rb, Xu, Xu, Xu, Uue, Rb, Rb, Rb, Xu, Xu, Xu, Uue, Uue^Em, Uu, Uu, Qxu, Uue^Emf, Uue^Uf, Qxu, Uue^Em, Xu, Xu, Qxu, Qxu, Xu, Xu, Xu
Xu, Xu, Xu, Xu, Xu, Xu, Xu, Xu, Xu, Xu, Xu, Xu, Xu, Xu, Xu, Qxu, Qxu, Xu, Xu, Qxu, Xu, Qxu, Qxu, Qxu, Qxu, Cte, Cte, Cte, Uu^Em, Rb^Dr, Rb^Es, Uu^Ecf, Xu, Xu, Xu, Uu, Xu, Uu, Uu, Uu, Uu, Re, Re, Uue^Em, Uh^Em, Rb, Cte, Qxu, Qxu, Qxu, Qxu, Xu, Qxu, Qxu, Qxu, Xu, Xu, Xu
Xu, Xu, Xu, Xu, Xu, Xu, Xu, Xu, Xu, Xu, Xu, Xu, Xu, Xu, Xu, Xu, Xu, Xu, Xu, Xu, Xu, Xu, Uu^Em, Uu^Vu, Uue^Edb, Uue, Uue, Uue, Uh^Emf, Uu^Es, Uu^Vu, Xu, Xu, Xu, Xu, Xu, Xu, Xu, Xu, Xu, Xu, Xu, Xu, Uue^Uf, Uue, Cte, Kte, Cte, Uue^Es, Uu^Ecf, Qxu, Qxu, Xu, Qxu, Qxu, Qxu, Qxu, Xu
Xu, Xu, Xu, Xu, Xu, Xu, Xu, Xu, Xu, Xu, Xu, Xu, Xu, Xu, Xu, Xu, Xu, Xu, Xu, Xu, Xu, Xu, Xu, Uu^Em, Uh^Uf, Uu^Edb, Uue^Vu, Uue^Em, Uh^Uf, Uu^Em, Xu, Xu, Xu, Xu, Xu, Xu, Xu, Xu, Xu, Xu, Xu, Xu, Xu, Uue^Vu, Uue, Cte, Cte, Cte, Uue, Uu, Xu, Qxu, Xu, Xu, Qxu, Xu, Xu, Xu
Xu, Xu, Xu, Xu, Xu, Xu, Xu, Xu, Xu, Xu, Xu, Xu, Xu, Xu, Xu, Xu, Xu, Xu, Xu, Xu, Xu, Xu, Xu, Xu, Xu, Uu^Ecf, Xu, Xu, Uu, Uue, Uue, Xu, Uh^Emf, Uh^Uf, Xu, Xu, Xu, Xu, Xu, Xu, Uu^Emf, Xu, Re^Es, Uue^Emf, Uu, Uue, Rb^Edb, Rb^Edb, Rb^Vu, Uue^Emf, Xu, Xu, Xu, Xu, Xu, Qxu, Xu, Xu
Xu, Xu, Xu, Xu, Xu, Xu, Xu, Xu, Xu, Xu, Xu, Xu, Xu, Xu, Xu, Xu, Xu, Xu, Xu, Xu, Xu, Xu, Xu, Xu, Xu, Xu, Xu, Xu, Xu, Rb^Es, Re, Rb^Es, Uu^Em, Uu^Emf, Uu^Em, Xu, Uu, Xu, Uu^Em, Uu^Em, Uu^Uf, Re, Uu^Em, Uh, Rb, Uu, Uu^Ecf, Uu^Edb, Xu, Xu, Xu, Xu, Xu, Xu, Xu, Xu, Xu, Xu
Xu, Xu, Xu, Xu, Xu, Xu, Xu, Xu, Xu, Xu, Xu, Xu, Xu, Xu, Xu, Xu, Xu, Xu, Xu, Xu, Xu, Xu, Xu, Xu, Xu, Xu, Xu, Xu, Xu, Xu, Xu, Re, Xu, Rb^Es, Re, Rb^Es, Re, Rb, Rb^Es, Re^Es, Xu, Uu^Uf, Xu, Rb, Xu, Xu, Xu, Xu, Xu, Xu, Xu, Xu, Xu, Xu, Xu, Xu, Xu, Xu
Xu, Xu, Xu, Xu, Xu, Xu, Xu, Xu, Xu, Xu, Xu, Xu, Xu, Xu, Xu, Xu, Xu, Xu, Xu, Xu, Xu, Xu, Xu, Xu, Xu, Xu, Xu, Xu, Xu, Xu, Xu, Xu, Xu, Xu, Uh, Re, Uu^Uf, Uu^Vu, Xu, Xu, Xu, Xu, Xu, Xu, Xu, Xu, Xu, Xu, Xu, Xu, Xu, Xu, Xu, Xu, Xu, Xu, Xu, Xu
Xu, Xu, Xu, Xu, Xu, Xu, Xu, Xu, Xu, Xu, Xu, Xu, Xu, Xu, Xu, Xu, Xu, Xu, Xu, Xu, Xu, Xu, Xu, Xu, Xu, Xu, Xu, Xu, Xu, Xu, Xu, Xu, Xu, Xos, Xos, Xos, Xos, Xos, Xu, Xu, Xu, Xu, Xu, Xu, Xu, Xu, Xu, Xu, Xu, Xu, Xu, Xu, Xu, Xu, Xu, Xu, Xu, Xu
Xu, Xu, Xu, Xu, Xu, Xu, Xu, Xu, Xu, Xu, Xu, Xu, Xu, Xu, Xu, Xu, Xu, Xu, Xu, Xu, Xu, Xu, Xu, Xu, Xu, Xu, Xu, Xu, Xu, Xu, Xu, Xu, Xu, Xu, Xu, Xu, Xu, Xu, Xu, Xu, Xu, Xu, Xu, Xu, Xu, Xu, Xu, Xu, Xu, Xu, Xu, Xu, Xu, Xu, Xu, Xu, Xu, Xu
Xu, Xu, Xu, Xu, Xu, Xu, Xu, Xu, Xu, Xu, Xu, Xu, Xu, Xu, Xu, Xu, Xu, Xu, Xu, Xu, Xu, Xu, Xu, Xu, Xu, Xu, Xu, Xu, Xu, Xu, Xu, Xu, Xu, Xu, Xu, Xu, Xu, Xu, Xu, Xu, Xu, Xu, Xu, Xu, Xu, Xu, Xu, Xu, Xu, Xu, Xu, Xu, Xu, Xu, Xu, Xu, Xu, Xu
Xu, Xu, Xu, Xu, Xu, Xu, Xu, Xu, Xu, Xu, Xu, Xu, Xu, Xu, Xu, Xu, Xu, Xu, Xu, Xu, Xu, Xu, Xu, Xu, Xu, Xu, Xu, Xu, Xu, Xu, Xu, Xu, Xu, Xu, Xu, Xu, Xu, Xu, Xu, Xu, Xu, Xu, Xu, Xu, Xu, Xu, Xu, Xu, Xu, Xu, Xu, Xu, Xu, Xu, Xu, Xu, Xu, Xu
