Xu, Xu, Xu, Xu, Xu, Xu, Xu, Xu, Xu, Xu, Xu, Xu, Xu, Xu, Xu, Xu, Xu, Xu, Xu, Xu, Xu, Xu, Xu, Xu, Xu, Xu, Wo, Wo, Wo, Wo, Wo, Wo, Wo, Wo, Wo, Wo, Wo, Wo, Wo, Wo, Wo, Wo, Wo, Wo, Wo, Wo, Wo, Wo, Wo, Wo, Wo, Wo, Wo, Wo, Wo, Wo, Wo, Wo, Wo, Wo, Wo, Wo, Wo
Xu, Xu, Xu, Xu, Xu, Xu, Xu, Xu, Xu, Xu, Urb, Xu, Urb, Xu, Xu, Xu, Xu, Xu, Xu, Xu, Mm^Xm, Xu, Mm^Xm, Wo, Wo, Wo, Wo, Wo, Wo, Wo, Qlf, Qlf, Qlf, Wo, Wo, Wo, Qlf, Qlf, Qlf, Wo, Wo, Wo, Wo, Wo, Wo, Wo, Wo, Wo, Wo, Wo, Wo, Wo, Wo, Wo, Wo, Wo, Wo, Wo, Wo, 8 Wo, Wo, 7 Wo, Wo
Xu, Xu, Xu, Xu, Xu, Xu, Xu, Xu, Xu, Xu, Xu, Xu, Xu, Xu, Xu, Xu, Xu, Xu, Mm^Xm, Xu, Mm^Xm, Mm^Xm, Mm^Xm, Mm^Xm, Wo, Wo, Wo, Wo, Wo, Wo, Wo, Wo, Wo, Wo, Wo, Wo, Wo, Wo, Wo, Wo, Wo, Wo, Wo, Wo, Wo, Wo, Wo, Wo, Wo, Wo, Wo, Wo, Wo, Wo, Wo, Wo, Wo, Wo, Wo, Wo, Wo, Wo, Wo
Xu, Xu, Xu, Xu, Xu, Xu, Xu, Xu, Xu, Xu, Urb, Urb, Urb, Xu, Xu, Xu, Xu, Mm^Xm, Mm^Xm, Mm^Xm, Wo, Wo, Wo, Wo, Wo, Wo, Wo, Wo, Wo, Wo, Wo, Wo, Wo, Wo, Wo, Wo, Wo, Wo, Wo, Wo, Wo, Wo, Wo, Wo, Wo, Wo, Wo, Wo, Wo, Wo, Wo, Wo, Wo, Wo, Wo, Wo, Wo, Wo, Wo, Wo, Wo, Wo, Wo
Xu, Xu, Xu, Xu, Xu, Urb, Urb^Xo, Xu, Xu, Xu, Xu, Urb, Xu, Xu, Xu, Xu, Mm^Xm, Mm^Xm, Mm^Xm, Wo, Mm, Mm, Mm, Wo, Mm, Wo, Wo, Wo, Wo, Wo, Wo, Wo, Qlf, Wo, Wo, Wo, Qlf, Wo, Wo, Wo, Wo, Wo, Wo, Wo, Wo, Wo, Wo, Wo, Wo, Wo, Wo, Wo, Wo, Wo, Wo, Wo, Wo, Wo, Wo, Wo, Wo, Wo, Wo
Xu, Xu, Xu, Xu, Xu, Xu, Urb^Xo, Xu, Xu, Xu, Xu, Xu, Xu, Xu, Xu, Xu, Mm^Xm, Mm^Xm, Mm, Wo, Mm, Mm, Mm, Mm, Wo, Wo, Wo, Wo, Wo, Wo, Wo, Wo, Wo, Qlf, Qlf, Qlf, Wo, Wo, Wo, Wo, Wo, Wo, Wo, Wo, Wo, Wo, Wo, Wo, Wo, Wo, Wo, Wo, Wo, Wo, Wo, Wo, Wo, Wo, Wo, Wo, Wo, Wo, Wo
Xu, Xu, Xu, Xu, Xu, Xu, Urb^Xo, Xu, Xu, Xu, Xu, Xu, Xu, Xu, Xu, Xu, Mm^Xm, Mm^Xm, Mm^Xm, Mm, Mm, Wo, Wo, Wo, Mm, Wo, Wo, Wo, Wo, Wo, Wo, Wo, Wo, Wo, Wo, Wo, Wo, Wo, Wo, Wo, Wo, Wo, Wo, Wo, Wo, Wo, Wo, Wo, Wo, Wo, Wo, Wo, Wo, Wo, Wo, Wo, Wo, Wo, Wo, Wo, Wo, Wo, Wo
Xu, Xu, Xu, Xu, Xu, Xu, Xu, Urb, Urb, Xu, Xu, Xu, Xu, Mm, Mm, Mm, Mm, Mm^Xm, Mm^Xm, Mm, Hh^Ftd, Wo, Mm, Mm, Mm, Wo, Wo, Wo, Wo, Wo, Wo, Wo, Wo, Wo, Wo, Wo, Wo, Wo, Wo, Wo, Wo, Wo, Wo, Wo, Wo, Wo, Wo, Wo, Ds, Wo, Wo, Wo, Wo, Wo, Wo, Wo, Wo, Wo, Wo, Wo, Wo, Wo, Wo
Xu, Xu, Xu, Xu, Xu, Xu, Xu, Cud, Cud, Cud, Cud, Mm, Mm, Mm, Gd^Ftd, Hh^Ftp, Hh^Ftp, Mm, Mm, Hh^Ftp, Wo, Wo, Wo, Mm, Wo, Wo, Wo, Wo, Wo, Wo, Wo, Wo, Wo, Wo, Wo, Wo, Wo, Wo, Wo, Wo, Wo, Wo, Wo, Wo, Ds^Esd, Wo, Wo, Wo, Wwrt, Ds^Edpp, Wwrt, Wo, Wo, Wo, Wwrt, Wo, Wo, Wo, Wo, Wo, Ds^Esd, Wo, Wo
Xu, Xu, Xu, Xu, Xu, Xu, Xu, Cud, Cud, 4 Kud, Cud, Cud, Ds^Esd, Gs^Ftd, Gd, Gd^Vht, Mm, Mm, Mm, Hh^Ftp, Wo, Mm^Xm, Mm^Xm, Wo, Mm^Xm, Mm^Xm, Wo, Wo, Wo, Wo, Wo, Wo, Wo, Wo, Wo, Wo, Wo, Wo, Wo, Wo, Wo, Wo, Wo, Wo, Wo, Wwt, Wwt, Wwt, Wwt^Ewl, Wwrt, Wo, Wo, Wo, Wo, Wwt, Wwrt, Wwt^Ewf, Wwt, Wwrt, Ds, Wwrt, Ds^Edpp, Wo
Xu, Xu, Xu, Xu, Xu, Xu, Mm, Xu, Gs^Em, Cud, Gd, Ds^Edpp, Ww^Wyc, Gs, Gd^Edpp, Hh^Fts, Hh^Fts, Mm, Mm, Mm, Hh^Ftd, Mm, Mm, Wo, Wo, Wo, Wo, Wo, Wo, Wo, Wo, Wo, Wo, Wo, Wo, Wo, Wo, Wo, Wo, Wo, Wwt, Hhd, Mdd, Wo, Wwt, Ds^Ftd, Ds, Ds^Esd, Ds^Fts, Wwrt, Wwrt, Wo, Wo, Wwrt, Wwt, Ds, Ds^Fts, Ds^Edp, Ds^Ftd, Wwrt, Wwt, Wwrt, Wo
Xu, Xu, Xu, Xu, Xu, Mm, Hh^Ftp, Hh^Ftp, Gd, Gs, Ww^Bw|, Ww^Ewl, Ww, Ww^Bw/, Gd, Wwr, Wwr, Wwr, Mm, Hh, Hh, Mm, Mm, Wo, Wo, Wo, Wo, Wo, Wo, Wo, Wo, Wo, Wo, Wo, Wo, Wo, Wo, Wo, Wo, Wo, Wo, Hhd^Ftd, Wo, Wo, Wo, Wwt^Ewl, Hhd^Ft, Rd^Fts, Hhd, Ds^Esd, Wwt, Wo, Wo, Wwt^Ewf, Wwt^Ewl, Gd^Fts, Gd^Ftp, Hd^Fts, Ds, Ds^Ftd, Wwt, Wo, Wo
Xu, Xu, Xu, Xu, Xu, Mm, Mm, Gd^Vh, Gd^Edpp, Ww^Wyc, Ww, Ww^Ewf, Ww, Wwr, Ww, Ww^Bw\, Gd, Wwr, Mm, Mm, Hh^Ftd, Wo, Wo, Wo, Wo, Wo, Wo, Wo, Mm^Xm, Wo, Wo, Wo, Wo, Wo, Wo, Wo, Wo, Wo, Wwrt, Wo, Hhd, Wwt, Hhd^Ftp, Mdd, Mdd, Wo, Gd^Ftd, Hhd^Ft, Ds^Ftd, Ds^Ftd, Ds^Edpp, Wwt^Ewl, Wwt, Wwt, Ds, Ds^Ftd, Mdd, Hd^Ftp, Hd^Esd, Ds^Edp, Ds^Ftd, Wwrt, Ds^Edpp
Xu, Xu, Xu, Xu, Xu, Mm^Xm, Ww^Ewl, Mm, Ds^Edpp, Ds, Wwr, Ww, Mm, Ww, Ww, Wwr, Gd^Edpp, Ch, Re, Mm, Mm, Hh^Ftd, Wo, Mm^Xm, Mm^Xm, Wo, Wo, Mm^Xm, Wo, Wo, Wo, Mm^Xm, Wo, Wo, Wo, Wo, Wo, Wo, Wwrt, Wwrt, Hhd^Ftp, Mdd, Ds^Ft, Mdd, Mdd, Mdd, Hhd^Ftp, Hhd^Ft, Hhd^Ftd, Ds, Gd^Ftd, Wwt, Wwt^Ewf, Ds^Esd, Gd^Fts, Ds^Edp, Hd^Ftd, Mdd, Gd^Fts, Ds, Ds^Esd, Wwrt, Ds
Xu, Xu, Xu, Xu, Xu, Mm^Xm, Wwr, Wwr, Wwr, Ww^Bw|, Wwr, Wwr, Hh, Mm, Wwr, Ww^Wyc, Ds^Esd, Rd^Esd, Gg^Vh, Mm, Mm, Hh, Wo, Mm^Xm, Wo, Wo, Wo, Wo, Wo, Wo, Wo, Wo, Wo, Wo, Wo, Wo, Wwrt, Ds^Edpp, Wwrt, Wwrt, Wwt, Wwt^Ewl, Ds^Fts, Hhd^Fts, Hhd, Mdd, Hhd^Ftp, Gd^Ft, Hhd, Hhd^Ftd, Gd^Ftd, Wwt^Ewl, Wwt^Ewf, Wwrt, Wwt^Ewl, Gd^Ft, Hd^Ftp, Hd^Ftp, Gd^Ftd, Wwrt, Wwt, Wwt, Wwt
Xu, Xu, Xu, Xu, Mm^Xm, Mm^Xm, Mm, Mm, Gs^Ft, Gs^Ft, Ww^Wyc, Ww, Ww, Hh^Fts, Ww, Ww^Bw/, Ds^Edpp, Hh^Ftd, Mm, Mm, Mm, Wo, Wo, Wo, Wo, Wo, Xu, Xu, Xu, Xu, Xu, Wo, Wo, Mm^Xm, Wo, Wo, Wo, Ds^Esd, Ds, Wwt, Ds^Esd, Wwt, Wwt^Ewl, Ds^Edpp, Ds^Ftd, Hhd^Ftp, Mdd, Gd^Ft, Gs^Ftd, Gd^Fts, Gs^Em, Gs^Ftd, Gs, Gg^Efm, Gs, Wwrt, Dd^Ft, Dd^Ftd, Wwt, Wwt, Wwt, Wwt, Wwt
Xu, Xu, Xu, Mm^Xm, Mm, Mm^Xm, Mm, Hh, Hh^Em, Gs^Ft, Gs^Em, Ww^Bw/, Ww, Wwr, Ww, Ww, Mm^Xm, Mm, Wo, Wo, Wo, Wo, Wo, Wo, Mm^Xm, Wo, Xu, Xu, Xu, Xu, Xu, Wo, Wo, Wo, Wo, Wo, Wo, Wwt, Wo, Wwt, Ds^Fts, Ds^Edpp, Ds^Fts, Ds^Ftd, Gd^Ft, Hhd, Gd^Vht, Gd^Em, Cd, Gd^Ftd, Cd, Gs, Gg^Efm, Gg, Wwt^Ewf, Wwt, Gd^Fts, Dd, Hd^Ftd, Wwt, Ds, Wwt, Wwt
Xu, Xu, Mm^Xm, Mm^Xm, Mm^Xm, Mm, Mm, Mm, Mm, Gs^Vht, Gs^Ftp, Ww, Ds^Edpp, Ww, Mm^Xm, Mm^Xm, Mm, Mm, Wo, Wo, Wo, Wo, Wo, Wo, Xu, Xu, Xu, Xu, Uu^Edb, Xu, Uu^Edb, Xu, Xu, Wo, Wo, Wo, Wo, Wo, Wo, Wwt, Wwt, Ds, Gd^Fts, Ds^Esd, Gd^Ftp, Gd^Ft, Gd^Ft, Gs^Fts, Gs^Em, Cd, 3 Kd, Cd, Wwt^Ewf, Gs, Wwrt, Gd^Ftd, Dd^Ft, Dd^Fts, Hd^Fts, Gd^Ftp, Ds^Ftd, Wwt, Wwt
Xu, Xu, Mm^Xm, Mm^Xm, Mm^Xm, Mm, Hh^Ftp, Mm, Mm^Xm, Gs^Ft, Gs^Ft, Ch, Ds, Mm, Wo, Wo, Wo, Wo, Wo, Mm^Xm, Wo, Wo, Mm^Xm, Wo, Wo, Xu, Xu, Uu^Edb, Uu^Em, Uu^Edb, Wwg, Uu, Ww^Edb, Ww, Wo, Wo, Wo, Wo, Wo, Wo, Wo, Ds^Fts, Rd^Ftd, Gd^Fts, Gs^Ftd, Gs^Ft, Gd^Em, Gs^Fts, Gs, Gs, Cd, Cd, Rd, Wwrt, Gd^Ftd, Dd^Ft, Dd^Ftd, Hd^Fts, Dd^Fts, Ds^Ftd, Ds^Esd, Ds^Edpp, Wo
Xu, Xu, Mm^Xm, Mm^Xm, Mm, Mm, Hh^Fts, Hh^Ftp, Mm^Xm, Mm^Xm, Mm, Mm, Mm, Mm, Wo, Wo, Wo, Wo, Wo, Mm^Xm, Wo, Wo, Wo, Mm^Xm, Wo, Xu, Xu, Uu^Em, Uu^Emf, Wwg^Edb, Uu^Edb, Wwg, Ww^Edb, Wo^Edb, Wo, Mm^Xm, Mm^Xm, Wo, Wo, Wo, Ds, Wwrt, Rd, Rd^Es, Dd^Ftd, Dd^Ftp, Gd^Ft, Gd, Gs^Ftd, Gs^Ftd, Gd^Em, Gd, Gs^Ftd, Rd^Es, Rd^Es, Dd^Ftd, Ds^Fts, Dd^Edpp, Ds^Fts, Ds^Edpp, Wwt^Ewl, Ds, Wo
Xu, Wo, Wo, Mm, Hh^Fts, Mm^Xm, Wo, Hh^Fts, Wo, Mm^Xm, Wo, Mm, Wo, Wo, Wo, Wo, Mm^Xm, Wo, Wo, Wo, Wo, Wo, Wo, Wo, Wo, Xu, Xu, Xu, Xu, Uu^Uf, Xu, Xu, Wo^Edb, Wo^Edb, Ww^Edb, Wo, Wo, Wo, Wo, Wwt, Wwt, Wwrt, Dd, Rd^Fts, Dd, Dd^Fts, Gd^Ftp, Gs^Vc, Dd, Gd^Ftd, Gs^Fts, Gs^Ft, Gd^Ft, Rd, Dd^Vda, Rd^Ftd, Ds^Ftp, Dd^Esd, Ds^Esd, Wwt^Ewl, Wwrt, Wo, Wo
Wo, Wo, Mm, Hh^Em, Hh, Hh^Fts, Wo, Wo, Hh, Hh^Ftd, Wo, Wo, Wo, Mm^Xm, Wo, Wo, Wo, Wo, Wo, Wo, Wwrt, Wo, Ds, Wo, Wwt, Wo, Wo, Xu, Wo, Xu, Xu, Wo, Ww, Wo, Wo, Wo, Mm^Xm, Wo, Wo, Wo, Wo, Dd^Fts, Dd^Esd, Dd^Esd, Dd, Gd^Ft, Dd^Fts, Dd^Esd, Dd^Esd, Dd, Rd^Ftd, Gs^Ftp, Gd^Ftd, Gd^Em, Rd^Ftd, Ds^Ftd, Ds^Ftd, Ds^Ftd, Ds^Edpp, Ds, Wwrt, Wo, Wwt
Wo, Wo, Mm^Xm, Mm, Hh^Ftd, Wo, Mm^Xm, Wo, Hh^Ftd, Mm^Xm, Hh, Wo, Wo, Wo, Wo, Wo, Wo, Wo, Wo, Wwt^Ewl, Rd, Gd^Ftp, Ds^Edp, Ds^Edp, Wwt^Ewf, Wwrt, Wo, Wo, Wo, Xu, Ww, Ww^Edb, Wo, Mm^Xm, Ww, Wo, Ww, Wo, Wo, Wo, Wo, Wwt, Wwt, Ds^Edpp, Dd, Dd^Fts, Ds, Dd, Rd^Fts, Rd, Rd^Ftp, Gd^Ftd, Gd^Em, Rd, Ds^Esd, Ds, Wwrt, Ds, Ds^Ftd, Wwt, Wo, Wwrt, Wwt
Wo, Mm^Xm, Mm^Xm, Mm^Xm, Mm, Wo, Wo, Mm^Xm, Wo, Wo, Hh^Ftd, Mm^Xm, Wo, Wo, Wo, Mm^Xm, Mm^Xm, Wo, Wwt, Gd^Es, Gd^Vh, Rd^Esd, 2 Kh, Rd, Rd^Esd, Gd^Ftp, Gs^Ftp, Wo, Wo, Wo, Wwt^Edb, Ww, Ww^Edb, Ww, Ww, Wo, Wo, Wo, Wo, Wo, Wo, Wo, Wwt, Ds, Ds^Esd, Dd^Esd, Ds, Ds, Ds, Rd^Ftp, Ds^Ftd, Gd^Edpp, Ds^Ftp, Gd^Fts, Ds, Wwt^Ewf, Wwrt, Ds^Esd, Ds, Wwt, Wwrt, Wo, Wo
Wo, Wo, Wo, Mm, Wo, Wo, Wo, Wo, Wo, Wo, Wo, Hh, Wo, Wo, Wo, Mm^Xm, Wo, Wo, Wo, Ds^Edp, Rd^Edp, Ch, Ch, Ch, Gd, Gs^Ftp, Gd^Em, Wo, Wo, Wwt, Gd^Fts, Ds, Ds^Edp, Ww^Ewl, Ds^Esd, Ww, Wo, Wo, Ww, Wo, Wo, Wo, Wo, Wwt, Wwt, Wwt, Wwt, Ds^Fts, Ds^Esd, Ds^Ftd, Ds^Esd, Ds, Ds^Edpp, Wwt^Ewf, Wwrt, Wwt^Ewl, Ww^Ewl, Wwt, Wo, Wwt, Wwrt, Wo, Wo
Wo, Wo, Wo, Wo, Wo, Wo, Wo, Wo, Wo, Wo, Mm^Xm, Wo, Wo, Wo, Wo, Wo, Wo, Wo, Ds, Ds^Esd, Gd^Ftp, Gd^Em, Gs, Gd^Es, Wo, Wwt, Wwt, Wwt^Bw\, Wwt^Bw\, Wwt, Gd, Rd, Rd^Edp, Gd^Vda, Ds^Edp, Wwt, Ww, Ww, Ww, Wo, Mm^Xm, Wo, Wo, Wo, Wo, Wo, Wwt, Ds, Ds^Esd, Ds, Wwt^Ewl, Ds, Wwrt, Wwrt, Ds, Wo, Wo, Wo, Wo, Wo, Wo, Wo, Wo
Wo, Wo, Wo, Wo, Wo, Wo, Wo, Wo, Wo, Wo, Wo, Wo, Wo, Mm^Xm, Wo, Wo, Wo, Wo, Wo, Wo, Wo, Wwt^Ewl, Gs^Em, Gs, Wo, Wo, Wwrt, Wwt, Wwt^Ewl, Gs, 5 Kh, Rd^Es, Gd^Ftp, Rd^Esd, Wwt, Wwt, Mm^Xm, Wwrt, Ww, Wo, Wo, Wo, Wo, Wo, Wo, Wo, Wo, Wwt, Wwt, Ds, Wwt, Wwt, Wwt, Wwrt, Ds, Wo, Wo, Wo, Wo, Wo, Wo, Wo, Wo
Wo, Wo, Wo, Wo, Wo, Wo, Wo, Wo, Wo, Wo, Wo, Wo, Wo, Wo, Wo, Wo, Wo, Wo, Wo, Wo, Wo, Wwt, Wwt^Bw|, Wo, Wo, Wo, Wwrt, Wwt, Gd^Es, Gs^Fts, Ch, Ch, Ds^Esd, Wwt^Ewl, Wwrt, Wwrt, Mm^Xm, Mm^Xm, Wwt, Wo, Wo, Wo, Wo, Wo, Wo, Wo, Wo, Wwt, Wwt, Wwt, Wo, Wwrt, Wo, Wwt, Wwt, Ds, Wwt, Wo, Wo, Wo, Wo, Wo, Wo
Wo, Wo, Wo, Wo, Wo, Wo, Wo, Wo, Wo, Wo, Wo, Wo, Wo, Wo, Wo, Wo, Wo, Wo, Wwt, Wo, Wo, Wo, Wwt^Bw|, Wwt, Wwt^Ewl, Wwrt, Wwrt, Wwrt, Wwt, Rd, Gd^Es, Ds^Edpp, Ds^Esd, Wwt, Wwt, Wwrt, Wwt, Wwt, Wwt, Wwt, Wwt, Ds^Edp, Ds^Esd, Wwt, Wo, Wo, Wo, Wo, Wo, Wo, Wo, Wo, Wo, Wo, Wo, Wo, Wo, Wo, Wo, Wo, Wo, Wo, Wo
Wo, Wo, Wo, Wo, Wo, Wo, Wo, Wo, Wo, Wo, Wo, Wo, Wo, Wo, Wwt, Wo, Wwrt, Wo, Wwt, Wwt, Wwt, Wwt, Gs^Em, Rd^Esd, Ch, Gd^Es, Rd^Esd, Wwrt, Wwt, Wwrt, Wwrt, Wwrt, Wwt, Wwt, Gd^Es, Wwt, Ds^Esd, Wwt, Ww^Bw/, Ds, Ds^Esd, Ds^Fts, Wwt, Wwt, Wwt, Ds, Ds^Edpp, Wo, Wo, Wo, Wo, Wo, Wo, Wo, Wo, Wo, Wo, Wo, Wo, Wo, Wo, Wo, Wo
Wo, Wo, Wo, Wo, Wo, Wo, Wo, Wo, Wo, Wo, Wo, Wo, Wo, Wo, Wwrt, Wwt, Wwt, Wwt^Ewf, Wwt^Ewl, Ds, Wwt^Ewl, Wwrt, Wwt, Gd^Es, Ch, Ch, Ds^Esd, Wwrt, Wwt, Wwt^Ewl, Wwt, Wwt, Rd^Edpp, Rd^Es, Gd^Edp, Gd^Ftd, Ds^Esd, Ds^Edpp, Wwt, Wwt, Wwt^Ewl, Ds^Esd, Ds, Ds^Esd, Wwt^Ewl, Wwt, Wwrt, Wwrt, Wo, Wo, Wo, Wo, Wwt, Wo, Wo, Wo, Ds, Wo, Wwt, Wo, Wo, Wo, Wo
Wo, Wo, Wo, Wo, Wo, Wo, Wo, Wo, Wo, Wo, Wo, Wo, Wo, Wwt, Wwrt, Wwrt, Wwt, Wwt^Ewl, Gd^Es, Ds^Esd, Ds^Edp, Wwr, Wwr, Ds^Edpp, Ww, Rd, Ds^Edpp, Wwt, Ww, Ds^Esd, Wwt, Wwt^Ewl, Rd^Vh, Rd, Rd^Es, Rd, Wwt^Ewl, Ds, Wwrt, Wwrt, Wwt, Gd^Ftd, Ds^Edp, Ds^Fts, Ds, Wwt^Ewl, Ds^Edpp, Wwrt, Wwrt, Wo, Wo, Wwt, Wwt, Wwt, Wwrt, Wwrt, Ds, Ds^Esd, Wwt, Wo, Wo, Wo, Wo
Wo, Wo, Wo, Wo, Wo, Wo, Wwrt, Wo, Wo, Wo, Wwrt, Wo, Wo, Wo, Wo, Wwt, Ds^Esd, Gd^Vh, Gd^Es, Rd, Ww^Ewl, Wwr, Wwr, Ww, Wwg^Ewl, Wwt, Wwrg, Ww, Ww, Wwt, Wwr, Wwt, Wwrt, Gd^Es, Rd, Ds^Esd, Ds, Wwrt, Wwrt, Ds^Ftd, Wwt, Gd^Fts, Ds, Ds^Edp, Wwt, Wwrt, Wwrt, Wwrt, Wo, Ds^Esd, Wwrt, Wwrt, Wwrt, Ds^Esd, Ds, Wwrt, Wwt, Wo, Wo, Wo, Wo, Wwt, Wo
Wo, Wo, Wo, Wo, Wo, Wo, Wwt, Wwrt, Ds^Edpp, Wwrt, Wwt^Ewf, Ds^Esd, Ds, Wo, Wwt, Wwrt, Wwt^Ewl, Gd, Ch, Rd^Edp, Rd^Es, Ww, Wwg, Ww, Sm^Em, Wwrg, Wwrg, Ds^Edpp, Ww, Ww, Ds^Edpp, Wwrt, Wwrt, Gd^Ftd, Gd^Ftd, Ch, Ds^Esd, Wwt, Wwt, Wwt, Ds^Fts, Ds^Esd, Dd^Dc, Gd^Fts, Dd^Ftd, Wwt, Wwt^Ewf, Wwt, Wwt, Wo, Wwt, Ds^Edpp, Ds, Ds^Fts, Wwrt, Ds^Esd, Wwt, Wo, Wo, Wwt, Ds^Edp, Wwt, Ds^Esd
Wo, Wo, Wo, Wo, Wo, Wwrt, Wwrt, Ds, Wwt, Wwt, Wo, Wwt, Wwt^Ewl, Wwrt, Wwrt, Wwt, Ds^Esd, 6 Kh, Ch, Rd, Gd, Ww, Wwg^Ewl, Sm, Gll^Vht, Ss, Gll^Ftp, Wwg, Wwrg, Ww, Ds^Esd, Ds, Ww, Wwt, Wwt, Rd, Wwt, Wwt, Ds^Esd, Wwt, Ds^Ftd, Rd, Rd^Vda, Dd^Ftp, Ds^Esd, Wwt^Ewl, Ds, Wwt^Ewl, Ds^Esd, Wwt, Ds^Fts, Ds^Fts, Rd^Ftd, Ds^Esd, Wwt^Ewl, Wwt, Ds^Esd, Wo, Wwt, Ds, Ds^Esd, Ds^Edp, Ds
Wo, Wo, Wo, Wo, Wwt, Wwt^Ewl, Wo, Wo, Wwrt, Wwrt, Wo, Wwrt, Wwrt, Wwrt, Wwt, Ds^Esd, Ds^Edp, Ds^Edp, Ds, Ds^Esd, Ds^Esd, Ww^Ewl, Wwg, Wwg, Rb, Gll^Emf, Rb, Gll^Em, Sm, Wwrg, Ww, Wwr, Ww, Wwt, Ds^Esd, Wwt, Wwrt, Ch, Ds^Esd, Wwt, Wwt, Dd^Ft, Rd, Rd, Dd^Fts, Ds^Edp, Gd^Ftd, Ds^Edp, Dd^Esd, Ds^Edp, Rd, Rd, Wwt^Ewl, Ds, Ds^Edpp, Ds^Esd, Ds^Fts, Wwt, Wwt, Wwt^Ewf, Wwrt, Wwrt, Ds
Wo, Wo, Wo, Wo, Wwt, Ds^Edpp, Wo, Wo, Wo, Wo, Wo, Wo, Wwt, Wwt^Ewf, Wwt, Wwt, Wwt, Wwt, Ww^Ewl, Wwr, Wwrg, Ww^Bw\, Ww^Bw\, Sm^Em, Gd^Es, Rb^Em, Gll^Ft, Ss, Sm^Em, Sm, Wwrg, Ww, Ww, Ww, Wwt, Ds^Esd, Wwt, Wwrt, Wwt, Wwt, Ds^Ftp, Dd^Ftd, Gs^Fts, Rd, Gs^Ft, Dd^Ftd, Dd^Ftp, Dd^Ftp, Dd, Ds^Esd, Dd, Rd^Ft, Wwt^Ewf, Wwt, Ds, Wwt^Ewl, Wwt, Wwt, Ds, Wwrt, Dd^Fts, Wwrt, Wwt
Wo, Wo, Wo, Wo, Wwrt, Wwrt, Wwrt, Wo, Wo, Wo, Wo, Wo, Wo, Wo, Wo, Wo, Ww, Wwt^Ewl, Wwt^Ewf, Wwr, Ww, Wwrg, Wwg, Gll, Gll^Ft, Gll^Em, Gll^Ft, Gll^Ftr, Ss^Emf, Wwrg, Ww^Bw/, Ww, Gll^Ftd, Ds^Esd, Ds^Ftd, Wwt, Wwt, Wwt, Wwt, Wwt, Wwt, Rd, Gs^Fts, Rd, Gd^Em, Gs^Fts, Dd^Esd, Dd^Vda, Dd^Edp, Ds^Ftd, Gd^Ft, Wwt^Ewl, Ds, Gd^Fts, Gd^Ftp, Ds^Ftd, Ds, Ds^Fts, Dd^Ftd, Ds^Edpp, Dd, Wwt^Ewl, Rd^Ftp
Wo, Wo, Wo, Wwrt, Wwrt, Wwt^Ewl, Ds^Esd, Wwt, Wwrt, Wo, Wo, Wo, Wo, Wo, Wo, Wo, Wwt, Wwt, Ww, Wwt, Wwr, Wwrg, Sm, Sm^Em, Ss^Em, Sm^Em, Ch, Ss^Uf, Ss^Bw/, Rb^Em, Sm^Em, Sm^Bw\, Gll^Es, Gd^Edp, Ds^Esd, Gd^Edp, Gd^Es, Gd^Ftd, Rd^Vc, Wwt, Ds^Esd, Rd, Rd, Gd^Ft, Gd^Fts, Gs^Fts, Rd, Dd^Edp, Gd^Fts, Gs^Fts, Gs^Em, Gd^Em, Ds^Esd, Dd^Fts, Dd^Ft, Dd^Ftd, Dd^Ftp, Ds^Fts, Dd^Ftd, Ds^Esd, Gd, Dd^Esd, Gd^Fts
Wo, Wo, Wo, Wo, Wo, Wwt, Wo, Wwt, Wo, Wo, Wo, Wo, Wo, Wo, Wo, Wwrt, Wwrt, Ds, Ds, Ww, Ww, Wwr, Wwg, Sm^Em, Wwg, Ss^Emf, Rb, Rb^Em, Ss, Wwrg, Ss, Ss, Sm^Vm, Gd, Gd^Ftd, Gll^Em, Gll^Ft, Rd^Fts, Rd^Ftd, Gs^Edp, Gd^Fts, Ds^Esd, Gd^Fts, Gd^Ft, Gd^Ft, Rd, Dd^Esd, Dd^Ftd, Dd^Ftd, Dd^Ftd, Gd^Ft, Gd^Fts, Gs^Ftd, Gs^Ftd, Gs^Em, Gs^Ftp, Gd^Ftp, Gd^Ft, Gd^Fts, Hd^Fts, Hd^Fts, Gd^Ftd, Dd^Ftd
Wo, Wo, Wo, Wo, Wo, Wo, Wo, Wwrt, Wo, Wwrt, Wo, Wo, Wo, Wo, Wo, Wo, Wwrt, Ww, Ww, Ww, Wwr, Wwr, Ds^Ftd, Wwg, Wwrg, Ss, Wwrg, Ww^Bw\, Ww^Bw|, Wwrg, Wwg, Sm, Ss, Gll^Ft, Gll^Ft, Gll^Ft, Gll^Em, Gs^Fts, Rd^Fts, Gs^Ft, Gs^Ft, Rd^Fts, Gs^Ftp, Gs^Fts, Gd^Ft, Gs^Fts, Gd^Fts, Dd^Ftp, Dd^Ftd, Dd^Ft, Dd^Ft, Dd^Esd, Dd^Ft, Gs^Ft, Gd^Em, Gd^Ft, Gs^Fts, Gd^Edpp, Dd^Esd, Dd, Dd^Esd, Dd, Dd^Esd
Wo, Wo, Wo, Wo, Wo, Wo, Wo, Wo, Wo, Wo, Wo, Wo, Wo, Wo, Wo, Wo, Ds, Wwt^Ewl, Ww, Wwrt, Ww, Ds^Edp, Ds^Esd, Gd, Gd^Edp, Ds^Ftd, Ds^Edp, Wwrg, Ww^Bw|, Wwg, Ss, Sm, Rb^Em, Wwg, Rb^Em, Gll^Ft, Gll^Em, Gs^Edpp, Gs^Fts, Rd, Rd^Ftp, Dd^Fts, Dd^Ftp, Gs^Ftp, Dd^Fts, Gs^Ft, Rd^Ft, Gd^Ftp, Dd^Ftd, Rd^Ftp, Dd^Fts, Gd^Ft, Gd^Ft, Gs^Ft, Hhd^Ft, Gd^Ft, Gs^Ftp, Gd^Fts, Dd^Ftd, Hd^Ftd, Hd, Hd^Ftd, Dd
Wo, Wo, Wo, Wo, Wo, Wo, Wo, Wo, Wo, Wo, Wo, Wo, Wo, Wo, Wo, Ds, Ds^Esd, Wwt, Ds, Wwt^Ewl, Ww, Gd^Es, Gd^Ftp, Gd^Ftd, Gd^Em, Gd, Gd^Edp, Gd, Gd, Gll^Ft, Gll^Ft, Ss, Gll^Ftr, Wwg, Ss, Ss^Vhs, Gs^Ft, Gd^Fts, Gd^Edp, Gd^Fts, Dd^Ftd, Ds, Ds^Ftd, Ds, Dd^Ftd, Dd^Ftd, Dd^Ftd, Rd^Ftp, Dd, Dd^Ftd, Rd^Es, Rd^Ftd, Hd^Ftd, Hhd^Ftp, Hhd^Ftp, Rd^Ftp, Gd^Ftp, Dd^Ftd, Rd^Es, Hd^Ftd, Mdd, Hd^Fts, Hd^Ftp
Wo, Wo, Wo, Wo, Wo, Wo, Wo, Wo, Wo, Wo, Wo, Wo, Wo, Wwrt, Wwrt, Wo, Wwt, Ww, Ww, Wwr, Wwrg, Wwrg, Gll^Em, Gll^Ftd, Gll^Ftp, Gll^Ftd, Gll^Em, Gll^Ftd, Gll^Em, Gll^Em, Gll^Ftp, Gll^Ftr, Gll^Ftr, Gll^Ftr, Ss, Gll^Em, Gll^Em, Gd^Ftd, Rd^Es, Rd, Rd^Es, Dd^Edp, Ds, Ds^Esd, Dd, Dd, Dd^Esd, Dd, Dd^Fts, Dd^Edp, Rd^Es, Dd^Esd, Hd^Ftd, Mdd, Mdd, Hhd^Ft, Gd^Ft, Dd, Rd, Dd, Mdd, Mdd, Mdd
Wo, Wo, Wo, Wo, Wo, Wo, Wo, Wo, Wwt, Wwt^Ewl, Wwrt, Wwrt, Wwt, Wwt^Ewl, Wwrt, Wwrt, Wwt, Wwr, Ww, Wwrg, Wwg, Wwg, Sm, Gll^Ftp, Gll^Ftr, Gll^Ftp, Gll^Ftd, Sm^Emf, Sm, Gll^Ftr, Wwg, Gll^Ftp, Gll^Ftr, Gll^Ftd, Gll^Em, Gll^Ftd, Gd^Fts, Rd^Fts, Dd^Ftd, Dd, Dd^Esd, Rd, Dd, Dd, Dd^Esd, Dd^Edp, Dd^Esd, Dd^Edp, Dd, Rd, Rd^Es, Dd^Fts, Ds, Ds, Dd, Hhd^Ftd, Rd^Ftd, Gd^Ftd, Gd^Fts, Mdd, Mdd, Mdd, Mdd
Wo, Wo, Wo, Wwt, Wwrt, Wo, Ds^Fts, Wo, Wo, Wo, Ds, Wwrt, Wwt, Wwt, Wwt, Ww, Ww^Ewl, Ww, Wwrg, Sm, Ss, Ss^Ftr, Ss^Ftr, Sm, Ss^Emf, Ss^Uf, Ss^Uf, Sm, Ss^Emf, Wwg^Em, Gll^Vht, Wwg^Ewl, Gll^Ftd, Gll^Ftd, Gd^Ftp, Gd^Ftd, Rd^Ftp, Dd^Ftd, Dd, Dd^Edp, Dd^Esd, Hd^Ftd, Dd, Dd^Edp, Dd^Esd, Dd, Hd, Rd, Dd^Esd, Ds^Vdt, Ds, Dd, Hd^Ftd, Hd^Edp, Hd, Dd^Ftd, Rd, Gd^Fts, Mdd, Hd^Edp, Hd, Mdd, Mdd
Wo, Wo, Wo, Wo, Wwrt, Wwrt, Wwt, Wo, Wo, Ds^Esd, Ds^Ftd, Wwt, Ds^Esd, Wwt, Gd^Ftd, Gd^Ftp, Gll^Ftp, Gll^Ftp, Sm, Sm^Em, Sm^Em, Ss, Sm, Ss, Wwg^Ewl, Sm^Em, Gll^Ftr, Gll^Ftr, Ss, Gll^Ftr, Gll^Ftr, Gll^Em, Gll^Em, Gd^Ftd, Gd^Fts, Gd^Ftp, Dd^Ftd, Dd, Dd^Ftp, Dd^Ftd, Dd^Ftd, Dd, Ds^Ftd, Dd, Dd, 1 Hd, Hd^Esd, Rd^Es, Ds, Ds, Hd^Ftd, Dd, Rd, Mdd, Dd^Edp, Dd, Mdd, Rd^Es, Hd, Mdd, Hd^Ftd, Mdd, Mdd
Wo, Wo, Ds, Wo, Wwt, Wwrt, Ds^Ftd, Wwt, Wwt, Wwt^Ewl, Wwt, Wwt, Ds^Esd, Ds^Edp, Gd^Ftp, Gll^Em, Gll^Ft, Gll^Ft, Gll^Ftr, Sm^Emf, Gll^Uf, Gll^Ft, Gll^Ftr, Gll^Ftr, Gll^Ftr, Gll^Emf, Sm^Em, Gs^Ft, Sm^Em, Gll^Ft, Rd^Ft, Gll^Ft, Gd^Ftd, Gd^Fts, Gd^Em, Gd^Ftp, Dd^Ftd, Dd^Edp, Hd, Hd^Fts, Hd, Dd, Dd^Vdt, Ds, Ds, Hd^Esd, Hd, Hd^Fts, Rd, Ds, Hd, Hd^Ftd, Mdd, Rd^Edp, Mdd, Hd, Hd^Ftd, Rd^Es, Mdd, Hd^Edp, Mdd, Mdd, Mdd
Wo, Wo, Wwt, Wwt^Ewl, Wwrt, Ds^Esd, Wwt, Wwt, Ds^Ftd, Gd^Ftp, Wwt, Ds^Ftd, Gd^Edp, Ds^Ftd, Ds^Esd, Gll^Edp, Gll^Ftd, Gll^Ftr, Gll^Ft, Gll^Ftr, Wwrg, Gll^Em, Gs^Ft, Gs^Ft, Gll^Ftr, Sm, Gll^Ftr, Ss, Gll^Ft, Sm, Gll^Ftr, Gd^Fts, Gd^Em, Gd^Ftd, Gd^Ftd, Dd, Gd^Ftd, Hd^Ftp, Hd^Fts, Hd, Rd^Fts, Dd, Dd, Ds, Hd, Hd^Esd, Hd^Fts, Hd, Hd, Mdd, Ds, Hd^Ftp, Mdd, Mdd, Mdd, Mdd, Mdd, Dd^Fts, Dd, Dd^Edp, Hd^Ftd, Mdd, Mdd
Wo, Wo, Wo, Wo, Wwt, Wwrt, Wwt, Ww^Ewl, Gs^Ftp, Wwt, Wwt, Wwt, Gd^Ft, Gd, Gd^Edp, Gll^Ftd, Gs^Ft, Gll^Emf, Gll^Ft, Wwg, Wwg, Gll^Ft, Gs^Ft, Gll^Ftr, Gs^Ft, Gll^Ft, Gs^Ft, Ss, Gs^Ft, Gll^Ftr, Gs^Ftp, Rd^Ftp, Gd^Ftp, Gd, Gd^Ftd, Gd^Ftd, Gd^Ftd, Dd^Ftd, Hd, Hd^Fts, Hd, Rd^Es, Dd, Dd^Ftd, Hd, Hd^Fts, Hd, Hd, Hd, Mdd, Ds, Mdd, Hd, Mdd, Hd, Mdd, Mdd, Hd, Dd, Rd, Rd, Hd^Ftd, Dd
