Wot, Wot, Wot, Wot, Wot, Wot, Wot, Wot, Wot, Wot, Wot, Wot, Wot, Wot, Wot, Wot, Wot, Wot, Wot, Wot, Wot, Wot, Wot, Wot, Wot, Wot, Wot
Wot, Wot, Wot, Wot, Wot, Wot, Wot, Wot, Wot, Wot, Wot, Wot, Wot, Wot, Wot, Wot, Wot, Wot, Wot, Wot, Wot, Wot, Wot, Wot, Wot, Wot, Wot
Wot, Wot, Wot, Wot, Wot, Wot, Wot, Wot, Wot, Wot, Wot, Wot, Wot, Wot, Wot, Wot, Wot, Wot, Wot, Wot, Wot, Wot, Wot, Wot, Wot, Wot, Wot
Wot, Wot, Wot, Wot, Wot, Wot, Wot, Wot, Wot, Wot, Wot, Wot, Wwt, Wot, Wot, Wot, Wot, Wot, Wot, Wot, Wot, Wot, Wot, Wot, Wot, Wot, Wot
Wot, Wot, Wot, Wot, Wwt, Wot, Wwt, Wot, Wwt, Wwt, Ds, Wot, Wwrt, Wwt, Wot, Wot, Wot, Wot, Wot, Wot, Wot, Wot, Wot, Wot, Wot, Wot, Wot
Wot, Wot, Wot, Wot, Wwt, Wwt, Ds^Edp, Wwt, Wwt, Ds, Wwrt, Wwt, Wwt^Vm, Wwrt, Wwt, Wot, Wot, Wot, Wot, Wot, Wot, Wot, Wot, Wot, Wot, Wot, Wot
Wot, Wot, Wot, Wot, Wot, Wwt, Ds, Ds, Wwt, Wwt, Wwt, Wwrt, Wwt, Wwrt, Wwt, Wot, Wot, Wot, Wot, Wot, Wot, Wot, Wot, Wot, Wot, Wot, Wot
Wot, Wot, Wot, Wot, Wot, Wwt, Wwrt, Wwt, Wwrt, Wwt^Ewl, Wwt, Wwt^Ewf, Wwt, Wwt, Ds, Wwt, Wwrt, Wwt, Wwrt, Wot, Wot, Wot, Wot, Wot, Wot, Wot, Wot
Wot, Wot, Wot, Wot, Wwt, Wot, Wwt, Wwrt, Wwrt, Ds^Esd, Dd^Ftd, Wwt, Wwt^Ewl, Wwt, Wwt, Ds^Edp, Wwt^Ewf, Wwrt, Wwrt, Wot, Wwrt, Wot, Wot, Wot, Wot, Wot, Wot
Wot, Wot, Wot, Wot, Wwt, Wwrt, Wwrt, Wwrt^Vm, Wwrt, Ds^Edp, Ds^Esd, Ds^Ftd, Wwt^Ewl, Wwt^Ewf, Wwt, Wwt^Vm, Wwt, Wwrt, Wwt, Wwt^Vm, Wwrt, Wwrt, Wot^Ewl, Wot, Wot, Wot, Wot
Wot, Wot, Wot, Wwt, Wot, Wwrt, Wot, Wwt, Wwt^Ewl, Ds^Esd, Ds, Ds, Ds^Ftd, Ds^Ftd, Ds^Edp, Wwt, Ds^Ftd, Wwt^Ewl, Wwt^Ewl, Wwt, Wwt^Ewf, Wot, Wot, Wot, Wot, Wot, Wot
Wot, Wot, Wot, Wot, Wot, Wot, Wwt, Wwt, Wwt^Ewf, Wwt^Ewl, Ds^Ftd, Ds^Edp, Ds, Ds^Do, Ds, Ds^Esd, Ds^Edpp, Ds, Ds^Ftd, Wwt, Wwt^Ewf, Wwt^Ewl, Wot, Wot, Wot, Wot, Wot
Wot, Wot, Wot, Wot, Wot, Wot, Wwt, Wwt^Ewl, Wwrt, Wwt^Ewl, Wwrt, Ds, Ds^Esd, Ds, Ds, 2 Ds, Ds, Ds^Esd, Ds^Esd, Wwt^Ewf, Wwt, Wwt, Wwt, Wot, Wot, Wot, Wot
Wot, Wot, Wot, Wot, Wot, Wwt, Wwt, Wwrt, Wwrt, Wwrt^Vm, Wwrt, Ds, Ds^Esd, Ds, 1 Ds, Ds, Ds, Ds^Esd, Ds^Esd, Ds^Ftd, Wwt^Ewf, Wwt, Wwt, Wot, Wot, Wot, Wot
Wot, Wot, Wot, Wot, Wot, Wot, Wot, Wot, Wwrt, Wwrt, Wwt, Wwrt, Ds^Ftd, Ds^Esd, Ds, Ds, Ds^Esd, Ds^Esd, Ds, Wwt^Ewl, Wwt, Ds^Edp, Wwt, Wwt, Wwt^Ewl, Wot, Wot
Wot, Wot, Wot, Wot, Wot, Wot, Wot, Wot, Wot, Wot, Wwt, Wwrt, Wwrt, Ds^Ftd, Ds^Edp, Ds^Edpp, Ds^Ftd, Ds^Edp, Ds, Ds^Ftd, Wwt, Wwt^Vm, Wwrt, Wwt^Ewl, Ds^Esd, Wot, Wot
Wot, Wot, Wot, Wot, Wot, Wot, Wot, Wot, Wot, Wot, Wot, Wwt, Wwt^Ewf, Wwt^Ewl, Wwt^Ewf, Wwt^Ewl, Wwt^Ewl, Ds^Ftd, Wwt^Ewl, Ds, Ds, Wwt, Wwrt, Wot, Wwt, Wwt, Wot
Wot, Wot, Wot, Wot, Wot, Wot, Wot, Wot, Wot, Wot, Wot, Wot, Wot^Ewf, Wwt^Ewl, Wwt, Wwrt, Wwrt, Wwt, Wwt, Wwt, Wwrt, Wwrt, Ds, Wot, Wot, Wwt, Wot
Wot, Wot, Wot, Wot, Wot, Wot, Wot, Wot, Wot, Wot, Wot, Wot, Wot, Wwt, Wot, Wwrt, Wot, Wwt, Wot, Wwt, Wwrt, Wwrt, Ds^Edp, Ds^Esd, Wot, Wot, Wot
Wot, Wot, Wot, Wot, Wot, Wot, Wot, Wot, Wot, Wot, Wot, Wot, Wot, Wot, Wot, Wot, Wot, Wot, Wot, Wot, Wwt, Wwt, Wwt, Wwt, Wot, Wot, Wot
Wot, Wot, Wot, Wot, Wot, Wot, Wot, Wot, Wot, Wot, Wot, Wot, Wot, Wot, Wot, Wot, Wot, Wot, Wot, Wot, Wot, Wot, Wot, Wot, Wot, Wot, Wot
Wot, Wot, Wot, Wot, Wot, Wot, Wot, Wot, Wot, Wot, Wot, Wot, Wot, Wot, Wot, Wot, Wot, Wot, Wot, Wot, Wot, Wot, Wot, Wot, Wot, Wot, Wot
Wot, Wot, Wot, Wot, Wot, Wot, Wot, Wot, Wot, Wot, Wot, Wot, Wot, Wot, Wot, Wot, Wot, Wot, Wot, Wot, Wot, Wot, Wot, Wot, Wot, Wot, Wot
Wot, Wot, Wot, Wot, Wot, Wot, Wot, Wot, Wot, Wot, Wot, Wot, Wot, Wot, Wot, Wot, Wot, Wot, Wot, Wot, Wot, Wot, Wot, Wot, Wot, Wot, Wot
Wot, Wot, Wot, Wot, Wot, Wot, Wot, Wot, Wot, Wot, Wot, Wot, Wot, Wot, Wot, Wot, Wot, Wot, Wot, Wot, Wot, Wot, Wot, Wot, Wot, Wot, Wot
Wot, Wot, Wot, Wot, Wot, Wot, Wot, Wot, Wot, Wot, Wot, Wot, Wot, Wot, Wot, Wot, Wot, Wot, Wot, Wot, Wot, Wot, Wot, Wot, Wot, Wot, Wot
Wot, Wot, Wot, Wot, Wot, Wot, Wot, Wot, Wot, Wot, Wot, Wot, Wot, Wot, Wot, Wot, Wot, Wot, Wot, Wot, Wot, Wot, Wot, Wot, Wot, Wot, Wot
