Wot, Wot, Wot, Wot, Wot, Wot, Wot, Wot, Wot, Wot, Wot, Wot, Wot, Wot, Wot, Wot, Wot, Wot, Wot, Wot, Wot, Wot, Wot, Wot, Wot, Wot, Wot, Wot, Wot, Wot, Wot, Wot, Wot, Wot, Wot, Wot, Wot, Wot, Wot, Wot, Wot, Wot, Wot, Wot, Wot, Wot, Wot, Wot, Wot, Wot, Wot, Wot
Wot, Wot, Wot, Wot, Wot, Wot, Wot, Wot, Wot, Wot, Wot, Wot, Wot, Wot, Wot, Wot, Wot, Wot, Wot, Wot, Wot, Wot, Wot, Wot, Wot, Wot, Wot, Wot, Wot, Wot, Wot, Wot, Wot, Wot, Wot, Wot, Wot, Wot, Wot, Wot, Wot, Wot, Wot, Wot, Wot, Wot, Wot, Wot, Wot, Wot, Wot, Wot
Wot, Wot, Wot, Wot, Wot, Wot, Wot, Wot, Wot, Wot, Wot, Wot, Wot, Wot, Wot, Wot, Wot, Wot, Wot, Wot, Wot, Wot, Wot, Wot, Wot, Wot, Wot, Wot, Wot, Wot, Wot, Wot, Wot, Wot, Wot, Wot, Wot, Wot, Wot, Wot, Wot, Wot, Wot, Wot, Wot, Wot, Wot, Wot, Wot, Wot, Wot, Wot
Wot, Wot, Wot, Wot, Wot, Wot, Wot, Mm^Xm, Wwt, Wot, Mm^Xm, Wot, Mm^Xm, Wot, Wot, Wot, Wot, Wot, Wot, Wot, Wot, Wot, Wot, Wot, Wot, Wot, Wot, Wot, Wot, Wot, Wot, Wot, Wot, Wot, Wot, Wot, Wot, Wot, Wot, Wot, Wot, Wot, Wot, Wot, Wot, Wot, Wot, Ds, Wot, Wot, Wot, Wot
Wot, Wot, Wot, Wot, Wot, Wot, Wwt, Mm^Xm, Mm^Xm, Mm^Xm, Ds, Mm^Xm, Mm^Xm, Wot, Wot, Wot, Wot, Wot, Wot, Wot, Wot, Wot, Mm^Xm, Mm^Xm, Mm^Xm, Wot, Wot, Wot, Wot, Wot, Wot, Wot, Wot, Wot, Wwt, Wot, Wot, Wot, Wot, Wot, Wot, Wot, Wot, Wot, Wot, Wot, Wwt, Wwt, Wot, Wot, Wot, Wot
Wot, Wot, Wot, Wot, Wot, Wot, Wwt, Wwt, Mm^Xm, Ds, Ds, Ds, Wwt, Wwt, Wwt, Wot, Wwt, Wot, Wot, Wot, Wot, Wot, Wwt, Mm^Xm, Wot, Wot, Wot, Wot, Wot, Wot, Wot, Wot, Wot, Wwt, Hh, Wwt, Wot, Wot, Wot, Wot, Wot, Wot, Wot, Wot, Wot, Wot, Ds, Wwt, Wot, Wot, Wot, Wot
Wot, Wot, Wot, Wot, Wot, Wwt, Wwt, Mm^Xm, Mm^Xm, Ds, Ds, Ds, Wwt, Wwt, Mm^Xm, Wwf, Wwf, Wwt, Wwt, Wwt, Wwt, Wwf, Wwt, Wwt, Wot, Wot, Wot, Wot, Wot, Wot, Wot, Wot, Wwt, Hh, Hh, Hh, Hh, Hh, Wot, Wot, Wot, Wot, Wot, Wot, Wwt, Gs, Wwt, Wot, Wot, Wot, Wot, Wot
Wot, Wot, Wot, Wot, Wot, Wwt, Wwt, Wwt, Wwt, Wwt, Wwf, Wwt, Wwt, Wwt, Mm^Xm, Mm^Xm, Mm^Xm, Wwt, Wwt, Mm^Xm, Mm^Xm, Wwt, Wwt, Wwt, Wwt, Mm^Xm, Wot, Wot, Wot, Wot, Wot, Wot, Wwt, Hh, Hh, Mm, Hh, Hh, Wot, Wot, Wot, Wot, Wwt, Wwt, Gs, Wwt, Wwt, Wot, Wot, Wot, Wot, Wot
Wot, Wot, Wot, Wot, Wot, Wwt, Wwt, Wwt, Wwt, Wwt, Wwf, Wwt, Wwt, Wwf, Wwt, Wwt, Mm^Xm, Wwt, Wwt, Wwt, Wwf, Wwt, Mm^Xm, Mm^Xm, Wwf, Wot, Wot, Wot, Wot, Wot, Wot, Wot, Wot, Wwt, Hh, Hh, Hh, Wwt, Wot, Wot, Wot, Wot, Wwt, Gs, Gs, Gs, Wwt, Wot, Wot, Wot, Wot, Wot
Wot, Wot, Wot, Wot, Wot, Wot, Wwt, Mm^Xm, Wwt, Wwf, Wwt, Wwt, Wwt, Wwt, Wwt, Wwf, Wwf, Wwt, Wwt, Wwf, Wwt, Wwt, Mm^Xm, Mm^Xm, Wwt, Wot, Wot, Wot, Wot, Wot, Wot, Wot, Wot, Wot, Wot, Hh, Wot, Wot, Wot, Wot, Wot, Wwt, Gs, Gs^Vc, Gs, Wwt, Wot, Wot, Wot, Wot, Wot, Wot
Wot, Wot, Wot, Wot, Wot, Wwt, Mm^Xm, Mm^Xm, Mm^Xm, Mm^Xm, Wwt, Wwt, Mm^Xm, Wwf, Wwt, Wwt, Wwt, Wwt, Mm^Xm, Wwt, Wwt, Wwt, Wwt, Wwt, Wwt, Wot, Wwt, Wot, Wwt, Wot, Wot, Wot, Wot, Wot, Wot, Wot, Wot, Wot, Wot, Wot, Wot, Wwt, Gs, Gs, Ds, Wwt, Wot, Wot, Wot, Wot, Wot, Wot
Wot, Wot, Wot, Wot, Wwt, Wwf, Wwt, Wwt, Wwt, Wwt, Wwt, Wwt, Wwt, Wwt, Mm^Xm, Wwt, Ds, Wwf, Wwt, Wwt, Wwt, Wwt, Wwt, Wwf, Wwt, Wwt, Wwt, Wwt, Ds, Wwt, Wwt, Wot, Wot, Wot, Wot, Wot, Wot, Wot, Wwt, Wwt, Wwt, Wwt, Wwt, Wwt, Wwt, Wwt, Wot, Wot, Wot, Wot, Wot, Wot
Wot, Wot, Wot, Wot, Wwt, Wwt, Wwt, Wwf, Wwf, Wwt, Wwt, Wwt, Wwt, Mm^Xm, Wwf, Wwt, Wwt, Ds, Wwt, Wwt, Wwt, Wwf, Wwt, Wwt, Wwt, Wwf, Wwt, Wwt, Ds, Ds, Wwt, Wot, Wot, Wot, Wot, Wot, Wot, Wwt, Gs^Ft, Gs^Ft, Re, Re, Gs, Wwt, Wwt, Wot, Wot, Wot, Wot, Wot, Wot, Wot
Wot, Wot, Wot, Wot, Wwt, Mm^Xm, Mm^Xm, Mm^Xm, Wwt, Wwt, Wwf, Wwt, Wwt, Wwt, Wwt, Wwt, Wwt, Ds, Ds, Ds, Ds, Wwt, Ds, Wwt, Gs^Ft, Wwt, Hh, Wwt, Wwt, Ds, Wwt, Wwt, Wot, Wot, Wwt, Wwt, Wwt, Wwt, Gs^Ft, Gs, Ss, Re, Gs^Vc, Gs, Wwt, Wot, Wot, Wot, Wot, Wot, Wot, Wot
Wot, Wot, Wot, Wot, Wwf, Wwt, Wwt, Wwt, Wwt, Wwt, Mm^Xm, Wwt, Wwf, Wwt, Wwf, Wwf, Wwt, Wwt, Wwt, Ds, Ds^Es, Ds, Gs^Ft, Gs^Ft, Hh, Hh, Hh, Gs^Ft, Gs^Ftp, Wwt, Gs^Ft, Wwt, Wwt, Wwt, Gs^Ftp, Gs^Ftp, Gs^Ftp, Gs^Ft, Ss, Gs, Gs, Gs, Gs, Wwt, Wot, Wot, Wot, Wot, Wot, Wot, Wot, Wot
Wot, Wot, Wot, Wot, Mm^Xm, Wwt, Wot, Wwt, Ds, Wwt, Wwt, Wwt, Wwf, Wwt, Wwt, Mm^Xm, Mm^Xm, Wwt, Wwt, Ds, Hh, Hh, Hh, Hh, Mm, Hh, Mm, Hh, Hh, Gs^Ftp, Gs^Ftr, Gs^Ft, Gs^Ftr, Gs^Ftp, Gs^Ftr, Gs^Ftr, Gs^Ftr, Ss, Re, Gs^Vc, Ss, Ss, Gs, Wwt, Wot, Wot, Wot, Wot, Wot, Wot, Wot, Wot
Wot, Wot, Wot, Wot, Wot, Wot, Wot, Wot, Ds, Ds, Wwt, Wwt, Wwt, Wwt, Wwt, Wwt, Wwt, Wwt, Ds^Es, Ds, Hh, Hh, Hh, Mm, Mm^Es, Mm^Es, Mm^Es, Mm, Mm, Hh, Hh, Gs^Ftr, Hh, Hh, Gs^Ftr, Hh, Gs^Ft, Re, Gs, Gs, Ss, Ss, Hh, Gs, Wwt, Wot, Wot, Wot, Wot, Wot, Wot, Wot
Wot, Wot, Wot, Wot, Wot, Wot, Wot, Wot, Wot, Ds, Ds, Wwt, Ds, Wwt, Ds, Wwt, Wwt, Wwt, Ds, Hh, Hh, Hh, Mm, Mm^Es, Mm, Mm^Es, Xu, Mm^Es, Mm, Mm, Mm, Hh, Hh, Gs^Ftr, Gs^Ftr, Gs^Ftr, Gs, Ss, Gs, Hh, Ce, Gs, Gs, Gs, Ds, Wwt, Wot, Wot, Wot, Wot, Wot, Wot
Wot, Wot, Wot, Wot, Wot, Wot, Wot, Wot, Wot, Mm^Xm, Ds, Ds, Ds, Ds, Hh, Ds, Ds, Ds, Hh, Hh, Hh, Hh, Mm, Mm, Mm, Xu, Qxu, Xu, Mm, Mm, Mm, Hh, Gs^Ftr, Gs^Ftr, Gs^Vht, Gs^Ftr, Re, Gs, Gs, Ce, 4 Ket, Ce, Gs, Gs, Ss, Wwt, Wot, Wot, Wot, Wot, Wot, Wot
Wot, Wot, Wot, Wot, Wot, Wot, Wot, Wot, Wot, Wot, Wot, Ds, Ss, Hh, Hh, Hh, Hh, Ds, Hh, Hh, Hh, Hh, Hh, Mm, Mm, Xu, Xu, Xu, Mm, Mm, Mm, Hh, Gs^Ftr, Gs^Ftr, Gs, Gs, Ss, Ss, Gs, Ce, Ce, Ce, Gs, Ds, Ss, Wot, Wot, Wot, Wot, Wot, Wot, Wot
Wot, Wot, Wot, Wot, Wot, Wot, Wot, Wot, Wot, Wot, Wot, Ss, Hh, Hh, Hh, Hh, Hh, Hh, Hh^Vc, Hh, Hh, Hh, Hh, Mm, Mm, Mm, Re, Mm, Mm, Mm, Hh, Gs^Ftr, Gs^Ftr, Gs^Ftr, Ss, Ss, Ss, Ss, Ss, Gs, Re, Re, Ss, Ss, Ss, Wot, Wot, Wot, Wot, Wot, Wot, Wot
Wot, Wot, Wot, Wot, Wot, Wot, Wot, Wot, Wot, Wot, Ss, Ss, Hh, Hh, Hh, Hh, Hh, Hh, Hh, Hh, Hh, Hh, Hh, Mm, Mm, Mm, Mm, Mm, Mm, Mm, Hh, Gs^Vht, Gs^Ftr, Gs, Ss, Ss, Wot, Ss, Wot, Ss, Ss, Ss, Wwt, Ss, Wwt, Wot, Wot, Wot, Wot, Wot, Wot, Wot
Wot, Wot, Ds, Ds, Wwt, Wot, Wot, Wot, Wot, Wot, Ss, Hh, Hh, Hh, Hh^Vc, Hh, Hh, Hh, Hh, Hh, Hh, Hh, Hh, Hh, Hh, Mm, Mm, Mm, Mm, Mm, Hh, Gs^Ftr, Gs, Gs, Ss, Wot, Wot, Wot, Wot, Wot, Wot, Wot, Wot, Wwt, Wwf, Wwt, Wot, Wot, Wot, Wot, Wot, Wot
Wot, Wot, Ds, 7 Kme, Cme, Wot, Wot, Wot, Ss, Ss, Hh, Hh, Hh, Hh, Hh, Hh, Chr, Chr, Chr, Re, Hh, Hh^Vc, Hh, Hh, Gs^Ftr, Hh, Hh, Hh, Hh, Hh, Gs^Ftr, Gs^Ftr, Gs, Ss, Ss, Wot, Wot, Wot, Wot, Wot, Wot, Wot, Wot, Wwt, Wwt, Wwt, Wwf, Wot, Wot, Wot, Wot, Wot
Wot, Wot, Wwt, Cme, Wwt, Wwt, Wwt, Wwt, Wwt, Ss, Hh, Hh, Hh, Hh, Hh, Re, Chr, 3 Khr, Chr, Hh, Hh, Hh, Gs^Ftr, Gs^Ftr, Gs^Ftr, Gs^Ftr, Gs^Ftr, Gs^Ftr, Gs^Ftr, Gs^Ftr, Gs^Ft, Gs, Ss, Ss, Wot, Wot, Wot, Wot, Wot, Wot, Wot, Wot, Wot, Wwf, Wwt, Wwt, Wwt, Wot, Wot, Wot, Wot, Wot
Wot, Wot, Wot, Wwt, Wwt, Wwf, Wwt, Wwt, Wot, Gs^Ft, Gs^Ft, Hh, Hh, Hh, Hh, Hh, Hh, Chr, Hh, Hh, Hh, Gs^Ftr, Gs^Ftr, Gs^Vht, Gs^Ftr, Gs^Ftr, Gs^Ftr, Gs^Ftr, Gs^Ftr, Gs^Ft, Gs, Gs, Wwt, Ss, Wot, Wot, Wot, Wot, Wot, Wot, Wot, Wot, Wot, Wot, Wwt, Wwt, Ww^Vm, Wot, Wot, Wot, Wot, Wot
Wot, Wot, Wot, Wot, Wwt, Wwt, Wwt, Wwt, Wot, Wot, Gs^Ft, Hh, Hh, Hh, Hh, Qxe, Qxe, Hh, Gs, Gs^Ft, Gs^Ft, Gs^Ftr, Gs^Ftr, Gs^Ftr, Gs^Ftr, Gs^Ftr, Gs^Ftr, Gs^Ftr, Gs^Ftr, Gs^Ft, Gs, Wwt, Wwt, Ss, Wot, Wot, Wot, Wot, Wot, Wot, Wot, Wot, Wot, Wot, Wwt, Wwf, Wwt, Wwt, Wwt, Wot, Wot, Wot
Wot, Wot, Wot, Wot, Wot, Wwf, Wwt, Wot, Wot, Wot, Wwt, Gs^Ftr, Gs^Ftr, Hh, Hh, Hh, Hh, Qxe, Qxe, Gs, Gs, Gs, Gs^Ft, Gs^Ftr, Gs^Ftr, Gs^Ftr, Gs^Ftr, Gs^Ftr, Gs^Ftr, Gs^Ft, Gs^Ft, Gs, Wwt, Wwt, Wot, Wot, Wot, Wot, Wot, Wot, Wot, Wot, Ww^Vm, Wwf, Wwt, Wwt, Gs, Gs, Ss, Wwt, Wot, Wot
Wot, Wot, Wot, Wot, Wwt, Wwt, Wwt, Wot, Wot, Wot, Wwt, Wwt, Wwt, Gs^Ftr, Gs^Ftr, Gs^Ftr, Gs^Ftr, Gs, Gs, Qxe, Qxe, Gs, Gs, Gs^Ftr, Gs^Ftr, Gs^Ftr, Gs^Vht, Gs^Ftr, Gs^Ftr, Gs^Ftr, Gs^Ft, Gs, Gs, Wwt, Wot, Wot, Wot, Wot, Wot, Wot, Wot, Wot, Wwf, Wwf, Ss, Ss, 8 Kme, Gs^Ft, Wwt, Wwt, Wot, Wot
Wot, Wot, Wot, Ww^Vm, Wwf, Wwt, Wot, Wot, Wot, Wot, Wot, Wwt, Gs^Ftr, Gs^Ftr, Gs^Ftr, Gs^Ftr, Gs^Ftr, Gs^Ft, Gs, Gs, Gs, Gs, Gs, Gs^Ftr, Gs^Ftr, Gs^Ftr, Gs^Ftr, Gs^Ftr, Gs^Ftr, Gs^Ftr, Gs^Ftr, Gs^Ft, Gs, Wwt, Wwt, Wot, Wot, Wot, Wwt, Wwt, Wwt, Wwt, Wwt, Wwt, Wwf, Gs^Ft, Cme, Cme, Wwt, Wwt, Wot, Wot
Wot, Wot, Wot, Wwt, Wot, Wot, Wot, Wot, Wot, Wot, Wot, Gs^Ftr, Gs^Ftr, Gs^Ftr, Gs^Ftr, Gs^Ftr, Gs^Ftr, Gs^Ftr, Gs^Ftr, Gs, Gs, Gs, Gs^Ft, Gs^Ftr, Gs^Ftr, Gs^Ftr, Gs^Ftr, Gs^Ftr, Gs^Ftr, Gs^Ftr, Gs^Ftr, Gs^Ftr, Gs^Ftr, Gs, Wwt, Ds, Wwt, Wwt, Ds, Wwt, Wwf, Wwf, Wot, Wwt, Wwt, Ss, Ss, Wwf, Wwt, Wot, Wot, Wot
Wot, Wot, Wwf, Wwt, Wot, Wot, Wot, Wot, Wot, Wot, Wwt, Gs^Ftr, Gs^Ft, Gs, Gs^Ftr, Gs^Ftr, Gs^Ftr, Gs^Ftr, Gs^Ft, Gs^Ftr, Gs^Ftr, Gs^Ftr, Gs^Ftr, Gs^Ftr, Gs^Ftr, Gs^Ftr, Gs^Ftr, Wwt, Wwt, Gs^Ftr, Gs^Ftr, Gs^Ftr, Gs^Ftr, Gs^Ftr, Gs^Ftr, Wwt, Wwt, Ds, Ds, Wwt, Wot, Wot, Wot, Wot, Wot, Wwt, Wwt, Wwt, Wot, Wot, Wot, Wot
Wot, Wot, Wwt, Wwt, Wot, Wot, Wot, Wot, Wot, Wwt, Gs^Ftr, Gs^Ftr, Gs^Ftr, Gs^Ftr, Gs^Ftr, Gs^Vht, Gs^Ftr, Gs^Ftr, Gs^Ftr, Gs^Ftr, Gs^Ftr, Gs^Ftr, Gs^Vht, Gs^Ftr, Gs, Gs^Ftr, Gs^Ft, Wwt, Wwt, Gs, Gs^Ftr, Gs^Ftr, Gs, Gs^Ftr, Gs^Ftr, Wwt, Gs^Ftr, Gs^Ftr, Wwt, Wwt, Wot, Wot, Wot, Wot, Wot, Wot, Wot, Wot, Wot, Wot, Wot, Wot
Wot, Wot, Ww^Vm, Wwt, Wot, Wot, Wot, Wot, Wot, Wot, Gs^Ftr, Gs^Ftr, Gs^Ftr, Gs^Ftr, Gs^Ftr, Gs^Ftr, Gs^Ftr, Gs^Ftr, Gs^Ftr, Gs^Ftr, Gs^Ftr, Gs^Ftr, Gs^Ftr, Gs^Ftr, Gs^Ftr, Gs^Ftr, Gs^Ftr, Gs, Gs^Ft, Gs^Ftr, Gs^Ftr, Gs^Ftr, Gs^Ftr, Gs^Ftr, Gs^Ftr, Gs^Ftr, Gs^Ftr, Gs^Ftr, Wot, Wot, Wot, Wot, Wot, Wot, Wot, Wot, Wot, Wot, Wot, Wot, Wot, Wot
Wot, Wot, Wwt, Wwf, Wot, Wot, Wot, Wot, Wot, Wot, Wwt, Gs^Ftr, Gs^Ftr, Gs^Ft, Gs^Ftr, Gs^Ftr, Gs^Ftr, Gs^Ftr, Gs^Ftr, Gs, Gs^Ftr, Gs^Ftr, Gs^Ftr, Gs^Ftr, Gs^Ftr, Gs^Ftr, Gs^Ftr, Gs^Ftr, Gs^Ftr, Gs^Ftr, Gs^Ftr, Gs^Ftr, Gs^Ftr, Gs^Ftr, Gs^Ftr, Gs^Ftr, Wot, Wot, Wot, Wot, Wot, Wot, Wot, Wot, Wot, Wot, Wot, Wot, Wot, Wot, Wot, Wot
Wot, Wot, Wot, Wwt, Wwt, Wot, Wot, Wot, Wot, Wot, Wot, Wwt, Gs^Ftr, Gs^Ftr, Gs^Ftr, Gs^Ftr, Wwt, Gs^Ftr, Wwt, Gs^Ftr, Gs^Ftr, Gs^Ftr, Wwt, Gs^Ftr, Gs^Ftr, Gs^Ftr, Gs^Ftr, Gs^Ftr, Gs^Ftr, Gs^Ftr, Wwt, Gs^Ftr, Wot, Chr, Chr, Wot, Wot, Wot, Wot, Wot, Wot, Wot, Wot, Wot, Wot, Wot, Wot, Wot, Wot, Wot, Wot, Wot
Wot, Wot, Wot, Wwf, Wwt, Wot, Wot, Wot, Wot, Wot, Wot, Wwt, Chr, Ch, Chr, Wwt, Wot, Wot, Wot, Wot, Wot, Wwt, Gs, Chr, Wot, Wwt, Wot, Gs^Ftr, Wot, Wwt, Wot, Wot, Wot, Gs, Ds, Wot, Wot, Wot, Wot, Wot, Wot, Wot, Wot, Wot, Wot, Wot, Wot, Wot, Wot, Wot, Wot, Wot
Wot, Wot, Wot, Wot, Wwt, Wwt, Wwt, Wot, Wot, Wot, Wot, Wwt, Gs, Gs, Gs^Es, Wot, Wot, Wot, Gs, Wot, Wot, Wot, Gs, Gs, Gs, Wot, Wot, Wot, Wot, Wot, Gs, Wot, Gs, Gs^Es, Ds, Wot, Wot, Wot, Wot, Wot, Wot, Wot, Wot, Wot, Wot, Wot, Wot, Wot, Wot, Wot, Wot, Wot
Wot, Wot, Wot, Wot, Wot, Wwf, Wwt, Wwt, Wot, Wot, Wot, Ds, Gs^Vc, Gs, Gs, Gs, Gs, Gs, Gs, Chr, Gs, Gs, Gs, Gs^Es, Gs, Gs^Ft, Gs, Wwt, Gs, Gs^Ft, Gs, Gs^Es, Gs, Ds, Wot, Wot, Wot, Wot, Wot, Wot, Wot, Wot, Wot, Wot, Wot, Wot, Wot, Wot, Wot, Wot, Wot, Wot
Wot, Wot, Wot, Wot, Wot, Wot, Wwt, Wwf, Wot, Wot, Ds, Ds, Gs, Gs, Gs, Gs, Gs, Gs^Ft, Gs^Vc, Gs, Gs, Gs^Ft, Gs, Gs, Gs^Es, Gs, Gs, Gs, Gs, Gs, Gs, Gs, Gs, Ds, Ds, Wot, Wot, Wot, Wot, Wot, Wot, Wot, Wot, Wot, Wot, Wot, Wot, Wot, Wot, Wot, Wot, Wot
Wot, Wot, Wot, Wot, Wot, Wot, Wot, Wwt, Wwt, Wot, Gs, Gs, Ch, Ch, Ch, Gs, Gs, Gs, Gs, Gs, Gs, Gs, Gs, Gs, Wwf, Wwt, Wwt, Gs, Wot, Chr, Wot, Wot, Gs, Gs, Gs, Ds, Wot, Wot, Wot, Wot, Wot, Wot, Wot, Wot, Wot, Wot, Wot, Wot, Wot, Wot, Wot, Wot
Wot, Wot, Wot, Wot, Wot, Wot, Wot, Wwt, Wwt, Ds, Gs, Gs^Es, Chw, 2 Kh, Ch, Gs, Gs, Gs, Gs, Gs^Ft, Chr, Gs, Wwt, Wwt, Gs, Gs, Wot, Wot, Wot, Wot, Wot, Wot, Wot, Gs, Gs, Ds, Ds, Wot, Wot, Wot, Wot, Wot, Wot, Wot, Wot, Wot, Wot, Wot, Wot, Wot, Wot, Wot
Wot, Wot, Wot, Wot, Wot, Wot, Wot, Wot, Wot, Wwt, Wwt, Gs, Wwt, Chw, Wwt, Gs, Gs, Gs, Gs, Gs, Gs, Chw, Wwt, Gs, Gs^Vc, Wot, Wot, Wot, Wot, Wot, Wot, Wot, Wot, Ds, Gs, Gs^Es, Gs, Ds, Wot, Wot, Wot, Wot, Wot, Wot, Wot, Wot, Wot, Wot, Wot, Wot, Wot, Wot
Wot, Wot, Wot, Wot, Wot, Wot, Wot, Wot, Wot, Wot, Wwt, Wwt, Wwt, Wwt, Gs, Gs, Gs, Gs^Vc, Gs, Gs, Wwt, Wwt, Wwf, Gs, Wot, Wot, Wot, Wot, Gs, Gs, Gs, Wot, Wot, Wot, Wot, Gs, Gs, Ds, Ds, Wot, Wot, Wot, Wot, Wot, Wot, Wot, Wot, Wot, Wot, Wot, Wot, Wot
Wot, Wot, Wot, Wot, Wot, Wot, Wot, Wot, Ds, Ds, Ds, Wwt, Wwt, Gs, Gs, Chr, Gs, Gs^Es, Gs, Gs, Gs, Gs, Wwt, Wwt, Wot, Wot, Wwt, Wot, Wwt, Gs^Vc, Gs, Wot, Wot, Wot, Wot, Wot, Gs, 1 Gs, Ds, Wot, Wot, Wot, Wot, Wot, Wot, Wot, Wot, Wot, Wot, Wot, Wot, Wot
Wot, Wot, Wot, Wot, Wot, Wot, Wot, Wot, Gs^Vc, Gs, Wwt, Wwt, Wot, Gs, Wot, Wot, Gs, Gs, Gs, Wwt, Wwt, Wwt, Wot, Wot, Wwf, Gs, Gs, Wwt, Wwt, Gs, Gs, Wwt, Wot, Wot, Wot, Wot, Wot, Ds, Ds, Wot, Wot, Wot, Wot, Wot, Wot, Wot, Wot, Wot, Wot, Wot, Wot, Wot
Wot, Wot, Wot, Wot, Wot, Wot, Wot, Ds, Gs, Gs^Es, Wot, Wot, Wot, Wot, Wot, Wot, Wot, Ds, Ds, Gs, Wwt, Wwt, Ds, Wot, Wwt, Gs, Wwt, Wwt, Wot, Wot, Wot, Wot, Wot, Wot, Wot, Wot, Wot, Wot, Wot, Wot, Wot, Wot, Wot, Wot, Wot, Wot, Wot, Wot, Wot, Wot, Wot, Wot
Wot, Wot, Wot, Wot, Wot, Wot, Wot, Ds, Wot, Wot, Wot, Wot, Wot, Wot, Wot, Wot, Wot, Wot, Ds, Gs, Wwt, Wwt, Wwt, Wwt, Wwt, Wwt, Wot, Wwt, Ds, Wot, Wot, Wot, Wwrt, Wwrt, Wwrt, Wwrt, Wwrt, Wot, Wot, Wot, Wot, Wot, Wot, Wot, Wot, Wot, Wot, Wot, Wot, Wot, Wot, Wot
Wot, Wot, Wot, Wot, Wot, Wot, Wot, Wot, Wot, Wot, Wot, Wot, Wot, Wot, Wot, Wot, Wot, Wot, Wot, Ds, Ds, Wwt, Wwt, Wwt, Ds, Wot, Wot, Wot, Wwrt, Wot, Wwrt, Wwrt, Wot, Wot, Wot, Wwrt, Wwrt, Wwrt, Wot, Wot, Wot, Wot, Wot, Wot, Wot, Wot, Wot, Wot, Wot, Wot, Wot, Wot
Wot, Wot, Wot, Wot, Wot, Wot, Wot, Wot, Wot, Wot, Wot, Wot, Wot, Wot, Wot, Wot, Wot, Wot, Wot, Wot, Ds, Wwt, Wot, Wot, Wwrt, Wot, Wwrt, Wot, Wwrt, Wwrt, Wot, Wot, Wot, Wot, Wot, Wot, Wot, Wot, Wot, Wot, Wot, Wot, Wot, Wot, Wot, Wot, Wot, Wot, Wot, Wot, Wot, Wot
Wot, Wot, Wot, Wot, Wot, Wot, Wot, Wot, Wot, Wot, Wot, Wot, Wot, Wot, Wot, Wot, Wot, Wot, Wot, Wot, Wot, Wot, Wot, Wwrt, Wot, Wwrt, Wot, Wwrt, Wot, Wot, Wot, Wot, Wot, Wot, Wot, Wot, Wot, Wot, Wot, Wot, Wot, Wot, Wot, Wot, Wot, Wot, Wot, Wot, Wot, Wot, Wot, Wot
Wot, Wot, Wot, Wot, Wot, Wot, Wot, Wot, Wot, Wot, Wot, Wot, Wot, Wot, Wot, Wot, Wot, Wot, Wot, Wot, Wot, Wot, Wot, Wot, Wot, Wot, Wot, Wot, Wot, Wot, Wot, Wot, Wot, Wot, Wot, Wot, Wot, Wot, Wot, Wot, Wot, Wot, Wot, Wot, Wot, Wot, Wot, Wot, Wot, Wot, Wot, Wot
