Wot, Wot, Wot, Wot, Wot, Wot, Wot, Wot, Wot, Wot, Wot, Wot, Wot, Wot, Wot, Wot, Wot, Wot, Wot, Wot, Wot, Wot, Wot, Wot, Wot, Wot, Wot, Wot, Wot, Wot, Wot, Wot, Wot, Wot, Wot, Wot, Wot, Wot, Wot, Wot, Wot, Wot, Wot, Wot, Wot, Wot, Wot, Wot, Wot, Wot, Wot, Wot
Wot, Wot, Wot, Wot, Wot, Wot, Wot, Wot, Wot, Wot, Wot, Wot, Wot, Wot, Wot, Wot, Wot, Wot, Wot, Wot, Wot, Wot, Wot, Wot, Wot, Wot, Wot, Wot, Wot, Wot, Wot, Wot, Wot, Wot, Wot, Wot, Wot, Wot, Wot, Wot, Wot, Wot, Wot, Wot, Wot, Wot, Wot, Wot, Wot, Wot, Wot, Wot
Wot, Wot, Wot, Wot, Wot, Wot, Wot, Wot, Wot, Wot, Wot, Wot, Wot, Wot, Wot, Wot, Wot, Wot, Wot, Wot, Wot, Wot, Wot, Wot, Wot, Wot, Wot, Wot, Wot, Wot, Wot, Wot, Wot, Wot, Wot, Wot, Wot, Wot, Wot, Wot, Wot, Wot, Wot, Wot, Wot, Wot, Wot, Wot, Wot, Wot, Wot, Wot
Wot, Wot, Wot, Wot, Wot, Wot, Wot, Mm^Xm, Wwt, Wot, Mm^Xm, Wot, Mm^Xm, Wot, Wot, Wot, Wot, Wot, Wot, Wot, Wot, Wot, Wot, Wot, Wot, Wot, Wot, Wot, Wot, Wot, Wot, Wot, Wot, Wot, Wot, Wot, Wot, Wot, Wot, Wot, Wot, Wot, Wot, Wot, Wot, Wot, Wot, Ds, Wot, Wot, Wot, Wot
Wot, Wot, Wot, Wot, Wot, Wot, Wwt, Mm^Xm, Mm^Xm, Mm^Xm, Ds, Mm^Xm, Mm^Xm, Wot, Wot, Wot, Wot, Wot, Wot, Wot, Wot, Wot, Mm^Xm, Mm^Xm, Mm^Xm, Wot, Wot, Wot, Wot, Wot, Wot, Wot, Wot, Wot, Wwt, Wot, Wot, Wot, Wot, Wot, Wot, Wot, Wot, Wot, Wot, Wot, Wwt, Wwt, Wot, Wot, Wot, Wot
Wot, Wot, Wot, Wot, Wot, Wot, Wwt, Wwt, Mm^Xm, Ds, Ds, Ds, Wwt, Wwt, Wwt, Wot, Wwt, Wot, Wot, Wot, Wot, Wot, Wwt, Mm^Xm, Wot, Wot, Wot, Wot, Wot, Wot, Wot, Wot, Wot, Wwt, Hh, Wwt, Wot, Wot, Wot, Wot, Wot, Wot, Wot, Wot, Wot, Wot, Ds, Wwt, Wot, Wot, Wot, Wot
Wot, Wot, Wot, Wot, Wot, Wwt, Wwt, Mm^Xm, Mm^Xm, Ds, Ds, Ds, Wwt, Wwt, Mm^Xm, Wwf, Wwf, Wwt, Wwt, Wwt, Wwt, Wwf, Wwt, Wwt, Wot, Wot, Wot, Wot, Wot, Wot, Wot, Wot, Wwt, Hh, Hh, Hh, Hh, Hh, Wot, Wot, Wot, Wot, Wot, Wot, Wwt, Gs, Wwt, Wot, Wot, Wot, Wot, Wot
Wot, Wot, Wot, Wot, Wot, Wwt, Wwt, Wwt, Wwt, Wwt, Wwf, Wwt, Wwt, Wwt, Mm^Xm, Mm^Xm, Mm^Xm, Wwt, Wwt, Mm^Xm, Mm^Xm, Wwt, Wwt, Wwt, Wwt, Mm^Xm, Wot, Wot, Wot, Wot, Wot, Wot, Wwt, Hh, Hh, Mm, Hh, Hh, Wot, Wot, Wot, Wot, Wwt, Wwt, Gs, Wwt, Wwt, Wot, Wot, Wot, Wot, Wot
Wot, Wot, Wot, Wot, Wot, Wwt, Wwt, Wwt, Wwt, Wwt, Wwf, Wwt, Wwt, Wwf, Wwt, Wwt, Mm^Xm, Wwt, Wwt, Wwt, Wwf, Wwt, Mm^Xm, Mm^Xm, Wwf, Wot, Wot, Wot, Wot, Wot, Wot, Wot, Wot, Wwt, Hh, Hh, Hh, Wwt, Wot, Wot, Wot, Wot, Wwt, Gs, Gs, Gs, Wwt, Wot, Wot, Wot, Wot, Wot
Wot, Wot, Wot, Wot, Wot, Wot, Wwt, Mm^Xm, Wwt, Wwf, Wwt, Wwt, Wwt, Wwt, Wwt, Wwf, Wwf, Wwt, Wwt, Wwf, Wwt, Wwt, Mm^Xm, Mm^Xm, Wwt, Wot, Wot, Wot, Wot, Wot, Wot, Wot, Wot, Wot, Wot, Hh, Wot, Wot, Wot, Wot, Wot, Wwt, Gs, Gs^Vc, Gs, Wwt, Wot, Wot, Wot, Wot, Wot, Wot
Wot, Wot, Wot, Wot, Wot, Wwt, Mm^Xm, Mm^Xm, Mm^Xm, Mm^Xm, Wwt, Wwt, Mm^Xm, Wwf, Wwt, Wwt, Wwt, Wwt, Mm^Xm, Wwt, Wwt, Wwt, Wwt, Wwt, Wwt, Wot, Wwt, Wot, Wwt, Wot, Wot, Wot, Wot, Wot, Wot, Wot, Wot, Wot, Wot, Wot, Wot, Wwt, Gs, Gs, Ds, Wwt, Wot, Wot, Wot, Wot, Wot, Wot
Wot, Wot, Wot, Wot, Wwt, Wwf, Wwt, Wwt, Wwt, Wwt, Wwt, Wwt, Wwt, Wwt, Mm^Xm, Wwt, Ds, Wwf, Wwt, Wwt, Wwt, Wwt, Wwt, Wwf, Wwt, Wwt, Wwt, Wwt, Ds, Wwt, Wwt, Wot, Wot, Wot, Wot, Wot, Wot, Wot, Wwt, Wwt, Wwt, Wwt, Wwt, Wwt, Wwt, Wwt, Wot, Wot, Wot, Wot, Wot, Wot
Wot, Wot, Wot, Wot, Wwt, Wwt, Wwt, Wwf, Wwf, Wwt, Wwt, Wwt, Wwt, Mm^Xm, Wwf, Wwt, Wwt, Ds, Wwt, Wwt, Wwt, Wwf, Wwt, Wwt, Wwt, Wwf, Wwt, Wwt, Ds, Ds, Wwt, Wot, Wot, Wot, Wot, Wot, Wot, Wwt, Gs^Ft, Gs^Ft, Re, Re, Gs, Wwt, Wwt, Wot, Wot, Wot, Wot, Wot, Wot, Wot
Wot, Wot, Wot, Wot, Wwt, Mm^Xm, Mm^Xm, Mm^Xm, Wwt, Wwt, Wwf, Wwt, Wwt, Wwt, Wwt, Wwt, Wwt, Ds, Ds, Ds, Ds, Wwt, Ds, Wwt, Gs^Ft, Wwt, Hh, Wwt, Wwt, Ds, Wwt, Wwt, Wot, Wot, Wwt, Wwt, Wwt, Wwt, Gs^Ft, Gs, Ss, Re, Gs^Vc, Gs, Wwt, Wot, Wot, Wot, Wot, Wot, Wot, Wot
Wot, Wot, Wot, Wot, Wwf, Wwt, Wwt, Wwt, Wwt, Wwt, Mm^Xm, Wwt, Wwf, Wwt, Wwf, Wwf, Wwt, Wwt, Wwt, Ds, Ds, Ds, Gs^Ft, Gs^Ft, Hh, Hh, Hh, Gs^Ft, Gs^Ft, Wwt, Gs^Ft, Wwt, Wwt, Wwt, Gs^Ft, Gs^Ft, Gs^Ft, Gs^Ft, Ss, Gs, Gs, Gs, Gs, Wwt, Wot, Wot, Wot, Wot, Wot, Wot, Wot, Wot
Wot, Wot, Wot, Wot, Mm^Xm, Wwt, Wot, Wwt, Ds, Wwt, Wwt, Wwt, Wwf, Wwt, Wwt, Mm^Xm, Mm^Xm, Wwt, Wwt, Ds, Hh, Hh, Hh, Hh, Mm, Hh, Mm, Hh, Hh, Gs^Ft, Gs^Ft, Gs^Ft, Gs^Ft, Gs^Ft, Gs^Ft, Gs^Ft, Gs^Ft, Ss, Re, Gs^Vc, Ss, Ss, Gs, Wwt, Wot, Wot, Wot, Wot, Wot, Wot, Wot, Wot
Wot, Wot, Wot, Wot, Wot, Wot, Wot, Wot, Ds, Ds, Wwt, Wwt, Wwt, Wwt, Wwt, Wwt, Wwt, Wwt, Ds, Ds, Hh, Hh, Hh, Mm, Mm, Mm, Mm, Mm, Mm, Hh, Hh, Gs^Ft, Hh, Hh, Gs^Ft, Hh, Gs^Ft, Re, Gs, Gs, Ss, Ss, Hh, Gs, Wwt, Wot, Wot, Wot, Wot, Wot, Wot, Wot
Wot, Wot, Wot, Wot, Wot, Wot, Wot, Wot, Wot, Ds, Ds, Wwt, Ds, Wwt, Ds, Wwt, Wwt, Wwt, Ds, Hh, Hh, Hh, Mm, Mm, Mm, Mm, Rb, Mm, Mm, Mm, Mm, Hh, Hh, Gs^Ft, Gs^Ft, Gs^Ft, Gs, Ss, Gs, Hh, Gs, Gs, Gs, Gs, Ds, Wwt, Wot, Wot, Wot, Wot, Wot, Wot
Wot, Wot, Wot, Wot, Wot, Wot, Wot, Wot, Wot, Mm^Xm, Ds, Ds, Ds, Ds, Hh, Ds, Ds, Ds, Hh, Hh, Hh, Hh, Mm, Mm, Mm, Rb, Rb, Rb, Mm, Mm, Mm, Hh, Gs^Ft, Gs^Ft, Gs^Vht, Gs^Ft, Re, Gs, Gs, Gs, Gs, Gs, Gs, Gs, Ss, Wwt, Wot, Wot, Wot, Wot, Wot, Wot
Wot, Wot, Wot, Wot, Wot, Wot, Wot, Wot, Wot, Wot, Wot, Ds, Ss, Hh, Hh, Hh, Hh, Ds, Hh, Hh, Hh, Hh, Hh, Mm, Mm, Rb, Rb, Rb, Mm, Mm, Mm, Hh, Gs^Ft, Gs^Ft, Gs, Gs, Ss, Ss, Gs, Gs, Gs, Gs, Gs, Ds, Ss, Wot, Wot, Wot, Wot, Wot, Wot, Wot
Wot, Wot, Wot, Wot, Wot, Wot, Wot, Wot, Wot, Wot, Wot, Ss, Hh, Hh, Hh, Hh, Hh, Hh, Hh^Vc, Hh, Hh, Hh, Hh, Mm, Mm, Mm, Mm, Mm, Mm, Mm, Hh, Gs^Ft, Gs^Ft, Gs^Ft, Ss, Ss, Ss, Ss, Ss, Gs, Re, Re, Ss, Ss, Ss, Wot, Wot, Wot, Wot, Wot, Wot, Wot
Wot, Wot, Wot, Wot, Wot, Wot, Wot, Wot, Wot, Wot, Ss, Ss, Hh, Hh, Hh, Hh, Hh, Hh, Hh, Hh, Hh, Hh, Hh, Mm, Mm, Mm, Mm, Mm, Mm, Mm, Hh, Gs^Vht, Gs^Ft, Gs, Ss, Ss, Wot, Ss, Wot, Ss, Ss, Ss, Wwt, Ss, Wwt, Wot, Wot, Wot, Wot, Wot, Wot, Wot
Wot, Wot, Ds, Ds, Ww, Wot, Wot, Wot, Wot, Wot, Ss, Hh, Hh, Hh, Hh^Vc, Hh, Hh, Hh, Hh, Hh, Hh, Hh, Hh, Hh, Hh, Mm, Mm, Mm, Mm, Mm, Hh, Gs^Ft, Gs, Gs, Ss, Wot, Wot, Wot, Wot, Wot, Wot, Wot, Wot, Wwt, Wwf, Wwt, Wot, Wot, Wot, Wot, Wot, Wot
Wot, Wot, Ds, Ds, Wwf, Wot, Wot, Wot, Ss, Ss, Hh, Hh, Hh, Hh, Hh, Hh, Hh, Hh, Hh, Re, Hh, Hh^Vc, Hh, Hh, Gs^Ft, Hh, Hh, Hh, Hh, Hh, Gs^Ft, Gs^Ft, Gs, Ss, Ss, Wot, Wot, Wot, Wot, Wot, Wot, Wot, Wot, Wwt, Wwt, Wwt, Wwf, Wot, Wot, Wot, Wot, Wot
Wot, Wot, Wwt, Wwf, Wwt, Wwt, Wwt, Wwt, Wwt, Ss, Hh, Hh, Hh, Hh, Hh, Re, Hh, Re, Hh, Hh, Hh, Hh, Gs^Ft, Gs^Ft, Gs^Ft, Gs^Ft, Gs^Ft, Gs^Ft, Gs^Ft, Gs^Ft, Gs^Ft, Gs, Ss, Ss, Wot, Wot, Wot, Wot, Wot, Wot, Wot, Wot, Wot, Wwf, Wwt, Wwt, Wwt, Wot, Wot, Wot, Wot, Wot
Wot, Wot, Wot, Wwt, Wwt, Wwf, Wwt, Wwt, Wot, Gs^Ft, Gs^Ft, Hh, Hh, Hh, Hh, Hh, Hh, Hh, Hh, Hh, Hh, Gs^Ft, Gs^Ft, Gs^Vht, Gs^Ft, Gs^Ft, Gs^Ft, Gs^Ft, Gs^Ft, Gs^Ft, Gs, Gs, Wwt, Ss, Wot, Wot, Wot, Wot, Wot, Wot, Wot, Wot, Wot, Wot, Wwt, Wwt, Ww^Vm, Wot, Wot, Wot, Wot, Wot
Wot, Wot, Wot, Wot, Wwt, Wwt, Wwt, Wwt, Wot, Wot, Gs^Ft, Hh, Hh, Hh, Hh, Qxe, Qxe, Hh, Gs, Gs^Ft, Gs^Ft, Gs^Ft, Gs^Ft, Gs^Ft, Gs^Ft, Gs^Ft, Gs^Ft, Gs^Ft, Gs^Ft, Gs^Ft, Gs, Wwt, Wwt, Ss, Wot, Wot, Wot, Wot, Wot, Wot, Wot, Wot, Wot, Wot, Wwt, Wwf, Wwt, Wwt, Wwt, Wot, Wot, Wot
Wot, Wot, Wot, Wot, Wot, Wwf, Wwt, Wot, Wot, Wot, Wwt, Gs^Ft, Gs^Ft, Hh, Hh, Hh, Hh, Qxe, Qxe, Gs, Gs, Gs, Gs^Ft, Gs^Ft, Gs^Ft, Gs^Ft, Gs^Ft, Gs^Ft, Gs^Ft, Gs^Ft, Gs^Ft, Gs, Wwt, Wwt, Wot, Wot, Wot, Wot, Wot, Wot, Wot, Wot, Ww^Vm, Wwf, Wwt, Wwt, Gs, Gs, Ss, Wwt, Wot, Wot
Wot, Wot, Wot, Wot, Wwt, Wwt, Wwt, Wot, Wot, Wot, Wwt, Wwt, Wwt, Gs^Ft, Gs^Ft, Gs^Ft, Gs^Ft, Gs, Gs, Qxe, Qxe, Gs, Gs, Gs^Ft, Gs^Ft, Gs^Ft, Gs^Vht, Gs^Ft, Gs^Ft, Gs^Ft, Gs^Ft, Gs, Gs, Wwt, Wot, Wot, Wot, Wot, Wot, Wot, Wot, Wot, Wwf, Wwf, Ss, Ss, Gs, Gs^Ft, Wwt, Wwt, Wot, Wot
Wot, Wot, Wot, Ww^Vm, Wwf, Wwt, Wot, Wot, Wot, Wot, Wot, Wwt, Gs^Ft, Gs^Ft, Gs^Ft, Gs^Ft, Gs^Ft, Gs^Ft, Gs, Gs, Gs, Gs, Gs, Gs^Ft, Gs^Ft, Gs^Ft, Gs^Ft, Gs^Ft, Gs^Ft, Gs^Ft, Gs^Ft, Gs^Ft, Gs, Wwt, Wwt, Wot, Wot, Wot, Wwt, Wwt, Wwt, Wwt, Wwt, Wwt, Wwf, Gs^Ft, Wwf, Wwf, Wwt, Wwt, Wot, Wot
Wot, Wot, Wot, Wwt, Wot, Wot, Wot, Wot, Wot, Wot, Wot, Gs^Ft, Gs^Ft, Gs^Ft, Gs^Ft, Gs^Ft, Gs^Ft, Gs^Ft, Gs^Ft, Gs, Gs, Gs, Gs^Ft, Gs^Ft, Gs^Ft, Gs^Ft, Gs^Ft, Gs^Ft, Gs^Ft, Gs^Ft, Gs^Ft, Gs^Ft, Gs^Ft, Gs, Wwt, Ds, Wwt, Wwt, Ds, Wwt, Wwf, Wwf, Wot, Wwt, Wwt, Ss, Ss, Wwf, Wwt, Wot, Wot, Wot
Wot, Wot, Wwf, Wwt, Wot, Wot, Wot, Wot, Wot, Wot, Wwt, Gs^Ft, Gs^Ft, Gs, Gs^Ft, Gs^Ft, Gs^Ft, Gs^Ft, Gs^Ft, Gs^Ft, Gs^Ft, Gs^Ft, Gs^Ft, Gs^Ft, Gs^Ft, Gs^Ft, Gs^Ft, Ww, Ww, Gs^Ft, Gs^Ft, Gs^Ft, Gs^Ft, Gs^Ft, Gs^Ft, Wwt, Wwt, Ds, Ds, Wwt, Wot, Wot, Wot, Wot, Wot, Wwt, Wwt, Wwt, Wot, Wot, Wot, Wot
Wot, Wot, Wwt, Wwt, Wot, Wot, Wot, Wot, Wot, Wwt, Gs^Ft, Gs^Ft, Gs^Ft, Gs^Ft, Gs^Ft, Gs^Vht, Gs^Ft, Gs^Ft, Gs^Ft, Gs^Ft, Gs^Ft, Gs^Ft, Gs^Vht, Gs^Ft, Gs, Gs^Ft, Gs^Ft, Ww, Ww, Gs, Gs^Ft, Gs^Ft, Gs, Gs^Ft, Gs^Ft, Wwt, Gs^Ft, Gs^Ft, Wwt, Wwt, Wot, Wot, Wot, Wot, Wot, Wot, Wot, Wot, Wot, Wot, Wot, Wot
Wot, Wot, Ww^Vm, Wwt, Wot, Wot, Wot, Wot, Wot, Wot, Gs^Ft, Gs^Ft, Gs^Ft, Gs^Ft, Gs^Ft, Gs^Ft, Gs^Ft, Gs^Ft, Gs^Ft, Gs^Ft, Gs^Ft, Gs^Ft, Gs^Ft, Gs^Ft, Gs^Ft, Gs^Ft, Gs^Ft, Gs, Gs^Ft, Gs^Ft, Gs^Ft, Gs^Ft, Gs^Ft, Gs^Ft, Gs^Ft, Gs^Ft, Gs^Ft, Gs^Ft, Wot, Wot, Wot, Wot, Wot, Wot, Wot, Wot, Wot, Wot, Wot, Wot, Wot, Wot
Wot, Wot, Wwt, Wwf, Wot, Wot, Wot, Wot, Wot, Wot, Wwt, Gs^Ft, Gs^Ft, Gs^Ft, Gs^Ft, Gs^Ft, Gs^Ft, Gs^Ft, Gs^Ft, Gs, Gs^Ft, Gs^Ft, Gs^Ft, Gs^Ft, Gs^Ft, Gs^Ft, Gs^Ft, Gs^Ft, Gs^Ft, Gs^Ft, Gs^Ft, Gs^Ft, Gs^Ft, Gs^Ft, Gs^Ft, Gs^Ft, Wot, Wot, Wot, Wot, Wot, Wot, Wot, Wot, Wot, Wot, Wot, Wot, Wot, Wot, Wot, Wot
Wot, Wot, Wot, Wwt, Wwt, Wot, Wot, Wot, Wot, Wot, Wot, Wwt, Gs^Ft, Gs^Ft, Gs^Ft, Gs^Ft, Wwt, Gs^Ft, Wwt, Gs^Ft, Gs^Ft, Gs^Ft, Wwt, Gs^Ft, Gs^Ft, Gs^Ft, Gs^Ft, Gs^Ft, Gs^Ft, Gs^Ft, Wwt, Gs^Ft, Wot, Chr, Chr, Wot, Wot, Wot, Wot, Wot, Wot, Wot, Wot, Wot, Wot, Wot, Wot, Wot, Wot, Wot, Wot, Wot
Wot, Wot, Wot, Wwf, Wwt, Wot, Wot, Wot, Wot, Wot, Wot, Wwt, Chr, Ch, Chr, Wwt, Wot, Wot, Wot, Wot, Wot, Wwt, Gs, Chr, Wot, Wwt, Wot, Gs^Ft, Wot, Wwt, Wot, Wot, Wot, Gs, Ds, Wot, Wot, Wot, Wot, Wot, Wot, Wot, Wot, Wot, Wot, Wot, Wot, Wot, Wot, Wot, Wot, Wot
Wot, Wot, Wot, Wot, Wwt, Wwt, Wwt, Wot, Wot, Wot, Wot, Wwt, Gs, Gs, Gs, Wot, Wot, Wot, Gs, Wot, Wot, Wot, Gs, Gs, Gs, Wot, Wot, Wot, Wot, Wot, Gs, Wot, Gs, Gs, Ds, Wot, Wot, Wot, Wot, Wot, Wot, Wot, Wot, Wot, Wot, Wot, Wot, Wot, Wot, Wot, Wot, Wot
Wot, Wot, Wot, Wot, Wot, Wwf, Wwt, Wwt, Wot, Wot, Wot, Ds, Gs^Vc, Gs, Gs, Gs^Edp, Gs, Gs, Gs, Chr, Gs, Gs, Gs^Edp, Gs, Gs, Gs^Ft, Gs, Wwt, Gs, Gs^Ft, Gs, Gs, Gs^Edp, Ds, Wot, Wot, Wot, Wot, Wot, Wot, Wot, Wot, Wot, Wot, Wot, Wot, Wot, Wot, Wot, Wot, Wot, Wot
Wot, Wot, Wot, Wot, Wot, Wot, Wwt, Wwf, Wot, Wot, Ds, Ds, Gs, Gs, Gs^Edp, Gs, Gs, Gs^Ft, Gs^Vc, Gs, Gs, Gs^Ft, Gs^Edp, Gs, Gs, Gs, Gs, Gs^Edp, Gs, Gs, Gs, Gs, Gs, Ds, Ds, Wot, Wot, Wot, Wot, Wot, Wot, Wot, Wot, Wot, Wot, Wot, Wot, Wot, Wot, Wot, Wot, Wot
Wot, Wot, Wot, Wot, Wot, Wot, Wot, Wwt, Wwt, Wot, Gs^Edp, Gs, Ch, Ch, Ch, Gs, Gs^Edp, Gs, Gs, Gs, Gs, Gs, Gs, Gs, Wwf, Wwt, Wwt, Gs^Edp, Wot, Chr, Wot, Wot, Gs, Gs, Gs, Ds, Wot, Wot, Wot, Wot, Wot, Wot, Wot, Wot, Wot, Wot, Wot, Wot, Wot, Wot, Wot, Wot
Wot, Wot, Wot, Wot, Wot, Wot, Wot, Wwt, Wwt, Ds, Gs, Gs, Chw, 2 Kh, Ch, Gs, Gs, Gs^Edp, Gs, Gs^Ft, Chr, Gs, Wwt, Wwt, Gs^Edp, Gs, Wot, Wot, Wot, Wot, Wot, Wot, Wot, Gs^Edp, Gs, Ds, Ds, Wot, Wot, Wot, Wot, Wot, Wot, Wot, Wot, Wot, Wot, Wot, Wot, Wot, Wot, Wot
Wot, Wot, Wot, Wot, Wot, Wot, Wot, Wot, Wot, Wwt, Wwt, Gs, Wwt, Chw, Wwt, Gs, Gs, Gs, Gs, Gs, Gs, Chw, Wwt, Gs, Gs^Vc, Wot, Wot, Wot, Wot, Wot, Wot, Wot, Wot, Ds, Gs, Gs^Edp, Gs, Ds, Wot, Wot, Wot, Wot, Wot, Wot, Wot, Wot, Wot, Wot, Wot, Wot, Wot, Wot
Wot, Wot, Wot, Wot, Wot, Wot, Wot, Wot, Wot, Wot, Wwt, Wwt, Wwt, Wwt, Gs, Gs, Gs, Gs^Vc, Gs, Gs, Wwt, Wwt, Wwf, Gs, Wot, Wot, Wot, Wot, Gs, Gs^Edp, Gs, Wot, Wot, Wot, Wot, Gs, Gs^Edp, Ds, Ds, Wot, Wot, Wot, Wot, Wot, Wot, Wot, Wot, Wot, Wot, Wot, Wot, Wot
Wot, Wot, Wot, Wot, Wot, Wot, Wot, Wot, Ds, Ds, Ds, Wwt, Wwt, Gs, Gs, Chr, Gs, Gs, Gs, Gs^Edp, Gs, Gs, Wwt, Wwt, Wot, Wot, Wwt, Wot, Wwt, Gs^Vc, Gs, Wot, Wot, Wot, Wot, Wot, Gs, 1 Gs, Ds, Wot, Wot, Wot, Wot, Wot, Wot, Wot, Wot, Wot, Wot, Wot, Wot, Wot
Wot, Wot, Wot, Wot, Wot, Wot, Wot, Wot, Gs^Vc, Gs^Edp, Wwt, Wwt, Wot, Gs, Wot, Wot, Gs, Gs^Edp, Gs, Wwt, Wwt, Wwt, Wot, Wot, Wwf, Gs, Gs, Wwt, Wwt, Gs, Gs, Wwt, Wot, Wot, Wot, Wot, Wot, Ds, Ds, Wot, Wot, Wot, Wot, Wot, Wot, Wot, Wot, Wot, Wot, Wot, Wot, Wot
Wot, Wot, Wot, Wot, Wot, Wot, Wot, Ds, Gs, Gs, Wot, Wot, Wot, Wot, Wot, Wot, Wot, Ds, Ds, Gs, Wwt, Wwt, Ds, Wot, Wwt, Gs, Wwt, Wwt, Wot, Wot, Wot, Wot, Wot, Wot, Wot, Wot, Wot, Wot, Wot, Wot, Wot, Wot, Wot, Wot, Wot, Wot, Wot, Wot, Wot, Wot, Wot, Wot
Wot, Wot, Wot, Wot, Wot, Wot, Wot, Ds, Wot, Wot, Wot, Wot, Wot, Wot, Wot, Wot, Wot, Wot, Ds, Gs, Wwt, Wwt, Wwt, Wwt, Wwt, Wwt, Wot, Wwt, Ds, Wot, Wot, Wot, Wwrt, Wwrt, Wwrt, Wwrt, Wwrt, Wot, Wot, Wot, Wot, Wot, Wot, Wot, Wot, Wot, Wot, Wot, Wot, Wot, Wot, Wot
Wot, Wot, Wot, Wot, Wot, Wot, Wot, Wot, Wot, Wot, Wot, Wot, Wot, Wot, Wot, Wot, Wot, Wot, Wot, Ds, Ds, Wwt, Wwt, Wwt, Ds, Wot, Wot, Wot, Wwrt, Wot, Wwrt, Wwrt, Wot, Wot, Wot, Wwrt, Wwrt, Wwrt, Wot, Wot, Wot, Wot, Wot, Wot, Wot, Wot, Wot, Wot, Wot, Wot, Wot, Wot
Wot, Wot, Wot, Wot, Wot, Wot, Wot, Wot, Wot, Wot, Wot, Wot, Wot, Wot, Wot, Wot, Wot, Wot, Wot, Wot, Ds, Wwt, Wot, Wot, Wwrt, Wot, Wwrt, Wot, Wwrt, Wwrt, Wot, Wot, Wot, Wot, Wot, Wot, Wot, Wot, Wot, Wot, Wot, Wot, Wot, Wot, Wot, Wot, Wot, Wot, Wot, Wot, Wot, Wot
Wot, Wot, Wot, Wot, Wot, Wot, Wot, Wot, Wot, Wot, Wot, Wot, Wot, Wot, Wot, Wot, Wot, Wot, Wot, Wot, Wot, Wot, Wot, Wwrt, Wot, Wwrt, Wot, Wwrt, Wot, Wot, Wot, Wot, Wot, Wot, Wot, Wot, Wot, Wot, Wot, Wot, Wot, Wot, Wot, Wot, Wot, Wot, Wot, Wot, Wot, Wot, Wot, Wot
Wot, Wot, Wot, Wot, Wot, Wot, Wot, Wot, Wot, Wot, Wot, Wot, Wot, Wot, Wot, Wot, Wot, Wot, Wot, Wot, Wot, Wot, Wot, Wot, Wot, Wot, Wot, Wot, Wot, Wot, Wot, Wot, Wot, Wot, Wot, Wot, Wot, Wot, Wot, Wot, Wot, Wot, Wot, Wot, Wot, Wot, Wot, Wot, Wot, Wot, Wot, Wot
