Mm^Xm, Mm^Xm, Mm^Xm, Mm^Xm, Mm^Xm, Mm^Xm, Mm^Xm, Hh, Gg, Gg, Gs^Fms, Gs^Fms, Gs^Fms, Gs^Fms, Gg, Rp, Gg, Gg, Gs^Fds, Gs^Fds, Gs^Fds, Gs^Fds, Gs^Fds, Gs^Fds, Gg, Gs^Fds, Gs^Fds, Gs^Fds
Mm^Xm, Mm^Xm, Mm^Xm, Mm^Xm, Mm, Mm, Hh^Fms, Hh, Hh^Fms, Gg, Gg, Gs^Fms, Gg, Gs^Fms, Gg^Efm, Rp, Gg, Gg, Gg, Gs^Fds, Gs^Fds, Gs^Fds, Gs^Fds, Gs^Fds, Gg^Efm, Gs^Fds, Gg^Efm, Gs^Fds
Mm^Xm, Mm^Xm, Mm^Xm, Mm^Xm, Mm, Mm, Mm, Hh^Fms, Hh^Fms, Hh, Hh, Ch, 3 Kh, Ch, Gg, Rp, Gg, Gg, Gg, Gs^Fds, Gs^Fds, Gs^Fds, Gg, Gs^Fds, Gs^Fds, Gs^Fds, Gs^Fds, Gs^Fds
Mm^Xm, Mm^Xm, Mm^Xm, Mm^Xm, Mm, Hh, Hh^Fms, Gg, Hh, Gs^Fms, Gg, Gg^Vh, Ch, Gg^Vh, Rp, Rp, Gg, Gg, Gg, Gg, Gs^Fds, Gg, Gs^Fds, Gg^Vh, Gs^Fds, Re, Gs^Fds, Gg
Mm^Xm, Mm, Mm, Mm, Mm, Mm^Vhh, Hh, Gg, Gg, Gs^Fms, Gg, Gg, Gg, Gg, Rp, Gg, Gg, Gg, Gg^Efm, Gg, Gg, Gg, Re, Gg, Gs^Fds, Re, Gs^Fds, Gs^Fds
Mm^Xm, Mm, Mm, Mm, Hh^Fms, Hh^Fms, Hh, Hh, Gg, Gg, Gg, Gg, Gg, Gg, Rp, Gg, Gg, Gg^Efm, Gg, Gg, Gg, Gg, Gg, Gs^Fds, Gs^Fds, Gs^Fds, Gs^Fds, Gs^Fds
Hh, Gg, Hh, Gs^Fms, Gs^Fms, Hh^Fms, Hh, Gs^Fms, Gg, Gg, Gg, Gg, Gg, Gg, Hh, Rp, Rp, Gg, Hh, Gg, Gg, Gg, Gg, Gg, Gg, Gg, Gg, Gs^Fds
Hh, Hh, Hh, Gg^Vh, Gg, Hh, Gg, Gg, Gg, Gs^Fms, Gg, Gg, Gg, Hh^Vhh, Hh, Hh, Rp, Hh, Gg, Hh, Gg, Gg, Gg, Gg, Gg, Gs^Fds, Gg, Gg
Hh, Hh, Gg, Gs^Fms, Gg, Gs^Fms, Gg, Gs^Fms, Gs^Fms, Gg, Gg, Gg, Hh, Hh, Rp, Rp, Hh, Gg, Gg, Gg, Gg, Gg, Gg, Gg, Gs^Fds, Gs^Fds, Gs^Fds, Gs^Fds
Gg, Gg, Gg, Gg, Hh, Gg, Gg, Gg, Gg, Gg, Gg, Gg, Hh, Gg, Rp, Hh, Hh, Hh, Hh, Gg, Gg, Gg, Gg, Gg, Gg, Gs^Fds, Gs^Fds, Gs^Fds
Gg, Gg, Hh, Hh, Gg, Hh, Gg, Gg, Gg, Gg, Gg, Hh, Rp, Rp, Hh, Re, Gg, Re, Re, Gg, Re, Gg, Gg, Gg, Re, Gg, Gg, Gg
Gg, Gg, Gg, Gg, Gg^Efm, Gg, Gg^Efm, Gg, Gg, Gg, Rp, Rp, Hh, Hh, Hh, Gg, Hh, Gg, Gg, Hh, Gg, Re, Gg, Re, Gg, Re, Re, Gg
Gg, Gg, Gg^Efm, Gg, Gg, Gg, Gg, Gg, Gg, Gg, Rp, Hh, Hh, Mm, Mm, Hh, Mm, Hh, Gg, Gg, Gg, Gg, Gg, Gg, Ce, Gg, Gg, Re
Gg, Gg, Hh, Gg, Gg, Gg, Gg, Gg, Gg, Hh, Gg, Rp, Hh, Hh^Fp, Hh, Hh, Mm, Hh, Hh, Gg, Gg^Vh, Gg, Gg, Ce, 2 Ke, Ce, Gg, Gg
Gs^Fds, Gs^Fds, Gs^Fds, Hh, Hh^Fms, Hh, Gg, Gg, Gg, Gg, Gg^Efm, Rp, Rp, Hh^Fp, Hh, Hh, Mm, Hh, Hh, Gg, Gg, Gg, Ce, Ce, Gs^Fmw, Ce, Gg, Gs^Fms
Gs^Fds, Gs^Fds, Gs^Fds, Gs^Fms, Gs^Fms, Hh, Gg, Gg, Gg, Gg, Gg, Gg, Rp, Gg, Hh, Hh^Fp, Mm, Mm, Mm, Hh, Hh, Gg, Gg, Gs^Fmw, Ce, Ce, Gg, Gs^Fms
Gs^Fds, Gs^Fds, Gg, Gs^Fms, Gs^Fms, Hh^Fms, Gg, Gg, Gg^Efm, Gg, Gg, Gg, Rp, Gg, Gs^Fp, Hh, Hh, Mm, Hh, Mm, Hh, Gs^Fmw, Gs^Fmw, Gs^Fmw, Gg, Gg^Vh, Gg, Gg
Gg, Gs^Fds, Gs^Fds, Gs^Fms, Gg, Gg, Gg, Gg, Gg, Gg, Gg, Gg, Gg, Rp, Gg, Gs^Fp, Hh^Fp, Hh, Mm, Mm^Vhh, Mm, Hh^Fmw, Hh, Hh, Gg, Gg, Ww, Ww
Gg, Gs^Fds, Gg, Gs^Fms, Gg, Gg^Vh, Gg, Gg, Re^Gvs, Re^Gvs, Re^Gvs, Gg, Gg, Rp, Gg, Gs^Fp, Hh, Hh, Hh^Fp, Mm, Mm, Hh, Re, Hh, Ww, Wwf, Gg, Gg
Gg, Gg, Gg, Gg, Gg, Gg, Re^Gvs, Re^Gvs, Re^Gvs, Re^Gvs, Re^Gvs, Re^Gvs, Gg, Rp, Gg, Gg, Hh, Hh, Hh, Hh^Vhh, Hh, Mm, Mm, Re, Wwf, Gg, Hh, Hh
Ww, Gg, Gg, Gg, Gg, Re^Gvs, Re^Gvs, Re^Gvs, Re^Gvs, Re^Gvs, Gg, Gg, Rp, Rp, Gg, Gg, Gg, Gs^Fp, Gg, Hh, Hh, Hh, Ww, Ww, Mm, Re, Re, Hh
Gg, Ww, Wwf, Gg, Gg, Gg, Gg, Re^Gvs, Gg, Gg, Gg, Gg, Rp, Gg, Gg, Gg, Gg, Gg, Gg, Gg, Gg, Hh, Ww, Hh, Hh, Mm, Gg, Re
Gg, Gg, Gg, Ww, Ww, Wwf, Ww, Gg, Gg, Gg, Gg, Gg, Gg, Rp, Gg, Gg, Ww, Gg, Gg, Gg, Ww, Wwf, Gg, Hh, Gs^Fms, Hh^Vhh, Gs^Fms, Gs^Fms
Gg, Gg, Gg, Gg^Vh, Gg, Gg, Gg, Wwf, Ww, Ww, Wwf, Ww, Ww, Rp, Gg, Ww, Wo, Gg, Ww, Ww, Wo, Ww, Gg, Gg, Gg, Gs^Fms, Gs^Fms, Gs^Fms
Gg, Gg, Gg, Gg, Gg, Gg, Gg, Gg, Gg, Gg, Gg, Gg, Gg, Ww^Bw|, Ww, Ww, Ww, Ww, Gg, Ww, Ww, Ww, Gg, Gg, Gg, Gg, Re, Re
Gg, Gg, Gg, Gg, Gg, Gg, Gg, Gg, Gg^Efm, Gg, Gg, Gg, Rp, Rp, Ww, Ww, Ww, Gg, Ww, Ww, Gg, Ww, Gg, Gg, Gg, Re, Gg, Gg
Gg, Gg, Ce, Ce, Ce, Gg, Gg, Gg, Gg, Gg, Gg, Gg, Rp, Gg, Ww, Wo, Wo, Ww, Ww, Gg^Vh, Wwf, Ww, Gg, Gg, Re, Re, Gg, Gg
Gg, Gg, Ce, 1 Ke, Ce, Gg, Gg, Gg, Gg, Gg, Gg, Gg, Rp, Gg, Gg, Ww, Ww, Ww, Gg, Ww, Re, Gg, Gs^Fms, Gs^Fms, Re, Gs^Fms, Gs^Fms, Gs^Fms
Gg, Gg, Ce, Ce, Ce, Gg, Gg, Gg, Gg, Gg, Gg^Efm, Gg, Gg, Rp, Gg, Ww, Gg, Gg, Gg^Efm, Gg, Re, Gg, Gs^Fms, Gs^Fms, Gs^Fms, Gg, Gg, Gs^Fms
Gg, Gg, Gg, Gg, Gg, Gg, Gg, Gg, Gs^Fms, Gg, Gg, Gg, Gg, Rp, Gg, Gg, Gg, Gg^Efm, Gg, Re, Gg, Gs^Fms, Gs^Fms, Re, Gg^Vh, Gs^Fms, Gs^Fms, Gs^Fms
Gg, Gg, Gg, Gg, Gg, Gg, Gg, Gg, Gs^Fms, Gs^Fms, Gg, Gg, Rp, Rp, Re, Re, Re, Re, Re, Re, Re, Re, Re, Re, Gs^Fms, Gs^Fds, Gs^Fds, Gs^Fds
Gg, Gg, Gg, Gg, Gg, Gg, Gs^Fds, Gs^Fds, Gs^Fds, Gs^Fms, Gg, Gg, Rp, Gg, Gg, Gg, Gg, Gg, Gg, Gg, Gg, Gs^Fms, Gs^Fms, Gs^Fms, Gs^Fds, Gs^Fds, Gs^Fds, Gs^Fds
Gg, Gg, Gg, Gg, Gg, Gs^Fds, Gs^Fds, Gs^Fds, Gs^Fds, Gs^Fms, Gg, Gg, Rp, Gg, Gg, Gg, Gg, Gg, Gg, Gg, Gg, Gs^Fms, Gs^Fds, Gs^Fds, Gs^Fds, Gs^Fds, Gs^Fds, Gs^Fds
