Mm, Mm, Mm, Hh, Hh^Fp, Hh, Hh^Fms, Gg, Gs^Fms, Gg^Fmw, Gll, Gs, Gll, Gg, Gs^Fms, Gg, Re, Re, Gs, Gs, Gd^Eff, Gs^Eff, Gs^Eff, Gs, Gs^Fmw, Gs^Fmw, Gs^Fms, Gs^Fds, Gs^Fms, Gs^Fds
Mm, Mm, Mm, Hh^Fmw, Hh^Fmw, Hh^Fp, Hh^Fmw, Gs^Fms, Gs^Fms, Gs^Fds, Gs^Fms, Gg^Efm, Gg^Efm, Gg^Fmw, Gs^Fms, Gg^Fmw, Re^Es, Re^Es, Gd, Gd^Eff, Re^Gvs, Re^Gvs, Re^Wm, Gs^Eff, Gs^Eff, Gs^Fmw, Gs^Fms, Gs^Fmw, Gs^Fms, Gs^Fds
Mm, Mm, Hh^Fmw, Hh, Gs^Em, Gll^Emf, Gg^Fmw, Gs^Fms, Gll^Emf, Gll^Em, Gs, Gs, Gg^Efm, Gs^Fms, Gs, Gg^Fmw, Re, Gs, Gd, Re^Gvs, Re^Gvs, Re^Gvs, Gs^Eff, Gs^Eff, Gll^Em, Gs^Fmw, Gs^Fds, Gs^Fds, Gs^Fds, Gs^Fds
Gs^Fms, Hh^Fds, Gs^Fms, Gs^Em, Gg^Fdw, Gs^Em, Gs^Fdw, Gll^Em, Gs^Fms, Gs^Fms, Gs^Fds, Gs^Fms, Gg, Gs, Re^Es, Re, Ce, Gg, Gg, Gs^Vc, Gs, Gs^Eff, Gs^Fms, Gll^Em, Gll^Fp, Gs^Fds, Gs^Fms, Gll^Emf, Hh, Hh
Gs^Fdw, Gs, Gs, Gg^Fmw, Gg, Gg^Efm, Re, Re, Gll^Em, Gs^Fp, Gg^Fmw, Gs^Fms, Gs, Re^Es, Ce, Ce, Ce, Gs, Gg, Gg, Gs^Fmw, Gs, Gs^Fmw, Gs^Fms, Gs^Fp, Gs^Fds, Gs^Fms, Hh^Fmw, Hh, Hh
Re^Es, Re^Es, Re, Re, Re, Re, Gs^Eff, Gs^Es, Gs, Gs^Fms, Gg^Fmw, Gg^Fmw, Re, Re^Es, Gs^Vh, 1 Ke, Gg, Gg^Efm, Gg, Gg, Gg, Gg^Efm, Gg^Efm, Gs, Gll^Em, Gll^Em, Gs^Fms, Gs^Fmw, Hh^Fmw, Hh
Gd, Gd, Gd, Gs^Vc, Gs^Eff, Gd^Eff, Re^Gvs, Re^Gvs, Gg^Vh, Gg^Efm, Gg^Efm, Re, Gs, Gs, Gs^Eff, Gg, Gg^Efm, Gs, Gs^Fms, Gs^Fmw, Gs^Fmw, Gg, Gs^Fms, Gs, Gs^Fp, Gs^Fds, Gs^Fp, Gs^Fms, Hh^Fds, Hh^Fds
Hh^Fdw, Re^Gvs, Hh, Re^Gvs, Hh, Gd^Eff, Gs^Vh, Gs, Re^Es, Gg, Gg, Re, Re^Gvs, Re^Gvs, Re^Gvs, Gs^Eff, Gg^Eff, Gg, Gs^Fms, Gg^Fmw, Gs^Fms, Gg^Efm, Gs^Fms, Gs^Fds, Gs^Fms, Gs^Fms, Gll^Em, Gs^Fds, Gs^Fds, Gs^Fds
Hh^Fms, Hh^Fmw, Hh^Es, Hh^Es, Hh^Es, Gs, Gs, Gs, Ww^Ewl, Re, Re^Es, Re, Gs^Vc, Re^Gvs, Gs^Eff, Gs^Eff, Gg, Gs^Fms, Gs^Fds, Gs^Fds, Gg^Vl, Gg^Efm, Gs^Fp, Gs^Fds, Gs^Fms, Gs^Fms, Hh^Fp, Hh^Fds, Hh^Fds, Hh
Gs^Fms, Hh, Ww, Ww, Ww, Gg^Efm, Wwf, Ww, Ww, Re^Es, Re^Es, Gg, Ww, Gs, Gs, Ww^Ewf, Ww, Ww, Ww, Ww^Ewf, Ww, Gs^Fds, Hh^Fmw, Hh^Fms, Hh^Fms, Hh, Hh, Hh^Fds, Mm, Mm
Ss^Em, Sm, Ss, Ss, Ww^Vm, Wwf, Ww^Ewf, Wwf, Ww^Ewl, Ch, Wwf, Ww, Ds, Ww, Ww, Ww, Ww^Ewl, Ww^Ewl, Gs^Fms, Gs^Fmw, Ww^Ewf, Ww, Gg, Hh, Hh^Fmw, Hh, Mm, Mm, Mm, Mm
Ww, Ww, Sm, Ss, Gll^Fmw, Ss, Gll^Fmw, Gs, Wwf, Ww, Re^Es, Gd^Es, Gd, Ds, Gs, Gs, Gs, Gs^Fms, Gs^Fds, Gs^Fp, Gs^Fmw, Ww, Gs^Fds, Gs^Fmw, Ww^Ewl, Ww^Ewl, Wwf, Mm, Hh, Hh
Ss^Em, Sm, Ss^Em, Sm^Em, Gll^Fp, Ss, Gll^Fmw, Gs, Gs, Re^Es, Re, Gd^Vc, Gs, Gd, Gs, Gs, Gg^Efm, Gs^Fms, Gg^Vl, Gs^Fds, Gs^Fp, Ww, Ww, Ww, Ww, Hh, Mm, Ww^Ewl, Ww^Ewl, Ww
Ww, Ss, Sm^Em, Gll^Fmw, Gll^Emf, Gs^Fp, Gs, Gg^Efm, Re, Re^Es, Re, Gs, Hh, Gs^Es, Gs^Fmw, Gg, Gg, Gg^Efm, Gg^Fmw, Gs^Fp, Gs^Fms, Gs^Fms, Gs, Ww, Gd^Edpp, Hh, Hh, Ww^Ewl, Ww, Ww
Ss, Sm, Rb, Ss^Em, Re, Gs^Em, Re^Es, Re, Gg, Gg^Vh, Re^Es, Gs^Fmw, Hh, Hh, Gs, Gg, Gs, Gg^Efm, Gg, Gg^Fmw, Gll, Gs^Fmw, Gs, Ww^Ewf, Gs, Gs, Gd, Gd^Edpp, Mm, Ww
Gll^Fp, Gll^Fmw, Ss, Re, Ss, Re^Es, Gll^Em, Gll^Fp, Gg, Gg^Efm, Re^Es, Hh^Es, Hh^Fdw, Gs^Wm, Gg^Efm, Gg, Gs^Fmw, Gg, Gs, Gs, Hh^Fdw, Gs, Hh, Gs, Gs^Fdw, Gs, Gs^Vh, Gs, Gd, Mm
Re, Ss, Re^Em, Ss, Sm, Ss, Ss, Gll^Fdw, Gg^Fmw, Hh^Fdw, Re, Gg, Gg^Em, Gg, Gg^Fmw, Gg, Hh, Gs^Fms, Hh, Gs, Hh, Hh, Hh^Fdw, Gs, Gs, Gs^Fms, Hh^Fp, Hh, Mm, Gd
Gll^Em, Re, Gll^Fmw, Gll^Fmw, Sm^Em, Re, Sm, Ss^Em, Gs^Efm, Gg^Fdw, Hh^Fdw, Re, Gs, Gg^Efm, Gs^Fmw, Gs^Fmw, Hh^Fp, Hh, Hh, Hh, Mm, Hh^Fdw, Mm, Hh, Hh^Fp, Gs^Fp, Gll^Emf, Hh^Fmw, Hh, Hh
Ss^Em, Sm, Sm, Gll^Em, Ss^Em, Sm^Em, Ss^Em, Ss, Gs^Fmw, Gg, Gg, Re, Gs, Gs^Fms, Ce, Gs^Fds, Ce, Hh^Fmw, Hh^Fp, Mm, Mm, Mm, Mm, Hh, Hh, Hh^Fmw, Hh, Hh^Es, Hh^Es, Hh
Ss^Em, Ss^Em, Ss^Em, Ss, Gll^Emf, Sm, Gll^Fp, Gs^Fms, Gs^Fmw, Gs, Re^Es, Re, Re^Es, Gs^Fp, Ce, 2 Ke, Hh^Es, Hh^Fp, Hh^Fds, Hh^Fp, Hh, Mm, Hh^Fdw, Mm, Mm, Mm, Mm, Hh, Hh^Fdw, Hh
Hh, Gll^Emf, Gll^Fdw, Gll^Fdw, Gll^Fp, Gll^Fmw, Gs^Fms, Gs^Fms, Gs, Re^Es, Gs^Fmw, Gs^Fp, Gs^Fms, Re^Es, Gs^Fms, Ce, Re^Es, Hh^Fds, Hh^Fp, Hh, Hh, Hh, Hh, Hh, Hh^Es, Hh^Fdw, Hh, Mm, Mm, Mm
Gg, Gll^Fmw, Gll^Fmw, Gll^Fmw, Gs^Fp, Gs^Fms, Gs^Fmw, Gs^Fms, Gs^Em, Re, Gs^Em, Hh, Hh, Gs^Fms, Gs^Fms, Gs^Fds, Gs^Fms, Gs^Fp, Gs^Fdw, Gs^Fmw, Hh, Hh^Fdw, Hh^Fdw, Hh^Es, Hh^Fdw, Hh^Es, Hh^Fdw, Mm, Hh, Hh
Gs^Fp, Gs^Fp, Hh, Hh, Gll^Fmw, Gs^Fms, Gs^Fms, Gg^Vl, Gs^Fms, Re, Re, Gs^Fp, Gs^Fp, Gs^Fds, Gs^Em, Gs^Em, Gs^Fds, Gs^Fms, Gs^Fms, Gs^Fmw, Gs^Fp, Hh, Hh^Fmw, Hh^Fmw, Ww, Hh^Fmw, Hh^Fds, Hh, Hh^Fdw, Hh
Hh^Fms, Gs^Fms, Gs^Fds, Hh, Gll^Emf, Gs^Fmw, Gs^Fms, Gs^Fms, Gs^Fmw, Gs, Re, Gs^Fms, Gs^Fms, Gs^Fds, Gs^Fp, Gs^Fms, Gs^Fms, Gll^Emf, Gs^Fds, Gs^Fp, Gs^Fms, Hh^Fmw, Hh^Fms, Hh^Fp, Ww^Ewf, Ww, Gll^Fp, Hh, Gll^Fmw, Gll^Fmw
Hh^Fmw, Gs^Fms, Gll^Em, Gs, Hh, Gs^Fms, Gs^Fmw, Gs^Fmw, Gs, Re, Gs^Fmw, Re, Re^Es, Gs^Fms, Gg, Gs^Fds, Gg, Gs^Fms, Re^Es, Gs^Fms, Gs^Fdw, Hh, Gll^Fms, Gll^Fp, Gg, Gg, Gll^Fp, Gs^Fp, Gll^Em, Gs^Fp
