Gll^Fp, Gll^Fp, Gll^Fmw, Gll^Fmw, Gll^Fmw, Gll^Fp, Re^Em, Gs^Fmw, Gg^Fms, Gg^Efm, Gg^Fms, Gg^Fms, Gg^Fms, Gs^Fds, Gg, Ww, Ww, Ww, Ww, Gd^Fdw, Gd, Gs, Gs^Fmw, Gg^Efm, Gll^Fms, Gll^Fms, Gs^Fds, Hh^Fp, Mm, Mm, Mm, Hh, Mm, Hh^Fmw, Mm, Mm, Mm
Gll^Fdw, Gll^Fmw, Gll^Fp, Gll^Fp, Ss^Em, Ss^Em, Re^Em, Gs^Fmw, Gs^Fp, Gg, Gg^Efm, Gs^Fds, Gs^Fds, Gg^Efm, Gs, Gs^Fds, Ww, Wo, Ww, Ds, Re^Es, Gs^Fdw, Gs^Fp, Gs^Fms, Gg^Fms, Hh^Fms, Hh, Hh^Fms, Hh^Fds, Mm, Mm, Mm, Hh^Fmw, Hh^Fms, Hh^Fmw, Mm, Mm
Gll^Fdw, Gll^Fmw, Gll^Fp, Sm^Em, Gll^Fdw, Ss^Uf, Ss^Em, Re, Re^Es, Re, Re^Es, Gs^Vl, Gs^Fmw, Gs, Gs, Gd, Ds, Ww, Ww, Ds^Esd, Re^Fdw, Gd, Gs^Fms, Gs^Fms, Gll^Fp, Gs^Fms, Hh, Gs^Fds, Gs^Fms, Hh, Mm, Gll^Emf, Gll^Fdw, Hh, Hh^Fmw, Gll^Emf, Hh^Fmw
Ss^Uf, Ss^Uf, Ss^Em, Sm^Edb, Ss, Gll^Fmw, Ss, Ss, Gll^Fmw, Gll^Fmw, Re^Es, Re, Gs, Gg^Efm, Gg^Efm, Gd, Gs^Fmw, Ww^Ewl, Ww, Ds, Gd, Gs^Fmw, Gs^Vl, Gs^Fds, Gs^Fp, Gs^Fms, Gg, Gs^Em, Gs^Em, Gs^Fms, Hh^Fdw, Hh^Fp, Gs^Em, Hh, Gs, Gs^Em, Gs^Fp
Ss^Em, Ss^Em, Sm^Edb, Ss^Edb, Sm, Ss^Edb, Ss^Em, Rb^Fdw, Rb^Fmw, Gll^Fp, Gll^Fp, Re, Gs^Efm, Gs^Fmw, Gs, Gs, Gs, Ds^Esd, Ww, Ww, Ds, Gd^Fmw, Gs^Fmw, Gll^Em, Gs^Fms, Gs^Fms, Gg^Efm, Gg, Gg, Gs^Fp, Gs^Fmw, Gs^Fp, Rr^Es, Rr, Rr, Gs^Fp, Rr
Ss^Em, Ss^Em, Sm^Em, Sm^Em, Rb^Edb, Sm, Sm^Em, Ss^Em, Ss^Uf, Gll^Fmw, Gll^Fmw, Re, Re, Gs, Gd^Fdw, Gs^Fmw, Gd^Es, Gs^Vc, Ww, Ww, Ds^Esd, Re, Gd, Gs^Em, Gs^Eff, Gs, Gg, Gs, Rp, Gs, Rr, Rr^Es, Ce, Re^Vct, Gg^Efm, Rr, Gg
Ss, Ss, Ss^Em, Gll^Uf, Rb^Em, Rb^Es, Ss, Ss^Em, Ss^Uf, Hh^Fdw, Rb^Es, Gd^Fmw, Gd, Re^Es, Gd, Ds^Esd, Ww, Ww, Ww, Ww, Re^Es, Gd, Re^Gvs, Re^Gvs, Re^Wm, Gs^Eff, Gs^Eff, Gs, Gs, Rp, Rr^Es, Ce, 1 Ke, Ce, Gg, Gg, Gg
Gll^Fmw, Gll^Fdw, Gll^Fmw, Ss, Ss^Edb, Ss, Sm^Edb, Ss^Em, Sm^Em, Rb^Fdw, Rb^Es, Gd^Vhr, Gll^Fmw, Re, Re, Ds, Ww, Wo, Ww, Ds, Gd^Eff, Re^Gvs, Re^Es, Re^Es, Re^Gvs, Re^Gvs, Gs, Gg, Gg^Efm, Gg^Efm, Gs^Fdw, Rr, Gg^Efm, Gg^Efm, Gs^Fp, Gg, Gs
Re^Es, Rb^Es, Gll^Fdw, Hh^Fdw, Ss^Em, Ss, Hh^Es, Sm^Edb, Hh^Em, Sm^Em, Rb^Fdw, Gll^Fmw, Gll^Fp, Gll^Fp, Re^Es, Ds, Ww, Wo, Ww, Ds, Ds, Gd^Eff, Gs^Eff, Re^Gvs, Gs^Eff, Gs, Gs^Vc, Gg^Es, Rp, Gs^Fdw, Rp, Rp, Gs^Fms, Gs, Gs, Gg, Gg^Em
Ss^Em, Rb^Es, Re, Ss^Edb, Ss^Em, Hh^Fdw, Sm^Em, Hh^Es, Hh^Fmw, Gll^Emf, Hh^Fmw, Hh, Gs^Fp, Gd, Re^Es, Gd^Fms, Gd^Vh, Ww, Ww, Ww, Ww, Gd, Ce, Gs^Eff, Rr, Rr, Rr, Rr^Es, Gg^Em, Rp, Gs^Fp, Gs^Em, Gs^Fms, Gs^Fms, Gs^Fms, Gs^Fp, Gs^Em
Ss, Ss, Re, Ss, Rb^Fdw, Sm, Gll^Fdw, Hh^Fmw, Gs^Fp, Hh^Fmw, Gs^Fp, Gs^Fp, Gs^Fms, Gs^Fms, Gs^Eff, Re, Re, Gd^Es, Gs, Ww, Ww^Ewl, Ww, Ww^Bw/, Rr^Es, Gs, Gs, Re^Gvs, Gs, Gs, Gg^Fdw, Gs^Fp, Gll^Em, Gll^Fp, Gs^Fms, Gs^Fds, Gll^Emf, Gll^Fms
Ss^Em, Ss^Em, Rb^Fdw, Re^Em, Re^Em, Rb, Hh, Hh^Fp, Hh, Gs^Fms, Gd^Em, Gs^Em, Gs^Eff, Gs^Eff, Re^Gvs, Gs^Eff, Gs, Rr, Rr, Ce, Rr, Ww^Bw/, Ww, Ww^Ewl, Gs^Eff, Re^Gvs, Re^Gvs, Re^Gvs, Gs^Fdw, Gg^Fms, Gs^Fms, Gll^Fp, Gll^Fp, Gs^Fds, Gs^Fds, Gll^Fms, Gs^Fms
Ss^Em, Ss^Uf, Gll^Fdw, Gll^Fmw, Re^Es, Gll^Emf, Gll^Fmw, Gll^Fp, Gll^Emf, Gs^Fms, Gs^Fms, Gd, Re^Gvs, Re^Gvs, Re^Gvs, Re^Gvs, Gs, Ce, Rr^Vhc, Rr^Es, Rr^Es, Rr^Vhc, Ww^Ewl, Ww, Ww, Gd^Eff, Gd^Eff, Gs^Eff, Gs^Fmw, Gs^Fmw, Gll^Em, Gll^Fms, Gll^Fp, Hh, Hh^Fms, Hh^Fdw, Hh^Fmw
Gll^Fmw, Gll^Fmw, Gll^Fp, Gs^Efm, Re, Gll^Fmw, Gll^Fp, Gll^Fp, Gs^Em, Gs^Fms, Gd, Gd^Es, Gs^Es, Re^Gvs, Gs^Es, Gs, Gg^Efm, Ce, Rp^Vhcr, Rp^Edb, Rp^Edb, Chr, Khr, Ww, Ww, Ds, Gd^Es, Gs, Gs^Es, Gs^Em, Gs^Fp, Hh^Vhh, Hh, Hh^Fmw, Mm, Hh^Es, Hh^Es
Gll^Fmw, Gll^Fmw, Gll^Fp, Gll^Fp, Gs^Em, Re^Em, Gll^Fp, Gs^Fp, Gs^Fds, Gll, Gll, Gd^Es, Re^Gvs, Re^Wm, Re^Gvs, Gs^Eff, Gg^Eff, Ce^Edb, Rp, Re^Edb, Re^Edb, Chr, Chr, Ww^Bw/, Wo, Ww, Ds, Gd, Gd^Fmw, Gs^Fms, Hh^Fms, Gll^Emf, Mm, Hh^Fmw, Mm^Xm, Mm, Hh^Fmw
Gll^Em, Gll^Emf, Gs^Fp, Gs^Fms, Re, Re, Gs^Fp, Gs^Fms, Gs^Fms, Gll^Fds, Re, Re^Gvs, Re^Gvs, Re^Gvs, Gs^Eff, Gs^Eff, Re, Rp^Es, Ce^Edb, Rp^Vhcr, Rb^Vhcr, Re, Rb^Vhcr, Ww^Bw/, Wo, Ww, Rd, Gd^Es, Hh^Es, Hh, Mm, Hh, Hh^Fdw, Mm, Mm, Mm, Hh^Es
Gs^Fds, Gs^Fp, Gs^Fms, Re^Es, Gs^Es, Gs^Es, Gs^Es, Gg^Efm, Gs^Fms, Gll^Fms, Re^Es, Re^Es, Gd^Fmw, Gd^Eff, Gs^Es, Re, Gg^Efm, Gg, Gg^Efm, Ce^Edb, Ce, Rb^Edb, Ww, Ww^Ewl, Ww, Ww^Ewl, Re^Es, Hh^Fdw, Ww^Ewf, Mm, Ww^Ewf, Mm, Mm^Xm, Mm^Xm, Wo, Mm, Mm
Gs^Fms, Gs^Fms, Gs^Fms, Re^Es, Gs^Fp, Gs^Fms, Gs, Gs, Gs, Re, Rb^Edb, Re^Vc, Rb^Edb, Rb, Re^Es, Re^Es, Gs^Vh, Gs, Re^Gvs, Gs, Gs, Ww^Ewl, Ww, Ww, Rd^Es, Re, Rd^Es, Hh, Ww, Ww, Mm, Mm, Mm, Mm^Xm, Wo, Wo, Wo
Gs^Fp, Gs^Fms, Gs^Em, Re, Re^Es, Gs^Fp, Re, Gs^Vc, Gll^Fmw, Gll^Fp, Re^Es, Gll^Fmw, Re^Edb, Gll^Fmw, Re^Em, Gll^Fmw, Gs^Es, Re^Gvs, Re^Gvs, Re^Gvs, Gd^Es, Gs, Ww, Ds^Esd, Ds^Esd, Rd^Es, Ww, Gd, Ww^Ewl, Mm, Mm, Mm, Mm, Mm, Hh^Fms, Gs^Fms, Ww
Gs^Fp, Gs^Em, Gs^Em, Gs^Fms, Gs^Fp, Re^Es, Gll^Fp, Re^Es, Re, Re^Em, Rb^Fdw, Re^Es, Rb^Fdw, Re^Em, Sm^Em, Rb^Fdw, Rb^Edb, Gll^Fmw, Gd^Edb, Gd^Es, Ww, Ww, Ww, Ds, Ww, Ww, Wo, Ww, Ww, Mm, Wo, Mm, Mm, Mm, Hh, Ww, Ww^Ewf
Gs^Fms, Gs^Fms, Gll^Emf, Gs^Fms, Gs^Fp, Gs^Em, Gll^Fp, Rb^Es, Rb^Em, Sm, Ss^Em, Ss, Ss^Em, Sm^Edb, Ss^Vhs, Ss, Ss, Rb^Es, Re^Edb, Gd^Vht, Ww^Bw\, Wo, Wo, Ww, Wo, Wo, Wo, Wo, Wo, Wo, Wo, Mm, Mm, Gs^Fp, Ww, Ww, Gg^Fms
Gs^Fp, Gll^Fp, Gll^Fp, Gll^Fp, Gs^Fp, Gll^Fp, Gll^Fmw, Gll^Fmw, Rb^Fdw, Sm^Em, Sm, Ss^Em, Rb^Emf, Rb^Fdw, Sm^Edb, Sm^Edb, Ww^Edb, Ww^Edb, Ww, Ww, Wo, Wo, Wo^Edb, Wo, Ww, Ww, Ww, Ww, Ww, Wo, Mm, Mm, Mm, Ww, Ww^Ewl, Gg^Efm, Gs^Fms
Gs^Fms, Gs^Fp, Gs^Fms, Gs^Fms, Wwf, Gll^Fp, Ww^Edb, Gll^Fmw, Ww, Sm^Edb, Ww^Edb, Sm^Em, Ss^Em, Ss, Ww, Ww, Ww^Edb, Ww^Edb, Ww, Ww, Ww^Edb, Ww^Edb, Ww^Edb, Ww, Ww, Ww, Gd^Fmw, Gs^Fdw, Gs^Fp, Ww, Ww, Mm, Ww, Ww^Ewl, Gg^Efm, Gs^Fms, Hh^Fms
Ww, Ww^Ewf, Ww^Ewl, Wwf, Ww, Ww, Ww, Wwf, Ww, Ww^Edb, Ww, Gll^Fmw, Ss, Ww, Ww^Edb, Ww, Re^Es, Gll^Fmw, Gll^Fp, Gll^Fdw, Gll^Fmw, Gll^Fp, Gs^Fms, Re, Gs^Fms, Ww, Gs^Fp, Gs^Fmw, Gll^Emf, Ww, Hh^Fmw, Ww, Hh^Es, Ww, Gs^Fp, Hh^Fp, Mm
Wo, Ww^Ewl, Ww, Ww, Gs^Fmw, Ww^Ewl, Hh, Ww, Gs^Fms, Ww, Ww^Edb, Ww, Ww, Ww, Ww^Edb, Ww^Edb, Gll^Fp, 2 Ke, Ce, Gll^Fdw, Gll^Fdw, Gs^Fp, Gd^Es, Gs^Em, Ww, Ww, Hh^Fp, Gs^Fms, Hh^Fms, Hh^Fp, Hh^Es, Hh, Hh^Fmw, Hh^Es, Gs^Fmw, Hh^Fmw, Mm
Ww, Ww, Gs^Fms, Gs^Fmw, Gs^Fds, Gs^Fmw, Hh, Hh^Es, Hh^Fmw, Gs^Fms, Hh^Es, Ww^Edb, Ww, Ww^Edb, Re^Fmw, Ww^Edb, Rb^Em, Ce, Ce, Gd, Wwf, Wwf, Ww, Gs^Fp, Ww, Ww, Gs^Fds, Gll^Emf, Hh, Hh^Fmw, Hh^Em, Mm, Mm, Hh^Es, Hh^Fdw, Mm, Ww^Ewl
Ww, Ww^Ewf, Gs^Fds, Gs^Fms, Gs^Fms, Gg^Efm, Gs^Em, Hh^Fdw, Hh^Fmw, Hh^Es, Gs^Fms, Gs^Fms, Sm, Ww^Edb, Re^Fmw, Gll^Fp, Gd^Es, Gd^Es, Gd^Es, Gs^Es, Gd, Ww, Ww, Ww, Ww^Ewf, Ww^Ewl, Ww, Hh^Fds, Hh^Es, Mm, Hh^Fdw, Hh^Em, Mm, Hh^Fdw, Mm, Hh, Hh^Fp
Hh, Hh^Fds, Gs^Fms, Gs^Fms, Gs^Fp, Gs^Em, Gs^Fp, Hh, Re^Em, Hh^Es, Hh^Fp, Gll^Fp, Sm^Em, Rb^Es, Sm, Ss^Em, Ss^Em, Gd^Es, Gd^Es, Gs^Es, Gs^Fms, Wwf, Ww, Ww^Ewl, Ww^Ewl, Ww, Ww^Ewl, Hh^Fms, Mm, Mm, Mm, Mm, Mm, Mm, Mm, Mm, Mm
Gs^Fms, Gs^Fms, Gs^Fms, Gs^Fms, Gs^Fp, Gs^Fmw, Gll^Fp, Gll^Fp, Gll^Fmw, Gll^Fmw, Hh, Gll^Fp, Gll^Fp, Sm, Gll^Emf, Gll^Fmw, Gll^Fmw, Gd^Fmw, Gs^Efm, Gs^Fp, Gs^Fms, Wwf, Wwf, Ww, Ww^Ewl, Ww, Mm, Ww, Mm, Mm, Mm, Mm, Mm, Wo, Wo, Wo, Ww
Gg^Efm, Gs^Em, Gs, Gs^Em, Gs^Fmw, Gll^Fp, Gll^Fdw, Gll^Fmw, Gll^Fp, Gll^Fp, Gll^Fmw, Gll^Emf, Gll^Fp, Ss^Em, Ss, Ss^Em, Gll^Fmw, Re^Em, Gll^Fp, Gll^Fp, Gs^Fms, Re, Gs^Fp, Gd^Fmw, Hh^Fp, Hh^Fds, Mm, Wo, Wo, Mm, Mm, Mm, Mm, Mm, Mm, Mm, Hh^Fms
Gs, Gs^Efm, Gs^Fp, Re, Re^Es, Re^Es, Gll^Em, Re^Em, Re^Es, Gll^Fmw, Gll^Fdw, Gll^Em, Gll^Fmw, Gll^Fdw, Ss^Em, Ss^Em, Gll^Fmw, Gll^Fmw, Gll^Fmw, Gll^Fmw, Gll^Fmw, Gs^Efm, Gs^Fms, Gs^Fp, Hh^Es, Mm, Ww, Wo, Mm, Wo, Mm, Mm, Mm, Wo, Wo, Hh, Hh^Fms
Gs^Em, Gs^Em, Gs^Fp, Gs^Fmw, Gll^Fp, Gll^Fdw, Gll^Fmw, Ss^Em, Ss^Em, Gll^Em, Ss^Em, Ss, Ss, Ss, Ss^Em, Gll^Emf, Gll^Fmw, Gll^Fdw, Gs^Efm, Gll^Fmw, Gll^Fp, Gs^Em, Gs^Fms, Gs^Fms, Hh^Es, Hh^Fds, Ww^Ewl, Mm, Hh^Fp, Mm, Mm, Mm, Mm, Mm, Mm, Ww, Hh^Fms
Gs^Fds, Gs^Fms, Gs^Fds, Gs^Fp, Gs^Fms, Gll^Fp, Gll^Fmw, Ss^Uf, Gll^Fmw, Ss, Sm, Sm^Em, Sm, Sm^Em, Ss^Em, Gll^Fdw, Gll^Fmw, Gll^Fmw, Gll^Fp, Gll^Fp, Re^Es, Re^Es, Gs^Fds, Gs^Fms, Gs^Fp, Ww^Ewl, Ww, Hh^Fms, Hh, Hh^Fdw, Mm, Mm, Hh^Fdw, Mm, Mm, Ww, Ww^Ewf
Gs^Fds, Gs^Fds, Gs^Fds, Gs^Fms, Gs^Fms, Gll^Fp, Gll^Fp, Gll^Fp, Gll^Fp, Ss^Uf, Ss, Sm^Em, Sm, Sm, Ss^Em, Ss^Uf, Gs^Fds, Gll^Fmw, Gll^Fp, Gll^Fp, Re, Gs^Fms, Re, Gs^Fp, Gs^Fds, Ww, Hh, Hh, Hh, Mm, Mm, Hh, Mm, Hh, Hh, Ww^Ewf, Gs^Fds
