Aa^Fpa, Aa^Fpa, Aa^Fma, Aa^Fma, Aa^Fma, Aa^Fda, Aa^Fda, Aa, Re^Eff, Gd^Eff, Gd^Eff, Gd^Fdw, Gd^Fdw, Gll^Em, Gll, Rr, Rr, Ww^Bw/, Ww^Ewl, Aa^Fpa, Aa^Fpa
Aa^Fma, Aa^Fpa, Aa^Fma, Aa^Em, Gd^Fmw, Gd^Es, Rd^Eff, Re^Eff, Re^Gvs, Re^Gvs, Re^Wm, Gd^Es, Gd, Gll^Em, Gd, Ch, Ch, Ww^Ewl, Ch, Ww, Wo
Aa^Fda, Aa^Fma, Aa^Fda, Aa^Fdw, Gd^Fdw, Re^Eff, Re^Eff, Re^Gvs, Re^Gvs, Re^Gvs, Rd^Eff, Re^Es, Re, Re, Rr, Ch, Rr, Rr^Vhc, Kh, Ww, Wo
Aa^Fma, Aa^Em, Rd^Em, Aa^Es, Rd^Em, Gd^Es, Rd^Es, Rd^Eff, Re^Eff, Gd^Eff, Re, Re, Gll^Em, Re^Es, Re^Es, Rr, Rr, Ch, Ch, Ww^Bw\, Wo
Aa^Fdw, Aa^Fda, Gd, Rd, Re, Gd^Fdw, Rd, Rd^Vh, Re^Es, Re^Es, Rd^Em, Gll^Fdw, Ww^Ewl, Gll^Fdw, Ww^Ewl, Ch, Ch, Rr, Rr^Vhc, Ww^Bw\, Wo
Gll^Fmw, Gd^Fdw, Gd^Em, Re^Es, Rd^Esd, Re, Re^Em, Re, Rd^Esd, Rd^Es, Gd^Em, Gll^Fdw, Ww, Ww, Ww, Ww, Ww^Ewl, Ww^Ewl, Ww, Ww^Bw\, Wo
Gll^Fdw, Gd^Fdw, Ce, Re, Gd^Em, Gd^Fdw, Gd^Fdw, Gd^Es, Ww^Ewl, Rd^Esd, Ww^Ewl, Ww, Wwr, Wo, Wo, Wo, Wo, Ww^Ewl, Ww, Wo, Wo
Gd^Em, Gd^Em, Ww^Ewl, Re, Ww, Ww^Ewl, Ww^Ewl, Ww, Ww^Ewl, Ww^Ewl, Wwr, Ww, Wo, Wo, Ww, Wo, Wwr, Wwr, Wo, Wo, Wwr
Ww, Ww^Ewl, Ww, Ww^Bw|, Ww, Wwr, Wwr, Wwr, Ww, Ww, Ww, Ww, Ai, Ww, Ai, Ww, Ww, Wwr, Wo, Wwr, Ww
Wwr, Ww, Ww, Ww^Bw|, Ww^Ewl, Wwr, Gd^Em, Ww^Ewl, Gd^Fdw, Gd^Em, Aa, Ww, Ai, Ai, Aa^Es, Ai, Rd^Esd, Ww, Ww^Ewl, Ww^Ewl, Ww
Wwr, Ww, Gd^Fdw, Re, Rd^Es, Gd^Fdw, Gll^Fmw, Gd^Fdw, Gll^Fmw, Gll^Fdw, Aa^Fdw, Aa^Fdw, Aa^Fda, Aa^Fda, Aa^Fda, Aa^Fma, Aa^Fdw, Ww, Ww, Ww, Re
Rd^Esd, Rd, Rd^Es, Re^Es, Gd^Fdw, Gll^Em, Gll^Fmw, Gll^Fp, Gll^Emf, Gll^Em, Hhd^Fmw, Aa^Fda, Aa^Fma, Ha^Fma, Aa^Em, Aa^Es, Rd^Es, Rd^Esd, Ww^Ewl, Ww, Ww^Ewl
Gd^Fdw, Gd^Fdw, Re, Re^Es, Gll^Fdw, Gll^Fmw, Gll^Em, Gll^Fmf, Gll^Fmw, Gd^Fmw, Hhd^Fdw, Aa^Em, Hhd^Fdw, Ha^Fda, Aa^Fma, Aa^Fda, Rd^Esd, Ww^Ewl, Rd, Re^Es, Gd^Em
Gll^Fmw, Gll^Em, Re, Gd^Es, Gll^Em, Gll^Em, Re, Gd^Vc, Re, Gd^Es, Gll^Fmw, Gll^Fmw, Hhd^Fdw, Aa^Em, Gd^Em, Aa^Fdw, Aa, Ww, Ww, Rd^Esd, Re
Gd, Gll^Fmw, Gd^Fdw, Re, Re, Re, Gd^Es, Re, Gd^Fmw, Re, Re, Gll^Fmf, Gd^Fp, Gd^Fmw, Gd^Fdw, Re, Rd, Re^Es, Ww, Ww^Ewl, Gd^Em
Gd^Em, Gll^Fmf, Gll^Fmw, Gll^Em, Gll^Fdw, Gd^Fdw, Gd^Fmw, Gd^Fdw, Gll^Fmf, Gll^Fmf, Re, Gll^Fmw, Gd^Fdw, Gd^Em, Gd^Fdw, Ww^Ewf, Ww, Ww, Ww^Ewf, Gd^Fdw, Gs^Efm
Gll^Fmf, Gll^Fmf, Gll^Em, Gll^Fmf, Gll^Fmf, Gd^Fmw, Gll^Fmf, Gd^Fmw, Gll^Fmw, Re, Re, Rd^Es, Re, Gd^Fdw, Re, Ww^Ewl, Ww, Ww^Ewl, Gs^Fmw, Gs^Fmw, Gs^Fp
Gll^Fp, Gll^Fmf, Gll^Fmf, Gll^Em, Gll^Fmf, Gll^Fdf, Gll^Fdf, Gd^Fmf, Gd^Es, Rd^Es, Rd^Es, Re, Gd^Fdw, Re, Gd^Fdw, Re, Ww^Ewf, Ww, Gd^Em, Gs^Efm, Gs^Fp
Gd^Em, Gll^Fmf, Gd^Fdf, Gll^Fmf, Gll^Fdf, Gll^Fdf, Gll^Fdf, Gd^Fmf, Gd^Fmf, Gll^Fmf, Gll^Fmf, Gd^Fmw, Gd^Fp, Gd^Fmw, Gll^Fmw, Re, Re, Gs^Em, Gs^Fmw, Gs^Fp, Gs^Fmw
Gll^Fmw, Gd^Emf, Gd^Fmw, Gd^Fdf, Gll^Fmf, Gll^Fdf, Gll^Fmf, Gll^Fmf, Gll^Fp, Gll^Fp, Gll^Fp, Gd^Fp, Gd^Vl, Gll^Fmw, Re, Re, Gs^Efm, Gd, Gs^Efm, Hhd^Fmw, Hhd^Fdw
Gd^Fmw, Gll^Fmw, Gd^Fmw, Gd^Fmf, Gd^Em, Gd^Fmw, Gll^Fp, Gd^Fmf, Gd^Fmw, Gll^Fmf, Gd^Fmw, Gd^Fmw, Re, Re, Gll^Fdw, Gll^Fmw, Hhd^Em, Gd^Fdw, Gd^Fp, Hhd^Fmw, Mm
Gd^Fdw, Gd^Fmw, Gd^Em, Hhd^Fdw, Hhd^Fdw, Gll^Fmf, Gll^Em, Gd^Fmw, Re, Gd^Fmw, Re, Gd^Em, Re, Gd^Em, Gd^Fmw, Gll^Fp, Hhd^Fp, Hhd^Fmw, Mm, Hhd^Fdw, Mm
Aa, Hhd^Fdw, Aa^Fda, Hhd^Fdw, Gd^Fmw, Gll^Em, Re, Re, Gll^Em, Re, Gd^Vh, Re, Gd^Em, Gd^Fmw, Gll^Fmf, Hhd, Hhd^Fmw, Hhd^Fp, Mm, Mm, Mm
Aa^Es, Ha^Em, Ha^Fda, Gd^Fdw, Gd^Es, Re, Gd^Fmw, Gll^Em, Gd^Fmf, Gll^Fmf, Gd^Fmw, Gd^Fmw, Gd^Fdf, Hhd^Fdf, Gll^Fdf, Hhd^Fmf, Gll^Fp, Hhd^Fmw, Hhd^Fmf, Hhd^Fmw, Hhd^Fmf
Ai, Ai, Ha^Fda, Aa^Em, Gd^Fdw, Re, Re^Es, Gll^Fmw, Gd^Fmw, Gd^Fp, Gll^Fmw, Hhd^Fmf, Hhd^Fmw, Gll^Fdf, Gll^Fmf, Gll^Fdf, Gll^Fmf, Gll^Fmf, Gll^Fdf, Gll^Fdf, Hhd^Fp
Ww, Ai, Aa^Es, Aa, Aa^Em, Gd^Es, Re, Gd^Em, Gd^Fmw, Gd^Fmw, Gd^Em, Gll^Fmw, Gll^Fmw, Gll^Fmf, Hhd^Fmw, Gd^Em, Hhd, Gll^Fmf, Hhd^Fdf, Gll^Fdf, Gll^Fmf
Ai, Ww, Ai, Aa^Fda, Aa^Fda, Gd^Fmw, Re, Gd^Fdw, Rp^Es, Gd^Fdw, Gd, Gd^Fdw, Re^Es, Hhd^Vhh, Gll^Emf, Hhd^Fdw, Hhd^Fmw, Hhd^Fmw, Hhd^Fp, Gll^Fmf, Gd
Ai, Ww, Ww, Aa^Es, Gd^Fdw, Gd^Fdw, Gd^Fmw, Rp, Gd^Fdw, Rp, Rp, Re^Es, Gd^Fdw, Gd^Em, Gd^Fdw, Gll^Fmw, Gll^Fp, Hhd^Fmw, Hhd, Gd^Em, Ww^Ewl
Aa^Fda, Ai, Aa^Fda, Ww, Ww, Ww^Ewl, Ww, Gd^Fmw, Ww, Wwf, Chw, Rp, Ww^Ewl, Gll^Em, Ww, Ww, Ww, Gll^Fmf, Ww^Ewl, Hhd^Fp, Ww
Aa^Fma, Aa^Fda, Aa, Ww^Ewl, Gd, Ww^Ewl, Gll^Fdw, Ww, Gll^Fdw, Ww^Ewl, Wwf, Wwf, Ww, Ww, Ww, Ww, Ww, Ww, Ww, Ww, Ww
Aa^Fma, Aa^Fma, Aa^Em, Ha^Fda, Ha^Fda, Gd^Em, Gll^Fmw, Gll^Fmw, Gll^Fp, Ww^Ewl, Ww, Rp, Rd^Esd, Ww, Ww^Ewl, Hhd^Fdw, Hhd^Fmw, Gd^Fmf, Ww, Ww^Ewl, Ww^Ewl
Ha^Em, Ha^Em, Aa^Fpa, Aa^Fma, Aa^Fma, Gd^Fdw, Gd^Fdw, Gll^Fp, Gll^Fmw, Gll^Fdw, Rd^Esd, Rp, Rd^Es, Re^Fdw, Gd^Fmw, Ww^Ewl, Hhd^Fp, Gd^Fdf, Hhd^Fdf, Ww^Ewl, Gd^Fmw
Ms, Ha^Fda, Ms, Ha^Fma, Aa^Fda, Aa^Fda, Aa^Fda, Gd^Em, Hhd^Fdw, Gll^Fmw, Gd^Em, Rp, Re^Fdw, Gd^Fmw, Gd^Fp, Gll^Fp, Gd^Em, Gll^Fp, Gll^Fmf, Hhd^Fmf, Gd^Fmw
Ms, Ms, Ms, Ha, Aa^Fma, Aa^Fma, Ha^Fda, Ha^Em, Md, Gll^Fmf, Gll^Fmw, Re, Gd^Fdw, Gd^Fmw, Gll^Fmf, Gll^Fmf, Hhd^Fdf, Gd^Emf, Gll^Fp, Gll^Fmf, Gll^Fmw
Ms, Ms, Ha^Em, Ha^Fda, Aa^Fpa, Aa^Fda, Ha^Fda, Ms, Hhd^Fdw, Hhd^Fp, Gll^Fmf, Re^Es, Re, Gd^Em, Gll^Fmw, Hhd^Fmf, Gll^Fmf, Gll^Fp, Gll^Fmf, Gll^Fmw, Gll^Fdw
Ha^Em, Ha^Fma, Ha^Em, Aa^Fma, Aa^Fpa, Aa^Fma, Gd^Fdw, Hhd^Em, Re^Es, Gd, Re, Rd^Es, Ce, Re, Re^Vct, Gll^Fmw, Hhd^Em, Hhd^Fp, Hhd^Fmw, Gll^Fdw, Gd^Em
Aa^Fma, Aa^Fpa, Aa^Fda, Aa^Fda, Ha^Em, Ha^Fma, Gd^Em, Re, Hhd^Es, Gd^Fmw, Rd, Rd, 1 Ke, Ce, Gd^Fdw, Gd^Fdw, Gd^Fdw, Hhd^Fdw, Gd^Fmw, Gd^Fmw, Gd^Em
Gd^Fdw, Aa^Fma, Ha^Fmw, Aa^Fma, Hhd^Fdw, Ha^Fda, Gd^Fmw, Hhd^Fmf, Gd, Hhd^Fdw, Rd^Es, Ce, Re^Es, Re^Vct, Gd^Em, Gd^Fdw, Aa^Fda, Gd^Em, Gd^Fdw, Gd^Fdw, Gd^Fdw
Aa^Fda, Ha^Fdw, Gd^Fdw, Aa^Fdw, Hhd^Em, Hhd^Em, Gd, Gd^Fdw, Re, Re, Re^Es, Re^Es, Gd, Re, Gll^Fdw, Gd^Em, Aa^Fda, Aa^Em, Aa^Fda, Aa^Em, Aa^Fda
Gd^Fdw, Aa^Fda, Gll^Fmw, Re^Vl, Re^Es, Gd^Es, Re, Re^Es, Gd, Gd, Re^Es, Gd^Em, Gd^Fmw, Gd^Em, Gll^Fdw, Aa^Fda, Aa^Fma, Aa^Fma, Aa^Em, Aa^Em, Ha^Fma
Gll^Fmw, Gll^Fdw, Gll^Fdw, Gll^Fmw, Gll^Fmf, Re^Es, Re, Gd, Gd^Es, Gd^Fdw, Gd^Fmw, Gd^Fmw, Gd^Fp, Gd^Fmw, Gd^Em, Gll^Fdw, Aa^Fma, Aa^Fma, Aa^Fma, Aa^Fpa, Aa^Fda
Gll^Fp, Gll^Fmw, Gll^Fp, Gll^Emf, Gd^Em, Gd, Re^Es, Gd^Fmw, Gd, Gd^Em, Gd^Fmf, Gd^Fp, Gd^Fp, Gd^Fmw, Gd^Em, Aa^Fda, Aa^Fda, Ha^Fma, Aa^Em, Ha^Fpa, Ha^Fma
Gll^Fp, Gll^Fmw, Gll^Fmw, Gll^Fmw, Gd, Gd^Fmf, Gll^Fdw, Re, Re, Gd^Fdw, Gll^Fdf, Gd^Fmf, Gd^Fmw, Gd^Fdw, Gll^Fdw, Aa^Em, Aa^Fda, Aa^Em, Ha^Fma, Aa^Fma, Aa
