Ss, Sm, Ss, Sm, Sm^Em, Ss, Gll^Fdw, Gll^Fmw, Rb, Gll^Fmw, Gll^Fmw, Gd, Gd^Fmw, Gd, Gd^Fdw, Gd, Ww, Ww, Ww, Ds, Rd, Gd, Aa, Aa, Ha^Fda, Ha, Ha, Ms, Ha^Fda, Hh, Ms, Ms, Ha^Fda, Ha, Aa
Ss^Em, Sm^Uf, Sm^Em, Sm^Uf, Sm^Em, Sm^Em, Ss^Em, Sm^Em, Gll^Fmw, Gll^Fmw, Rd^Es, Rd^Es, Gd^Fdw, Gd^Em, Ww, Gd^Es, Gd^Es, Ww, Wwf, Ds^Esd, Gd^Fdw, Hhd, Ha^Fma, Aa, Aa^Fda, Aa^Fda, Ha^Fma, Ha, Ha, Ms, Aa, Ha^Fpa, Aa^Vha, Aa, Re
Ss, Ss^Em, Sm^Edb, Sm^Emf, Sm^Edb, Ss^Vhs, Ss^Em, Ss, Hhd^Fdw, Gll^Fmw, Gll^Fp, Gd^Em, Rd^Es, Gd, Gd^Fdw, Ww, Ww, Ww, Wwf, Rd, Rd, Re, Re, Re, Aa, Aa^Fda, Aa, Aa^Fda, Re, Ha^Fda, Re, Aa, Re, Re, Aa
Gll^Fdw, Gll^Fdw, Ss^Em, Ss, Ss^Emf, Ss^Em, Sm^Emf, Sm^Uf, Gll^Fmw, Hhd, Gd^Vl, Gd^Fdw, Rd^Es, Rd, Gd^Fdw, Wwf, Wwf, Ww, Ds, Rd, Gd^Fdw, Re, Rd, Hhd^Fdw, Rd, Re, Re, Re, Hhd, Re, Ha^Fda, Re, Aa, Ha^Fda, Ha
Re^Es, Gd^Fdw, Hhd^Fdw, Gll^Fmw, Ss^Uf, Hhd^Fdw, Hhd, Gll^Fdw, Hhd^Fp, Hhd, Gll^Fp, Gd^Em, Gd^Fdw, Rd^Es, Gd, Ds^Esd, Wwf, Ww, Ww, Ds^Esd, Wwf, Gd, Ww, Ds, Ds^Esd, Gd^Vc, Re, Rd, Rd, Hhd^Fdw, Rd, Ha, Aa^Fda, Ha, Aa^Fda
Gd^Fdw, Re^Es, Gll^Fdw, Gll^Fdw, Hhd^Fdw, Gll^Fmw, Hhd^Fp, Hhd, Hhd^Fp, Gll^Fmw, Hhd, Gll^Fmw, Gd^Em, Rd^Es, Gd^Fmw, Gs^Vh, Ds^Esd, Ww, Wwf, Ww, Ww, Ww, Wo, Ww, Rd, Re, Aa, Aa^Fda, Rd, Re, Hhd, Gd^Fdw, Gll^Fmw, Gd^Fdw, Gll^Fmw
Gd^Es, Re^Em, Hh^Fdw, Gll^Fmw, Gs^Fdw, Gll^Fp, Hhd, Gll^Fmw, Hhd, Gll^Fmw, Gs^Efm, Gll^Fmw, Gd^Fdw, Gd, Rd^Es, Rd^Es, Gd^Fdw, Ds, Gd, Wwf, Ds^Esd, Ww, Ww, Ww, Ww, Cha, Aa, Rd, Rd, Re^Vh, Hhd^Fdw, Gd, Gll^Fmw, Gd^Fdw, Gd
Gd^Fdw, Gd^Em, Gs^Fp, Gs^Fp, Gs^Fmw, Hhd, Hhd^Fp, Hhd^Fmw, Gs^Fdw, Gs^Em, Hhd, Hhd^Fmw, Gd^Em, Gd^Em, Gd^Fmw, Gs^Vc, Rd^Eff, Rd, Gd^Fmw, Gd^Fdw, Gs, Ds^Esd, Gd^Es, Ww, Ww^Bw/, Re, Ai, Gd, Re, Re, Re, Gd, Gd^Fdw, Gll^Fmw, Gll^Fmw
Gll^Fmw, Hh^Fdw, Hh^Fmw, Gs^Efm, Gs^Fp, Gg^Fet, Gd^Fp, Gs^Fmw, Gs^Efm, Gd^Fmw, 2 Gd^Fdw, Hhd, Gs^Vh, Gd^Fmw, Gd^Wm, Re^Gvs, Re^Gvs, Gs^Eff, Rd^Eff, Re^Em, Gd^Fdw, Re^Es, Rr, Ww^Bw/, Ww, Ww, Ww, Ai, Wwf, Gd, Re, Gd^Fdw, Gd, Hh^Fdw, Hh
Gs, Gll^Fp, Gll^Fp, Gs^Em, Gs^Fdw, Gd^Fp, Hh^Fp, Gs^Efm, Gs^Fp, Gd^Fmw, Gs^Em, Gs^Efm, Hh^Fdw, Re, Gd^Eff, Re^Gvs, Re^Gvs, Re^Gvs, Rd^Eff, Re^Eff, Rrc^Vhca, Cha, Rr, Ai, Cha, Ww, Wo, Ww, Ww, Re, Gll^Fdw, Hhd, Hhd^Fmw, Md, Hh
Gll^Fmw, Gd^Fdw, Gll^Fdw, Gd^Fmw, Re^Es, Hh^Fdw, Gd^Fp, Gs^Fdw, Gs^Fmw, Gd^Fdw, Gd, Re, Re^Es, Re^Es, Re, Gs^Eff, Gs^Eff, Gs^Eff, Gd^Es, Ch, Rr, Rr, Rr, Rr, 1 Kha, Ai, Wo, Wo, Wo, Ww, Gll^Fdw, Hhd^Fmw, Md, Md, Md
Gd^Fmw, Gll^Emf, Gd^Fmw, Re^Fp, Re^Es, Hh^Fmw, Gd^Fdw, Gd^Fdw, Gs^Em, Gd^Fdw, Gd^Em, Gd^Fdw, Re^Es, Gd^Fdw, Gd, Gd^Es, Gs^Fdw, Gd^Fdw, Gs^Efm, Ch, Rr^Vhc, Rr, Rr, Cha, Cha, Ww^Bw\, Wo, Wo, Ww, Ww, Hhd^Fmw, Md, Md, Md, Ms
Gll^Fdw, Gd^Fdw, Gll^Emf, Gd^Fmw, Gll^Fmw, Gd^Fdw, Gd^Em, Gll^Fmw, Gd^Fdw, Gd, Gs^Fdw, Gs^Fmw, Gd, Re, Rr^Es, Ce, Rr, Re, Gd^Fdw, Ch, Cha, Rr, Rrc^Vhca, Cha, Rr, Ww^Bw\, Wo, Ww, Ai, Hhd, Md, Md, Ms, Md, Ms
Gll^Fdw, Gll^Fdw, Re^Em, Gd^Fdw, Gll^Fdw, Re^Es, Gll^Fdw, Gd^Em, Gd, Gd^Em, Gd, Gs^Vl, Gd, Rr^Es, Ce, Gd, Rr, Gs^Efm, Rr, Rr, Rr, Rr, Cha, Rr, Ai, Ww^Bw\, Ww, Ww, Ai, Ha, Ms, Ha^Fda, Ha^Fda, Aa^Fda, Ha^Fpa
Gll, Ss^Em, Ss^Uf, Re^Es, Ss, Sm^Em, Gll^Fdw, Gll^Fmw, Gd, Rd, Aa, Rd^Es, Gd^Fdw, Rr, Ce, Gd^Vc, Rd, Rr, Gs^Vh, Gs^Efm, Gs, Cha, Gs^Fp, Rr, Ai, Wo, Ww, Ww, Gd^Fmw, Hhd^Fdw, Ha, Aa^Fda, Ha^Fda, Ha, Ai
Ss^Emf, Gll^Fdw, Sm^Vhs, Rb^Em, Gll^Fdw, Ss^Em, Rd^Es, Rd^Es, Gll^Fdw, Rd^Es, Rd^Es, Aa^Fda, Rd, Aa, Aa^Fda, Aa^Fda, Gd^Fmw, Rd, Gs^Vh, Ww^Bw\, Ww^Bw\, Ww, Wo, Ww, Ww, Ww, Ww, Ww, Gd^Fdw, Hhd^Fdw, Hhd, Aa, Aa^Fda, Ha^Fpa, Ai
Ss^Em, Rb^Fdw, Sm^Em, Sm^Em, Ss^Uf, Gll^Fmw, Gd^Em, Aa, Aa, Aa^Fda, Aa^Fda, Aa, Aa, Ai, Ww, Ai, Gd^Fmw, Re, Ww, Ww^Bw\, Wo, Wo, Wo, Wo, Ww, Ww, Ww^Bw\, Ww, Ww, Ww, Ai, Aa, Aa, Wwf, Ww
Gll^Fdw, Sm^Em, Ss, Ss, Ss^Emf, Re^Em, Aa, Ai, Ww, Ai, Aa, Ww, Ww, Ww, Ww, Wwf, Wwf, Wwf, Wwf, Wo, Wo, Wo, Ww^Bw\, Ww, Ww, Ww, Rd, Gd^Vh, Aa, Ww, Ai, Aa^Fda, Aa^Fda, Ww, Aa^Fda
Wwg, Sm^Em, Sm, Sm^Em, Re^Fdw, Re^Fdw, Aa^Fda, Ww, Ww, Ai, Ww, Ww, Wo, Wo, Ww, Ai, Wwf, Ai, Ai, Ai, Ww, Ww, Ww, Gs^Vh, Rd, Gd^Fdw, Rd, Rd, Aa, Aa^Fda, Ww, Ww, Ww, Ai, Ai
Wwg, Wwg, Wwg, Wwg, Ww, Ai, Wo, Wo, Wo, Ww, Gll^Fdw, Ww, Ww, Wo, Wo, Ai, Aa, Re, Aa^Fdw, Aa, Aa, Gs^Fdw, Gs^Fmw, Rd, Rd, Gd, Rd, Aa^Fda, Ha, Ha^Fda, Aa^Fda, Aa, Aa, Ai, Aa^Fda
Gd, Wwg, Wwg, Wwg, Ai, Wo, Ai, Wo, Ww, Ww, Ww, Ww, Ww, Ai, Ai, Aa, Ha^Fda, Re, Re, Aa, Gd, Rd^Fdw, Rd, Gd^Fdw, Rd, Rd, Rd, Wwf, Ww, Ww, Aa^Fma, Aa^Fma, Ha, Ww, Ww
Ss^Em, Rb, Rb^Es, Rb^Es, Aa, Ha, Ha^Fda, Ai, Aa^Fda, Ha, Ww, Ai, Ai, Aa^Fda, Aa, Aa^Fma, Ha^Fma, Hh^Fdw, Aa, Re, Rd, Aa^Vha, Aa, Aa, Rd, Gd^Fdw, Wwf, Ww, Ww, Wo, Ha^Fda, Ha, Wo, Ww, Ha
Rb^Em, Sm^Em, Gll^Fmw, Gd^Fdw, Gll^Emf, Aa^Fda, Hhd^Fpa, Ha^Fpa, Hhd^Fmw, Aa^Fda, Ai, Ai, Ha^Fda, Aa^Vha, Aa, Ha, Aa, Aa, Aa, Aa^Fda, Rd, Aa^Fda, Aa, Gd^Fdw, Rd, Gd^Fmw, Wwf, Hhd^Fdw, Mm, Wo, Ms, Ms, Wo, Mm, Ha
Ss^Em, Rb, Re^Em, Gll^Fmw, Gd^Fdw, Gd^Fdw, Hhd^Fdw, Aa^Fda, Hhd^Es, Hhd^Es, Aa^Fda, Ww, Ai, Ha^Fda, Aa, Aa^Fda, Gd, Aa^Fda, Ha^Fma, Ha, Re, Gd^Fdw, Aa, Gd, Gs^Vc, Hhd, Ha, Aa^Fda, Mm, Ha, Mm, Ms, Mm, Ms, Ms
Sm, Sm^Em, Gll^Emf, Gd^Fdw, Gd, Gll^Fmw, Gd^Fdw, Gd^Emf, Ha^Fmw, Ha^Es, Aa^Fma, Aa, Aa^Fma, Ha, Aa^Fda, Gd^Fdw, Aa, Aa^Fda, Ha, Aa^Fma, Aa, Re, Re, Gd^Fmw, Aa^Fdw, Hhd, Aa^Fda, Ai, Aa^Fda, Aa^Fda, Mm, Mm, Mm, Mm, Ms
Ss^Uf, Ss^Em, Gll^Fdw, Gll^Fmw, Gll^Fdw, Gd, Gll^Fmw, Aa, Aa, Ha^Fda, Gd, Ai, Ww, Ai, Gd, Re, Re, Aa, Aa^Fda, Aa^Fma, Hh, Gd^Vc, Aa^Fma, Re, Aa, Ww, Ai, Ha^Fda, Ha^Fda, Mm, Mm, Mm, Wo, Mm, Mm
Gs^Fdw, Gll^Em, Re, Re^Em, Gll, Gll^Em, Re, Aa^Fma, Gd^Fdw, Re, Aa, Ai, Aa^Fda, Re, Ai, Gll^Fmw, Aa, Gd^Fmw, Aa, Ha, Hh^Fdw, Aa, Aa^Fda, Re, Hh, Ha, Hh, Ha^Fda, Ai, Ms, Mm, Mm, Mm, Wo, Ww
