Gs^Fp, Gs^Fp, Gs^Fp, Gs^Fp, Gs^Fp, Gs^Fp, Gs^Fp, Gs^Fp, Gs^Fp, Gs^Fp, Gs^Fp, Gs^Fp, Gs^Fp, Gs^Fp, Gs^Fp, Gs^Fp, Gs^Fp, Gs^Fp, Gs^Fp, Gs^Fp, Gs^Fp, Gs^Fp
Gs^Fp, Gs^Fp, Gs^Fp, Gs^Fp, Gs^Fp, Gs^Fp, Gs^Fp, Gs^Fp, Gs^Fp, Gs^Fp, Gs^Fp, Gs^Fp, Gs^Fp, Gs^Fp, Gs^Fp, Gs^Fp, Gs^Fp, Gs^Fp, Gs^Fp, Gs^Fp, Gs^Fp, Gs^Fp
Gs^Fp, Gs^Fp, Gs^Fp, Gs^Fp, Gs^Fp, Gs^Fp, Gs^Fp, Gs^Fp, Gg^Fet, Gs^Fp, Gs^Fp, Gs^Fp, Gs^Fp, Gs^Fp, Gs^Fp, Gs^Fp, Gs^Fp, Gs^Fp, Gs^Fp, Gs^Fp, Gs^Fp, Gs^Fp
Gs^Fp, Gs^Fp, Gs^Fp, Gs^Fp, Gs^Fp, Gs^Fp, Hh, Hh, Hh, Hh, Hh, Gs^Fp, Gs^Fp, Gs^Fp, Gs^Fp, Gs^Fp, Gs^Fp, Gs^Fp, Gs^Fp, Gs^Fp, Gs^Fp, Gs^Fp
Gs^Fp, Gs^Fp, Gs^Fp, Gs^Fp, Hh, Hh, Hh, Hh, Mm, Hh, Hh, Hh, Hh, Gs^Fp, Gs^Fp, Gs^Fp, Gs^Fp, Gs^Fp, Gs^Fp, Gs^Fp, Gs^Fp, Gs^Fp
Gs^Fp, Gs^Fp, Hh, Hh, Hh, Hh, Mm, Mm, Mm^Xm, Mm, Mm, Hh, Hh, Hh, Hh, Gs^Fp, Gs^Fp, Gs^Fp, Gs^Fp, Gs^Fp, Gs^Fp, Gs^Fp
Hh, Hh, Hh, Hh, Mm, Mm, Mm^Xm, Mm^Xm, Mm, Mm^Xm, Mm^Xm, Mm, Mm, Hh, Hh, Hh, Hh, Gs^Fp, Gs^Fp, Gs^Fp, Gs^Fp, Gs^Fp
Hh, Hh, Mm, Mm, Mm^Xm, Mm^Xm, Mm, Mm, Wo, Mm, Mm, Mm^Xm, Mm^Xm, Mm, Mm, Hh, Hh, Gg^Fet, Gs^Fp, Gs^Fp, Gs^Fp, Gs^Fp
Mm, Mm, Mm^Xm, Mm^Xm, Mm^Xm, Mm, Wo, Wo, Ch^Ebn, Wo, Wo, Mm, Mm^Xm, Mm^Xm, Mm^Xm, Mm, Hh, Hh, Gs^Fp, Gs^Fp, Gs^Fp, Gs^Fp
Mm, Mm, Mm^Xm, Mm^Xm, Mm, Mm, Wo, Ch^Ebn, Kh, Ch^Ebn, Wo, Mm, Mm, Mm^Xm, Mm^Xm, Mm, Hh, Hh, Gs^Fp, Gs^Fp, Gs^Fp, Gs^Fp
Mm, Mm, Mm^Xm, Mm, Wo, Wo, Ch, Ch, Ch, Ch, Ch, Wo, Wo, Mm, Mm^Xm, Mm, Hh, Hh, Gs^Fp, Gs^Fp, Gs^Fp, Gs^Fp
Mm, Mm, Mm^Xm, Mm, Wo, Ch^Ebn, Kh, Ch, Ch, Ch, Kh, Ch^Ebn, Wo, Mm, Mm^Xm, Mm, Hh, Hh, Gs^Fp, Gs^Fp, Gs^Fp, Gs^Fp
Mm, Mm, Mm^Xm, Mm, Wo, Ch^Ebn, Ch, Ch, Ch, Ch, Ch, Ch^Ebn, Wo, Mm, Mm^Xm, Mm, Hh, Hh, Gs^Fp, Gs^Fp, Gs^Fp, Gs^Fp
Mm, Mm, Mm^Xm, Mm, Mm, Wo, Wo, Ch, Kh, Ch, Ch, Wo, Wo, Mm, Mm^Xm, Mm, Hh, Hh, Gs^Fp, Gs^Fp, Gs^Fp, Gs^Fp
Mm, Mm, Mm^Xm, Mm^Xm, Mm^Xm, Mm, Wo, Ch^Ebn, Ch^Ebn, Ch^Ebn, Wo, 2 Kh, Ww^Bsb\, Mm, Mm^Xm, Mm, Gg^Fet, Gs^Fp, Gg^Fet, Gs^Fp, Gs^Fp, Gs^Fp
Hh, Mm, Mm, Mm^Xm, Mm^Xm, Mm, Mm, Wo, Wo, Wo, Wo, Wo, Mm, Rr, Rr, Gg^Fet, Rr, Gg^Fet, Rr, Gg^Fet, Gg^Fet, Gs^Fp
Hh, Hh, Hh, Mm, Mm, Mm^Xm, Mm^Xm, Mm, Mm, Mm, Mm, Mm, Mm^Xm, Mm^Xm, Gg^Fet, Rr, Gg^Fet, Rr, Gg^Fet, Rr, 1 Rr, Rr
Gs^Fp, Hh, Hh, Hh, Hh, Mm, Mm, Mm^Xm, Mm^Xm, Mm^Xm, Mm^Xm, Mm^Xm, Mm, Mm, Hh, Gg^Fet, Hh, Gg^Fet, Gs^Fp, Gg^Fet, Gg^Fet, Gs^Fp
Gs^Fp, Gs^Fp, Gs^Fp, Hh, Hh, Hh, Hh, Mm, Mm, Mm^Xm, Mm, Mm, Hh, Hh, Hh, Hh, Gs^Fp, Gs^Fp, Gs^Fp, Gs^Fp, Gs^Fp, Gs^Fp
Gs^Fp, Gs^Fp, Gs^Fp, Gs^Fp, Gs^Fp, Hh, Hh, Hh, Hh, Mm, Hh, Hh, Hh, Hh, Gs^Fp, Gs^Fp, Gs^Fp, Gs^Fp, Gs^Fp, Gs^Fp, Gs^Fp, Gs^Fp
Gs^Fp, Gs^Fp, Gs^Fp, Gs^Fp, Gs^Fp, Gs^Fp, Gs^Fp, Hh, Gg^Fet, Hh, Gg^Fet, Hh, Gs^Fp, Gs^Fp, Gs^Fp, Gs^Fp, Gs^Fp, Gs^Fp, Gs^Fp, Gs^Fp, Gs^Fp, Gs^Fp
Gs^Fp, Gs^Fp, Gs^Fp, Gs^Fp, Gs^Fp, Gs^Fp, Gs^Fp, Gs^Fp, Gs^Fp, Hh, Gs^Fp, Gs^Fp, Gs^Fp, Gs^Fp, Gs^Fp, Gs^Fp, Gs^Fp, Gs^Fp, Gs^Fp, Gs^Fp, Gs^Fp, Gs^Fp
