Gg, Gg^Efm, Gg, Gg, Hh, Mm, Mm, Mm, Mm, Mm, Mm, Mm, Hh, Hh, Gg, Ww, Ww, Ww, Gg, Gg, Gg, Hh, Hh, Mm, Mm, Mm, Mm, Mm, Mm, Mm, Hh, Hh, Gs^Fp, Gs^Fp, Gs^Fp, Gs^Fp, Gs^Fp, Gs^Fp, Gs^Fp, Gs^Fp
Rp, Rp, Rp, Gg, Hh, Mm, Mm, Mm, Mm, Mm, Mm, Mm, Hh, Hh, Gg, Ww, Ww, Ww, Gg, Gg, Gg, Hh, Hh, Mm, Mm, Mm, Mm, Mm, Mm, Mm, Hh, Hh, Gs^Fp, Gs^Fp, Gs^Fp, Gs^Fp, Gs^Fp, Gs^Fp, Gg^Fet, Gs^Fp
Gg, Gg, Gg, Rp, Rp, Hh, Ch, 2 Kh, Ch, Mm, Hh, Hh, Gg, Gg, Gg^Vh, Ww, Ww, Gg, Gs^Fp, Gg, Gg, Gg, Gg, Hh, Hh, Mm, Mm, Mm, Mm, Mm, Hh, Gs^Fp, Gs^Fp, Gs^Fp, Gs^Fp, Gs^Fp, Gs^Fp, Gs^Fp, Gs^Fp, Gs^Fp
Hh, Hh, Gg^Vh, Gg, Rp, Gg, Gg, Ch, Hh, Hh, Hh, Hh, Hh, Gg, Re^Gvs, Ds, Ww, Gg, Gg, Gg, Gs^Fp, Gs^Fp, Gg, Hh, Gg, Hh, Hh, Hh, Hh, Hh, Gs^Fp, Gs^Fp, Gs^Fp, Gs^Fp, Gs^Fp, Gs^Fp, Gs^Fp, Gs^Fp, Gs^Fp, Gs^Fp
Hh, Hh, Hh, Gg, Gg, Rp, Gg, Gg, Hh, Hh, Gg, Hh, Hh, Re^Gvs, Re^Gvs, Re^Gvs, Re^Gvs, Ww, Gg, Gg, Re^Gvs, Gg, Gg, Gg, Gg, Hh, Hh, Hh, Hh, Hh, Hh, Gs^Fp, Gs^Fp, Gg^Fet, Gs^Fp, Gs^Fp, Gs^Fp, Gs^Fp, Gs^Fp, Gs^Fp
Mm, Mm, Hh, Hh, Gg^Efm, Rp, Rp, Gg, Gg, Hh, Gg, Gg, Gg, Hh, Re^Gvs, Re^Gvs, Re^Gvs, Ww, Ww, Re^Gvs, Re^Gvs, Re^Gvs, Gg^Vh, Gg, Gg, Hh, Gg^Efm, Hh, Gg^Efm, Gg, Gg, Gs^Fp, Gs^Fp, Gs^Fp, Gs^Fp, Gs^Fp, Gs^Fp, Gg^Ve, Gs^Fp, Gs^Fp
Mm, Mm, Mm, Hh, Gg^Efm, Gg^Efm, Rp, Gg, Gg^Vh, Gg, Gg, Gg, Gg, Gg^Wm, Re^Gvs, Re^Gvs, Re^Gvs, Ww, Re^Gvs, Re^Gvs, Re^Gvs, Re^Gvs, Gg, Gg, Gg, Gg^Efm, Gg^Efm, Gg^Efm, Re, Gs^Fp, Gs^Fp, Gs^Fp, Gs^Fp, Gs^Fp, Gs^Fp, Gs^Fp, Gg, Gs^Fp, Re, Re
Mm, Mm, Mm, Hh, Hh, Gg, Rp, Gg, Gg, Gg, Gg, Gg, Gs^Fp, Gg, Gg, Re^Gvs, Re^Gvs, Ww, Ww, Re^Gvs, Gs^Fp, Gg, Gg, Gg, Gg, Gg, Gs^Fp, Re, Gs^Fp, Gs^Fp, Gs^Fp, Gs^Fp, Gs^Fp, Gs^Fp, Re, Re, Re, Gg, Gs^Fp, Gs^Fp
Mm, Mm, Hh, Hh, Hh, Gg, Rp, Gg, Gg, Gg, Gg, Gs^Fp, Gs^Fp, Gg, Gg, Re^Gvs, Gs^Fp, Gs^Fp, Gs^Fp, Ww, Gs^Fp, Gg, Gg, Gg, Gs^Fp, Gs^Fp, Gs^Fp, Gs^Fp, Re, Gg, Gs^Fp, Re, Gg, Gg, Gs^Fp, Gs^Fp, Gs^Fp, Gs^Fp, Gs^Fp, Gs^Fp
Hh, Hh, Gg, Gg, Gg, Gg, Gg, Rp, Rp, Gg, Gg, Gg, Gs^Fp, Gs^Fp, Gg, Gs^Fp, Gs^Fp, Gs^Fp, Gs^Fp, Ww, Gs^Fp, Gs^Fp, Gs^Fp, Gs^Fp, Gg, Gs^Fp, Gg, Re, Gs^Fp, Gs^Fp, Gs^Fp, Gs^Fp, Gs^Fp, Gs^Fp, Gs^Fp, Gs^Fp, Gs^Fp, Gs^Fp, Gs^Fp, Gs^Fp
Gg, Gg, Re^Gvs, Gg, Gg, Gg, Rp, Rp, Gg, Rp, Gg, Gg, Gg^Efm, Gg^Efm, Gg^Efm, Gs^Fp, Gs^Fp, Gs^Fp, Gs^Fp, Ww, Gs^Fp, Gg^Fet, Gs^Fp, Gs^Fp, Gg^Vh, Gg^Efm, Gg, Gg, Gs^Fp, Gs^Fp, Gg^Fet, Gs^Fp, Gs^Fp, Gs^Fp, Gg, Gs^Fp, Gg, Gs^Fp, Gs^Fp, Gs^Fp
Gs^Fp, Gs^Fp, Re^Gvs, Gg^Vh, Re^Gvs, Rp, Gg, Gg, Gg, Rp, Gg, Gg, Gg, Gg^Efm, Gg^Vh, Gg, Gg, Gs^Fp, Gs^Fp, Ww, Gs^Fp, Gs^Fp, Gs^Fp, Gs^Fp, Gs^Fp, Re, Re, Gg, Gs^Fp, Gs^Fp, Gs^Fp, Gs^Fp, Gg, Gg, Gg, Gg, Gg, Gs^Fp, Gs^Fp, Gs^Fp
Gs^Fp, Gs^Fp, Gs^Fp, Re^Gvs, Re^Gvs, Re^Gvs, Gs^Fp, Gs^Fp, Gg, Rp, Rp, Gg, Gg, Gg, Gg, Gg, Gs^Fp, Gs^Fp, Ww, Ww, Gs^Fp, Gs^Fp, Gs^Fp, Gs^Fp, Gs^Fp, Gs^Fp, Re, Gs^Fp, Gs^Fp, Gs^Fp, Gg, Gg, Gg, Gg, Ww, Ww, Gg, Gg, Gs^Fp, Gs^Fp
Gs^Fp, Gs^Fp, Re^Gvs, Re^Gvs, Re^Gvs, Re^Gvs, Gs^Fp, Gs^Fp, Gg, Gg, Gg, Rp, Gg, Gg, Gg, Gg, Ds, Ww, Ww, Ww, Gg, Gs^Fp, Gs^Fp, Gg^Fet, Gs^Fp, Gs^Fp, Re, Gs^Fp, Gs^Fp, Gs^Fp, Gg, Gg, Gg, Ww, Ww, Ww, Gg, Gg, Hh, Hh
Gs^Fp, Gs^Fp, Gs^Fp, Re^Gvs, Gs^Fp, Gs^Fp, Gs^Fp, Gs^Fp, Gg, Gg, Gg, Rp, Gg, Gg, Gg, Ds, Ww, Ww, Ww, Gg, Gg, Gg, Gg, Gs^Fp, Re, Re, Gs^Fp, Gs^Fp, Gg, Gg, Gg, Gg, Gg, Gg, Gg, Gg, Gg, Hh, Hh, Hh
Gs^Fp, Gs^Fp, Gs^Fp, Gs^Fp, Gs^Fp, Gs^Fp, Gs^Fp, Gg, Gg, Gg^Wm, Gg, Rp, Rp, Gg, Gg, Ww, Ww, Ww, Gg, Gg, Rr, Ch, Gg^Vh, Gg, Gg, Gg, Gg, Gg, Gg, Gg, Gg, Gs^Fp, Gg, Gg, Gs^Fp, Gg, Hh, Hh, Hh, Hh
Gs^Fp, Gs^Fp, Gs^Fp, Gs^Fp, Gs^Fp, Gs^Fp, Gg, Gg, Gg, Re, Gg, Gg, Rp, Gg, Ww, Ww, Ww, Gg, Rr, Ch, Ch, Ch, Ch, Gg, Gg, Gs^Fp, Gg, Gg, Gg, Gg, Gg, Gg, Gg^Vh, Re^Gvs, Re^Gvs, Gg, Hh, Gg, Hh, Hh
Gs^Fp, Gs^Fp, Gg, Gs^Fp, Re^Gvs, Re^Gvs, Re^Gvs, Gg, Re, Re, Gg, Gg, Gg, Ds, Ww^Bsb\, Ww, Gg, Gg, Rr, Rr, Ch, 1 Kh, Ch, Gg, Gg, Gg, Gg, Gs^Fp, Gs^Fp, Gg, Gg, Gs^Fp, Gs^Fp, Re^Gvs, Re^Gvs, Re^Gvs, Gg, Gg, Hh, Hh
Gs^Fp, Gs^Fp, Re^Gvs, Re^Gvs, Re, Re, Re, Re, Gg, Gg, Gg^Vh, Gg, Gg, Ds, Ww, Ds, Rr, Rr, Gg, Ch, Gg, Ch, Gg^Vh, Ch, Gg, Gg, Gg, Gg, Re^Gvs, Gg, Gg, Gg, Gg, Gs^Fp, Gg, Gg, Gg, Hh, Hh, Hh
Gg, Re^Gvs, Re, Gg^Vh, Re, Gg, Gg, Gg, Gs^Fp, Gg, Gg^Efm, Gg^Efm, Gg, Gg, Ww, Ww, Ww, Gg, Gg, Gg, Gg, Gg, Gg, Gg, Gg^Efm, Gg^Efm, Gg, Re^Gvs, Gg^Vh, Gs^Fp, Gg, Gs^Fp, Gg, Gg, Gg, Gg, Hh, Hh, Hh, Hh
Re, Re, Gg, Re, Gg, Gg, Gs^Fp, Gg, Gs^Fp, Gs^Fp, Gs^Fp, Gg^Efm, Gs^Fp, Gg, Ww, Ww, Ww, Gg, Gs^Fp, Gs^Fp, Gg, Gg, Gg, Gg^Efm, Gg^Efm, Gg^Efm, Gg, Gs^Fp, Re^Gvs, Gs^Fp, Gs^Fp, Gg, Gg, Gg, Gg, Gg, Gg, Gg, Hh, Hh
Gs^Fp, Gs^Fp, Gs^Fp, Gg, Gs^Fp, Gs^Fp, Gs^Fp, Gs^Fp, Gs^Fp, Gs^Fp, Gs^Fp, Gs^Fp, Gg, Gs^Fp, Ww, Ww, Gg^Wm, Gg, Gg, Gg, Gg, Gg, Gg, Gg, Gg, Gg, Gg, Gg, Gs^Fp, Re^Gvs, Gg, Gg, Hh, Gg, Gg, Gg, Gg, Gg, Gg, Gg
Gs^Fp, Gs^Fp, Gs^Fp, Gs^Fp, Gs^Fp, Gs^Fp, Gg, Gg, Gg, Gs^Fp, Gg, Gs^Fp, Ww, Ww, Ww, Ww, Ww, Gg, Ww, Ww, Ww, Gg, Gg, Hh, Hh, Hh, Hh, Gg, Gg, Gg, Gg, Gg, Hh, Gg, Gg, Gg, Gg, Gg, Gg, Gg
Gs^Fp, Gs^Fp, Gs^Fp, Gs^Fp, Gg, Gg, Gg, Gg, Gg, Gg, Gg, Gg, Ww, Ww, Ww, Wo, Ww, Ww, Ww, Ww^Bw\, Gg, Gg, Gg^Vh, Gg, Re^Gvs, Hh, Hh, Gg, Gg, Gg, Gg, Hh, Hh, Hh, Hh, Gg, Gg, Gg, Gg, Gg
Gs^Fp, Gs^Fp, Gs^Fp, Gs^Fp, Gs^Fp, Gg, Gg, Gg, Gg, Ww, Ww, Ww, Wo, Wo, Wo, Wo, Wo, Wo, Wo, Ww, Ww, Gg, Re^Gvs, Re^Gvs, Re^Gvs, Hh, Hh, Hh, Hh, Hh, Hh, Hh, Mm, Hh, Hh, Hh, Hh, Hh, Hh, Hh
Gs^Fp, Gs^Fp, Gs^Fp, Gs^Fp, Gs^Fp, Gg, Gg, Gg^Vh, Gg, Ww, Ww, Wo, Wo, Wo, Wo, Wo, Ww, Wo, Wo, Wo, Ww, Ds, Ds, Re^Gvs, Re^Gvs, Re^Gvs, Hh, Hh, Mm, Mm, Mm, Mm, Mm, Hh, Hh, Mm, Mm, Hh, Mm, Mm
Gs^Fp, Gs^Fp, Gs^Fp, Gs^Fp, Gs^Fp, Gg, Gg, Gg, Ww, Ww, Wo, Wo, Wo, Wo, Wo, Wo, Wo, Wo, Wo, Wo, Ww, Ww, Ds, Re^Gvs, Re^Gvs, Re^Gvs, Hh, Hh, Hh, Mm, Mm, Mm, Mm, Mm, Mm, Mm, Mm, Mm, Mm, Mm
Gs^Fp, Gs^Fp, Gs^Fp, Gs^Fp, Gs^Fp, Gg, Gg, Gg, Ww, Ww, Wo, Wo, Wo, Wo, Wo, Wo, Wo, Wo, Wo, Wo, Ww, Ww, Ds, Re^Gvs, Re^Gvs, Re^Gvs, Hh, Hh, Hh, Mm, Mm, Mm, Mm, Mm, Mm, Mm, Mm, Mm, Mm, Mm
