Mm, Mm, Mm, Mm, Mm, Mm, Mm, Mm, Mm, Mm, Mm, Mm, Mm, Mm, Mm, Mm, Mm, Mm, Mm, Mm, Mm, Mm, Mm, Mm, Hh, Hh, Hh, Hh, Hh, Mm, Mm, Mm, Mm, Mm, Mm
Mm, Mm, Mm, Mm, Mm, Mm, Mm, Mm, Mm, Mm, Mm, Mm, Mm, Mm, Mm, Mm, Mm, Mm, Mm, Mm, Mm, Mm, Mm, Mm, Hh, Hh, Hh, Hh, Hh, Mm, Mm, Mm, Mm, Mm, Mm
Mm, Mm, Mm, Mm, Hh, Hh, Ch, 2 Kh, Ch, Hh, Hh, Mm, Mm, Mm, Mm, Mm, Hh, Hh, Gg^Efm, Mm, Hh, Mm, Mm, Hh, Hh, Gg, Gg, Gg, Gg, Hh, Gg, Hh, Hh, Mm, Mm
Mm, Mm, Mm, Hh, Gg, Gg, Re, Ch, Gg, Gg, Hh, Hh, Hh, Mm, Mm, Hh, Hh, Gg^Efm, Gg^Vh, Gg^Efm, Gg, Mm, Mm, Hh, Gg, Gg, Gg^Efm, Gg, Mm, Gg, Mm, Gg, Hh^Vhh, Mm, Mm
Mm, Mm, Mm, Hh, Gg, Gg, Re, Gg, Gg, Gg, Gg, Gg, Hh, Mm, Hh, Hh, Hh, Hh, Hh, Hh, Gg, Hh, Mm, Hh, Gg, Gg, Gg, Mm, Mm, Mm, Mm, Mm, Mm, Mm, Mm
Mm, Mm, Mm, Hh, Hh, Gg, Gg, Re, Gg, Gg, Hh, Hh, Mm, Mm, Hh, Gg^Vh, Gg, Gg, Gg, Hh, Gg, Hh, Mm, Hh, Gg^Efm, Gg^Efm, Gg, Hh, Hh, Mm, Mm, Mm, Mm, Mm, Mm
Hh, Hh, Mm, Mm, Hh, Gg, Gg, Re, Gg, Hh, Hh, Hh, Mm, Mm, Hh, Gg, Gg, Gg, Gg, Gg, Gg, Hh, Hh, Gg, Gg, Gg, Gg, Gg, Gg, Mm, Mm, Mm, Hh, Hh, Hh
Hh, Hh, Hh, Mm, Mm, Hh, Gg, Re, Re, Gg, Hh, Mm, Mm, Hh, Gg, Gg, Gg, Re, Gg, Gg, Hh, Hh, Hh, Hh, Gg, Gg, Gg, Hh, Mm, Mm, Hh^Vhh, Mm, Hh, Hh, Hh
Gg, Gg, Gg, Hh, Mm, Hh, Hh, Ch, Re, Ch, Hh, Mm, Hh, Hh, Gg, Gg, Re, Gg, Gg, Gg, Gg, Hh, Gg, Gg, Gg, Gg, Gg, Hh, Mm, Re^Gvs, Re^Gvs, Re^Gvs, Hh, Hh, Hh
Gg, Gg, Hh, Hh, Hh, Hh, Gg, Gg, Re, Gg, Hh, Hh, Gg^Efm, Gg^Efm, Gg^Efm, Re, Re^Gvs, Gg, Gs^Fp, Gs^Fp, Gg, Gg, Gg, Gg, Hh, Hh, Hh, Mm, Hh, Re^Gvs, Re^Gvs, Re^Gvs, Gg, Hh, Hh
Gg, Gg, Gg, Hh, Gg, Gg, Gg, Re, Gg, Gg, Hh, Gg, Gg^Efm, Gg^Efm, Gg, Gg^Efm, Re^Gvs, Re^Gvs, Re^Gvs, Gs^Fp, Gs^Fp, Gg, Gg, Gg, Hh, Mm, Hh, Hh, Gg, Gg, Gg, Gg, Gg, Hh, Hh
Gg, Gg, Gg, Hh, Gg, Gg, Re, Gg, Gg, Gg, Gg, Gg, Gg, Gg, Gg, Re, Re^Gvs, Re^Gvs, Re^Gvs, Gg^Vh, Gg, Gg, Gg, Gg, Gg, Hh, Gg, Gg, Gg, Gg, Gg, Gg, Hh, Gg, Gg
Gg, Gg, Gg^Efm, Gg^Efm, Gg, Gg, Re, Gg, Gg, Gg, Gg, Gg, Gg, Gg, Gg, Re, Re, Re^Gvs, Gg, Gg, Gg, Gg, Gg, Gg, Gg, Gg, Re^Gvs, Gg, Gg, Gg, Hh, Gg, Hh, Mm, Mm
Gg, Gg, Gg, Gg, Gg, Gg, Gg, Gg, Gg, Gg, Re^Gvs, Gs^Fp, Gs^Fp, Gg, Gg, Gg, Gg, Gg, Gg, Gg, Gg, Gg, Gs^Fp, Gs^Fp, Re^Gvs, Re^Gvs, Re, Re, Gg, Gg, Hh, Hh, Mm, Mm, Mm
Gg, Gg, Gg, Gg, Ch, Rr, Gg, Gg, Gg, Re^Gvs, Re^Gvs, Gg^Vh, Gs^Fp, Gs^Fp, Gg, Gg, Gg, Gg, Gg, Gg, Gg, Gg, Gg, Gs^Fp, Gg^Vh, Re^Gvs, Re^Gvs, Gg, Gg^Efm, Gg, Hh, Mm, Mm, Mm, Mm
Rr, Rr, Rr, Rr, Rr, Rr, Rr, Rr, Rr, Re^Gvs, Re^Gvs, Re^Gvs, Gg, Gg, Gg, Gg, Rr, Rr, Rr, Gg, Ch, Gg, Gg, Gs^Fp, Gg, Re^Gvs, Re, Gg, Gg^Efm, Gg, Gg, Mm, Gg, Mm, Mm
Rr, Rr, Gg, Gg, Gg, Rr, Ch, Gg, Gg, Rr, Rr, Gg, Rr, Gg, Rr, Rr, Gg, Rr, Gg, Rr, Rr, Rr, Rr, Gg, Gg, Re^Gvs, Gg, Gg, Gg, Gg^Efm, Gg, Gg, Gg, Mm, Mm
Gg, Gg, Gg, Re, Gg, Gg, Gg, Gg, Gg, Gg, Gg, Rr, Gg^Efm, Rr, Gg, Gg, Gg, Gg, Gg, Gg, Gg, Ch, Gg, Rr, Rr, Gg, Rr, Gg, Gg, Hh, Hh, Hh, Hh, Hh, Hh
Gs^Fp, Gs^Fp, Gs^Fp, Gg, Re, Gg, Gg, Gg, Gg, Gs^Fp, Gs^Fp, Gg^Efm, Gg^Efm, Gg^Efm, Gg, Gg, Gg, Gg, Gs^Fp, Gg, Gg, Gg, Gg, Gg, Gg, Rr, Gg, Rr, Gg, Gg^Vh, Hh, Hh, Mm, Mm, Mm
Gs^Fp, Gs^Fp, Gs^Fp, Gg, Re, Gg, Gs^Fp, Gg, Re^Gvs, Gg, Gg, Gg, Gg, Gg, Gg, Gg, Gg, Gs^Fp, Gs^Fp, Gs^Fp, Gg, Gg, Gg, Gg, Gg, Gg, Gg^Efm, Rr, Gg, Gg, Hh, Mm, Mm, Mm, Mm
Gs^Fp, Gs^Fp, Gg, Gg, Re, Gs^Fp, Gs^Fp, Gg^Vh, Re^Gvs, Re^Gvs, Gg, Gg, Gg, Gg, Ww, Gg, Gs^Fp, Gg^Vh, Re^Gvs, Gg, Gg^Efm, Gg, Gg, Hh, Hh, Gg^Efm, Gg^Efm, Rr, Rr, Gg, Gg, Ch, Ch, Mm, Mm
Re^Gvs, Re^Gvs, Gg^Vh, Re, Gs^Fp, Gs^Fp, Gs^Fp, Gs^Fp, Gg, Gg, Gg, Gg, Ww, Ww, Ww, Gg, Gg, Re^Gvs, Re^Gvs, Gg, Gg^Efm, Gg, Gg, Gg, Hh, Hh, Mm, Gg, Rr, Gg, Gg, Ch, 1 Kh, Mm, Mm
Re^Gvs, Re^Gvs, Re^Gvs, Re^Gvs, Re^Gvs, Gg^Efm, Gg^Efm, Gg, Hh, Hh, Gg, Gg, Ww, Ww, Ww, Ww^Bw\, Gg^Vh, Re^Gvs, Re^Gvs, Gg^Efm, Gg^Efm, Gg^Efm, Gg, Gg^Vh, Hh, Hh, Mm, Gg, Gg, Rr, Rr, Rr, Rr, Mm, Mm
Hh, Hh, Hh, Re^Gvs, Gg, Gg^Efm, Gg^Efm, Gg, Hh, Hh, Hh, Gg, Gg, Ww, Gg, Gg, Re^Gvs, Re^Gvs, Hh, Hh, Gg, Gg, Hh, Hh, Mm, Mm, Mm, Mm, Mm, Mm, Mm, Hh, Mm, Rr, Hh
Hh, Hh, Hh, Gg, Gg, Gg, Gg, Gg, Hh, Hh, Hh, Gg, Gg, Ww, Gg, Gg, Gg, Re^Gvs, Hh, Hh, Gg, Gg, Hh, Hh, Mm, Mm, Mm, Mm, Mm, Mm, Mm, Hh, Mm, Rr, Rr
