Hh, Hh, Hh, Gg, Gg, Gs^Fds, Gs^Fds, Gs^Fds, Gs^Fms, Gs^Fds, Gs^Fds, Gs^Fds, Gs^Fds, Gs^Fds, Gs^Fds, Gg, Gs^Fds, Gs^Fds, Gs^Fds, Gs^Fds, Gs^Fds, Gs^Fds, Gs^Fds, Gs^Fds, Gs^Fds, Gs^Fds, Gs^Fds, Gs^Fds, Gs^Fds, Gs^Fds, Gs^Fds, Gg, Hh, Hh, Hh
Hh, Hh, Hh, Gg, Gg, Gs^Fds, Gs^Fds, Gs^Fms, Gs^Fds, Gs^Fds, Gs^Fds, Gg^Fet, Gs^Fds, Gs^Fds, Gs^Fds, Gg^Vh, Gs^Fds, Gs^Fds, Gs^Fds, Gs^Fds, Gs^Fds, Gs^Fds, Gs^Fms, Gs^Fds, Gs^Fds, Gs^Fds, Gs^Fds, Gs^Fds, Gg^Fet, Gs^Fds, Gs^Fds, Gg, Hh, Hh, Hh
Gg, Gg, Gg, Gg, Gs^Fds, Gs^Fds, Gs^Fds, Gs^Fds, Gs^Fds, Gg^Vh, Gs^Fds, Gs^Fds, Gg, Gg, Gg, Gs^Fds, Gg, Gs^Fds, Gs^Fds, Gg^Vh, Gs^Fds, Gs^Fds, Gs^Fds, Gs^Fds, Gg^Vh, Gs^Fds, Gg, Gs^Fds, Gs^Fds, Gs^Fds, Gg, Gg, Hh, Hh, Hh
Gs^Fds, Gs^Fds, Gs^Fds, Gs^Fds, Gs^Fds, Gg^Vh, Gs^Fds, Gs^Fds, Gg, Gs^Fds, Gs^Fds, Gg, Gg, Gg, Ch, Gg, Gg, Gg, Gs^Fds, Gs^Fds, Gs^Fms, Gs^Fms, Gs^Fds, Gg, Gg, Gg, Gs^Fds, Gg, Gg, Gg, Hh, Hh, Hh, Hh, Hh
Gs^Fds, Gg^Fet, Gs^Fds, Gs^Fds, Gs^Fds, Gs^Fms, Gg, Gg, Gs^Fds, Gg, Gg, Gg, Gg, Ch, 2 Kh, Ch, Gg, Gg, Gs^Fds, Gs^Fds, Gs^Fds, Gs^Fds, Gs^Fds, Gg, Gs^Fds, Gs^Fp, Gs^Fms, Gs^Fds, Gg, Hh, Hh, Hh, Gg, Hh, Hh
Gs^Fds, Gs^Fds, Gs^Fds, Gs^Fds, Ds, Ds, Gs^Fds, Gs^Fds, Gg^Vh, Gs^Fds, Gs^Fds, Gg, Gg, Ch, Ch, Ch, Re, Gg, Gs^Fds, Gs^Fds, Gg^Vh, Gs^Fds, Gs^Fds, Gg, Gs^Fds, Gs^Fms, Gs^Fds, Gs^Fms, Ds, Gg, Gg, Gg, Ww, Gg, Gg
Ww, Ww, Gs^Fds, Ds, Ww, Ds, Ds, Gs^Fds, Gs^Fds, Gs^Fds, Gg^Fet, Gs^Fms, Gs^Fds, Gg, Gg, Re, Gg, Re, Re, Gs^Fds, Gs^Fds, Gs^Fds, Re, Re, Re, Gs^Fds, Re, Ds, Ww, Ww, Ww, Ww, Gs^Fds, Ww, Ww
Ww, Ww, Ww, Ww, Ww, Ww, Gs^Fds, Gs^Fds, Gs^Fds, Gs^Fds, Gs^Fds, Gs^Fms, Gs^Fds, Gg, Re, Re, Gs^Fds, Gs^Fds, Gs^Fds, Re, Re, Re, Gs^Fds, Gs^Fds, Gs^Fds, Re, Gs^Fds, Ww^Bw\, Re, Gs^Fds, Gs^Fds, Gs^Fds, Gg^Vh, Gs^Fds, Gs^Fds
Gs^Fds, Gs^Fds, Gs^Fp, Gs^Fds, Ww, Ww, Ww, Ww, Ww, Gs^Fds, Gg^Vh, Gs^Fms, Re, Re, Gs^Fds, Gs^Fds, Gs^Fds, Gg^Vh, Gs^Fds, Gs^Fds, Gg, Gs^Fds, Gg^Vh, Gs^Fds, Gs^Fms, Gs^Fds, Gs^Fds, Ww, Gs^Fds, Re, Re, Gs^Fms, Gs^Fds, Gs^Fds, Gs^Fds
Gs^Fds, Gs^Fds, Gs^Fds, Hh^Fms, Gs^Fds, Ww, Gs^Fds, Ww, Ww, Gs^Fds, Gs^Fds, Gs^Fds, Re, Gs^Fds, Gs^Fds, Gs^Fds, Gg, Gs^Fds, Gs^Fds, Gs^Fds, Gg, Gs^Fds, Gs^Fds, Gs^Fds, Ww, Gs^Fds, Ww, Ww, Gs^Fds, Gs^Fds, Re, Gg, Gg, Gs^Fds, Gs^Fds
Gs^Fds, Gs^Fms, Gs^Fds, Gs^Fds, Gs^Fds, Gs^Fds, Gs^Fms, Gs^Fds, Gg, Ww, Ww^Bw/, Re, Gg, Gs^Fds, Gg^Fet, Gg^Vh, Gg, Gs^Fds, Gs^Fms, Gs^Fds, Ds, Ds, Ww, Ww, Gs^Fds, Ww, Gs^Fds, Gs^Fds, Gs^Fds, Gg, Re, Gg, Gs^Fds, Gs^Fds, Gs^Fds
Gs^Fds, Gs^Fds, Gg^Fet, Gs^Fds, Gs^Fds, Gg^Vh, Gs^Fds, Gg, Re, Re, Gg, Ww, Gg, Gs^Fds, Gs^Fds, Gs^Fds, Gs^Fds, Gs^Fds, Gs^Fds, Gs^Fds, Ww, Ww, Gs^Fds, Gs^Fds, Gg^Vh, Gs^Fds, Gs^Fms, Gs^Fds, Gg, Gg, Re, Gg, Gs^Fds, Gs^Fds, Gs^Fds
Gs^Fds, Gs^Fds, Gs^Fms, Gs^Fds, Gs^Fms, Gs^Fds, Re, Re, Gs^Fds, Gg, Gs^Fds, Ww, Ww, Gg, Gs^Fds, Gs^Fds, Gs^Fp, Gs^Fds, Gg^Fet, Ww, Gs^Fds, Gg, Gg, Gs^Fds, Gs^Fp, Gs^Fms, Gs^Fms, Gs^Fds, Gg, Re, Gs^Fds, Gg, Gs^Fds, Gg^Fet, Gs^Fds
Gs^Fds, Gs^Fms, Gs^Fms, Gs^Fds, Gs^Fds, Gs^Fds, Re, Gs^Fds, Gs^Fds, Gs^Fds, Ww, Ww, Gs^Fds, Gg, Gs^Fds, Gg^Vh, Gs^Fds, Gs^Fds, Ww, Ww, Gs^Fds, Gs^Fds, Gg, Gg, Gs^Fds, Gs^Fds, Gs^Fds, Gs^Fds, Gs^Fms, Re, Gs^Fds, Gs^Fds, Gg^Vh, Gs^Fds, Gs^Fds
Gs^Fds, Gs^Fds, Hh^Fms, Gs^Fds, Gs^Fds, Gs^Fds, Re, Gs^Fms, Gs^Fds, Gg^Fet, Gs^Fds, Ww, Ww, Gg, Gg, Gs^Fds, Gs^Fds, Gs^Fds, Ww, Gs^Fds, Gs^Fds, Gs^Fds, Gg, Gg, Gs^Fds, Gs^Fds, Gg^Fet, Gs^Fds, Gs^Fms, Re, Re, Gs^Fds, Gs^Fds, Gs^Fds, Gs^Fds
Gs^Fds, Gs^Fds, Gg^Vh, Gs^Fds, Re, Re, Gs^Fds, Gs^Fds, Gs^Fds, Gs^Fds, Gs^Fds, Gs^Fds, Ww, Ww, Gs^Fds, Gg, Gs^Fds, Gs^Fds, Ww, Gs^Fds, Gs^Fds, Gg, Gs^Fds, Gg, Gg, Gs^Fds, Gg, Gs^Fds, Gg, Gg, Re, Gs^Fds, Gg, Gs^Fds, Gs^Fds
Gg, Gg, Gg, Gg, Re, Gg, Gs^Fds, Gs^Fds, Gg^Fet, Gs^Fms, Gs^Fms, Gs^Fds, Gg, Ww, Ww, Ww, Ww, Ww, Gs^Fds, Gs^Fds, Gs^Fds, Gs^Fds, Gs^Fds, Gs^Fds, Gs^Fp, Gg, Gg, Gg, Gg, Gg, Re, Gg, Re, Gg, Gg
Rr, Rr, Rr, Gg, Re, Gg, Gg, Gs^Fds, Gs^Fms, Gs^Fds, Gs^Fds, Gg, Ww, Ww, Gs^Fds, Ww, Gs^Fds, Gs^Fds, Gs^Fds, Gs^Fds, Gs^Fds, Gg^Fet, Gs^Fds, Gg^Vh, Gs^Fds, Gg, Ch, Ch, Ch, Re, Gg, Re, Gg, Re, Re
Gg, Gg, Ch, Ch, Ch, Gg, Gg, Gg^Vh, Gs^Fds, Gs^Fms, Gs^Fds, Gg, Gs^Fds, Ww, Ww, Ww, Gs^Fds, Gs^Fds, Gg^Fet, Gs^Fds, Hh^Fms, Gs^Fds, Gs^Fds, Gs^Fds, Gg, Gg, Ch, 1 Kh, Ch, Gg, Hh, Gg, Hh, Gg, Gg
Gg, Gg, Ch, 3 Kh, Ch, Gg, Gg, Gs^Fds, Gs^Fds, Gs^Fms, Gs^Fds, Gs^Fds, Gs^Fds, Ww, Ww, Gs^Fds, Gs^Fds, Gs^Fds, Gs^Fds, Gs^Fds, Gg^Vh, Gs^Fds, Gg, Gg, Gs^Fds, Gg, Gg, Ch, Gg, Gg, Gg, Hh, Hh, Hh, Hh
Gg, Gg, Gg, Ch, Gg, Gg, Gg, Gs^Fds, Gg^Fet, Gs^Fds, Gs^Fds, Gs^Fds, Gg^Fet, Gs^Fds, Gs^Fds, Wwf, Ww, Gs^Fds, Gs^Fms, Gs^Fds, Gs^Fms, Gs^Fds, Gs^Fds, Gg, Gs^Fds, Gs^Fds, Gs^Fds, Gg, Gg, Hh, Hh, Gg, Hh, Hh, Hh
Gg, Gg, Gg, Ch, Gg, Gg, Gg, Gs^Fds, Gs^Fds, Gs^Fms, Gs^Fds, Gs^Fds, Gs^Fms, Gs^Fds, Gs^Fds, Ww, Ww, Gs^Fds, Gs^Fds, Gs^Fds, Gs^Fms, Gs^Fds, Gs^Fds, Gg, Gs^Fp, Gs^Fp, Gs^Fds, Gg, Gg, Hh, Hh, Gg, Hh, Hh, Hh
