Ww, Ww, Ss, Ss, Ss, Ss, Ss, Gg, Gg, Ss, Ss, Ss, Ww, Ww, Ss, Ss, Ss, Ss, Ss, Ss, Ss, Ww, Ww, Ss, Ss, Ss, Ss, Ss, Gg, Ss, Gg, Gg, Gg, Ww, Ss, Gg, Gs^Fp, Gs^Fp, Gs^Fp, Gs^Fp
Ww, Ww, Ss, Ss, Ss, Ss, Ss, Gg, Gg, Ss, Ss, Ss, Ww, Ww, Uu^Uf, Uu^Uf, Ss, Ss, Ss, Ss, Ss, Ww, Ww, Ss, Ss, Ss, Ss, Ss, Gg, Ss, Gg, Gg, Gg, Ww, Ss, Gg, Gs^Fp, Gs^Fp, Gs^Fp, Gs^Fp
Ss, Ss, Ss, Gg, Ss, Gg, Ss, Ss, Ss, Ss, Ww, Ww, Ss, Ss, Ss, Ww, Ww, Ss, Ss, Ss, Ss, Ss, Ss, Ww, Ss, Ss, Ss, Ss, Ss, Gs^Vht, Ss, Gg, Ww^Bw\, Ww, Gg, Gg, Gs^Fp, Gs^Fp, Gs^Fp, Gs^Fp
Ss, Ss, Gg, Chr, 2 Khr, Chs, Gg, Ss, Ss, Ss, Ww, Ss, Ss, Ss^Vhs, Gg, Ss, Ww, Ss, Ss, Ss, Ss, Ss, Ss, Ww, Ww, Ss, Ss, Ss, Ss, Ss, Ww, Ww, Ss, Gg, Gg, Gs^Fp, Re, Re, Re, Re
Ss, Ss, Gg, Chs, Chr, Ss, Ss, Ss^Vhs, Ss, Ss, Ss, Ss, Gg, Gg, Gg, Ss, Ww, Ss, Ss, Ss, Gg, Gg, Ss, Ss, Ss, Ww, Ww, Ss, Ss, Ss, Ww, Ss, Ss, Gg, Re, Re, Gs^Fp, Gs^Fp, Gs^Fp, Gs^Fp
Ss, Ss, Ss, Gg, Gg, Gg, Gg, Ww, Ww, Ww, Gg, Ss, Gg, Hh, Hh, Gg, Ww^Bw\, Gg, Gg, Ss, Ss, Gg, Gg, Ss, Ss^Vhs, Ss, Ss, Ww, Ww, Ww, Ss, Ss, Gg, Gg, Re, Gg, Gg, Gs^Fp, Gg^Vh, Gg
Ww, Ww, Ww, Ss^Vhs, Gg, Ww, Ww, Ww^Bw\, Gg, Gg, Hh, Gg, Gg, Hh, Gg, Gg, Ww, Gg, Gg, Ss^Vhs, Ss, Ss, Ss, Ss, Gg, Gg, Gg, Ss, Ww, Ww, Re, Ss, Re, Re, Gg, Gg, Chr, Gg, Gg, Gg
Ss, Ss, Gg, Ww, Gg, Gg, Ss, Ww, Ss, Gg, Gg, Gg, Ss, Gg, Ss, Ss, Ss, Ss, Ss, Gg, Ss, Ss, Ss, Gg, Gg, Gg, Re, Re, Re, Ww^Bw/, Ss, Re, Gg, Gg, Gg, Chr, 3 Khr, Chr, Gg, Gg
Ss, Ss, Ww, Ww, Ss, Ss, Ss, Ww, Ww, Ss, Gg, Gg, Ss, Ss, Ss, Ww, Ss, Ss, Gg, Uu^Uf, Ss, Gg, Ss, Ss, Gg, Re, Gg, Gg, Ss, Ww, Ww, Ss, Ss^Vhs, Gg, Gg, Chr, Chr, Chr, Gg, Gg
Ss, Ss, Ss, Ww, Ww, Ss, Ss, Ss, Ww, Ss, Gg, Ss, Ss^Vhs, Ss, Ss, Ww, Ss, Ss, Ss, Gg, Ss, Ss, Ss, Ss, Ss, Re, Ss, Ss, Ss, Ww, Ww, Ss, Ss, Ss, Gg, Gg, Gg, Gg, Gg, Gg
Gg, Gg, Ss, Ss, Ss, Ww, Ww, Ww, Ss, Ww, Ww^Bw/, Gg, Ss, Ss, Ww, Ww, Ww, Ss, Ss, Ss, Ss, Ss^Vhs, Gg, Gg, Re, Re, Ss, Ss, Ww, Ww, Ss, Ss, Ss, Ss, Ss, Ss, Ss, Ss, Ss, Ss
Ss, Ss, Gg, Ss, Gg, Ss, Ss, Ww, Ss, Gg, Ss, Ww, Ww, Ww, Ss, Ss, Ss, Ss, Ss, Ss, Ss, Gg, Gs^Fp, Re, Gs^Fp, Gg, Ss, Ss, Ww, Ss, Ss, Ss, Ss, Ss, Ss, Ss, Gg, Gg, Ss, Ss
Ss, Ss, Ss, Ss, Gg, Gg, Ss, Ww, Ss, Gg, Gg, Gg, Gg, Ww, Ss, Ss, Ss, Ww, Ss, Ss, Gg, Gg, Gs^Fp, Re, Gs^Fp, Gs^Fp, Gg, Ss, Ss, Ww, Ss, Ss, Gg, Ss^Vhs, Gg, Ss, Ss, Gg, Ss, Ss
Gg, Gg, Ss^Vhs, Ss, Ss, Ss, Ss, Ww, Ss, Gg, Ss^Vhs, Gg, Gg, Ww, Gg, Gg, Ss, Ss, Ww, Gg, Re, Re, Re, Re, Gs^Fp, Gs^Fp, Gs^Fp, Ss, Ss, Ww, Ss, Ss, Gg, Gs^Fp, Gs^Fp, Ss, Ss, Ss, Ss, Ss
Gg, Gg, Ss, Ss, Ss, Ss, Ww, Ww, Ss, Ss, Ss, Gg, Ww, Ww^Bw\, Gg, Gg, Gg, Gg, Re, Ww^Bw/, Ww, Gg, Gg, Gg, Gg, Gs^Fp, Gg, Gg, Ss, Ww, Ss, Ss, Ss, Gg, Gg, Gg, Ss, Ss, Ss, Ss
Gg, Gg, Gg, Gg, Ss, Ss, Uu^Uf, Uu^Uf, Ss, Ww, Ss, Ss, Ss, Ww, Ss, Gg, Re, Re, Gs^Fp, Gg, Ss, Ww, Ss, Ss^Vhs, Ss, Gg, Ss, Ss, Ss, Ww, Ss, Ss, Ss, Gg, Ss, Ss, Uu^Uf, Ss, Ss, Ss
Gs^Fp, Gs^Fp, Gs^Fp, Gg, Gg, Ss, Ss, Ss, Gg, Ss, Ss, Ww, Ww, Ss, Ss^Vhs, Gg, Re, Gs^Fp, Gs^Fp, Gs^Fp, Gg, Ss, Ww, Ss, Ss, Ss, Ss, Ss, Ww, Ww, Ss, Ss, Ss, Ss, Ss, Ss, Ww, Ww, Ss, Ss
Gs^Fp, Gs^Fp, Gg, Gs^Fp, Gg, Ss, Ss, Gg, Ss, Gg, Ss, Ss, Ww, Ss, Gg, Gg, Re, Gs^Fp, Ss, Gs^Fp, Ss, Ss, Ss, Ss, Ww, Ww, Ss, Ww, Ww, Ww, Ss, Gg, Gg, Ss, Ss^Vhs, Ss, Ss, Ww, Ww, Ww
Re, Re, Re, Gg^Vh, Gs^Fp, Gg, Gg, Ss, Ss, Ss, Ss^Vhs, Ss, Ww, Ss, Re, Re, Gg, Gg, Ss, Gg, Ss, Ss, Ww, Ww, Ss, Ss, Ss, Ww, Ss, Ss, Ss, Gg, Ss, Ss, Gg, Ss, Ss, Ss, Ww, Ww
Gg, Gg, Gg, Re, Re, Gg, Gs^Fp, Gg, Gg, Ss, Gg, Gg, Re, Ww^Bw/, Ww, Ss, Ss, Ss^Vhs, Ss, Ss, Ss, Ss, Ww, Ss, Gg, Ss^Vhs, Ss, Ww, Ss, Gg, Ss, Ss, Ss, Gg, Gs^Fp, Gg, Gg, Ss, Ss, Ss
Hh, Hh, Hh, Gg, Gs^Fp, Re, Re, Gs^Fp, Re, Gg, Re, Re, Gg, Gg, Ss, Ww, Ww, Ss, Gg, Gg, Ww, Ww, Ss, Ss, Gg, Gg, Gg, Ww, Ww, Ss, Ss, Gg, Gg, Gg, Gs^Fp, Gg, Ss, Ss, Ss, Ss
Hh, Hh, Gg, Gg, Gg, Gs^Fp, Gg, Re, Gs^Fp, Re, Gg, Gg, Ss, Ss, Ss, Ss, Ww, Ss, Ss, Gg, Ww, Ss, Ss, Ss, Ss, Ss, Ww, Ww^Bw\, Gg, Ss, Gg, Gg, Gg^Vh, Gs^Fp, Gs^Fp, Gg, Gg, Ss, Ww, Ww
Gg, Gg, Gg, Gg, Ch, Gg, Gg, Re, Gs^Fp, Gs^Fp, Gs^Fp, Gg, Gg, Ss, Gg, Ss, Ss, Ww, Ww, Ww, Ss, Ss, Ww, Ww, Ww, Ww, Ss, Gg, Gg, Ss, Gg, Gg, Gs^Fp, Gs^Fp, Gs^Fp, Gs^Fp, Gg, Ss, Ss, Ss
Gg, Gg, Gg, Ch, 1 Kh, Ch, Gg, Re, Re, Gs^Fp, Gg, Gg, Ss, Ss, Gg, Ss, Ss, Ww, Wo, Ww, Ww, Ww, Ss, Ss, Ss, Ss, Ss, Gg, Ss, Ss, Gg, Gs^Fp, Hh, Gs^Fp, Gs^Fp, Gs^Fp, Ww, Ww, Gg, Gg
Hh, Hh, Gg, Ch, Ch, Ch, Gg, Gs^Fp, Re, Gg, Gs^Fp, Gg, Ss, Ss, Ss, Ss, Ww, Ww, Ww, Ww, Ss, Ss, Gg, Ss, Ss^Vhs, Ss, Gg, Gg, Gg, Gg, Gg, Gg, Hh, Gs^Fp, Gs^Fp, Gs^Fp, Ww, Gs^Fp, Gs^Fp, Gs^Fp
Hh, Hh, Hh, Gg, Gg, Gg, Gg^Vh, Gg, Re, Gg, Gs^Fp, Gg, Gg, Ss, Ss, Ss, Ww, Wo, Ww, Ss, Ss, Ss, Ss, Ss, Gg, Ss, Gg, Gg, Hh, Gg^Vh, Hh, Hh, Gg, Gs^Fp, Ww, Ww, Gs^Fp, Gs^Fp, Gs^Fp, Gs^Fp
Hh, Hh, Hh, Gg, Gg, Gg, Gg, Gg, Re, Gg, Gs^Fp, Gg, Gg, Ss, Ss, Ss, Ww, Wo, Ww, Ss, Ss, Ss, Ss, Ss, Gg, Ss, Gg, Gg, Hh, Gg, Hh, Hh, Gg, Gs^Fp, Ww, Ww, Gs^Fp, Gs^Fp, Gs^Fp, Gs^Fp
