Gs^Fp, Gs^Fp, Gs^Fp, Gg, Gg, Ss, Ww, Ww, Ss, Ss, Ss, Ww, Ss, Ss, Ss, Gg, Hh, Hh, Hh, Gg, Ss, Ss
Gs^Fp, Gs^Fp, Gs^Fp, Gg, Gg, Ss, Ww, Ww, Ss, Ss, Ss, Ww, Ss, Ss, Ss, Gg, Hh, Hh, Hh, Gg, Ss, Ss
Re, Re, Re, Gg, Ww, Ss, Ww, Ss, Ss, Ss, Ss, Ww, Ww, Ss, Gg, Gg, Gg, Hh, Hh, Gg, Gg, Gg
Gg, Gg, Ss, Re, Ww^Bw\, Ww, Gg, Ss, Ss, Gg, Ss, Ss, Ww, Ss, Ss, Gg, Gg, Hh, Gg, Hh, Hh, Hh
Ss, Ss, Ww, Ww, Ww, Re, Re, Gg, Gg, Ss, Ss, Ss, Ww, Ss, Ss, Gg, Ss, Gg, Hh, Hh, Hh, Hh
Ss, Ss, Ww, Ss, Re, Ww, Gg, Gg, Re, Gg, Ss, Ss, Ss, Ww, Ww, Ss, Ss, Gg, Gg, Hh, Gg, Gg
Ww, Ww, Ww, Ss, Ww, Ww, Ss, Ss, Gg, Re, Ss, Ss, Gg, Ss, Ss, Ww, Ww, Ss, Ss, Gg, Ss, Ss
Ss, Ss, Ww, Ww, Ss, Ss, Gg, Ss, Ss, Ss, Ss, Re, Re, Gg, Gg, Ss, Ss, Ww, Ss, Ss, Ss, Ss
Ss, Ss, Ww, Ww, Ss, Gg, Gg, Ss, Ss, Ss, Gg, Gg, Re, Gg, Gg, Gg, Ss^Vhs, Ww, Ww, Ss, Ss, Ss
Ss, Ss, Ss, Ww, Ww, Ss, Ss, Ss, Ss^Vhs, Gg, Gg, Gs^Fp, Gs^Fp, Re, Re, Gg, Gg, Ss, Ss, Ww, Ss, Ss
Ss, Ss, Ss, Ss, Ww, Ww, Ss, Ss, Gg, Gg, Gs^Fp, Gs^Fp, Ch, Gs^Fp, Re, Gg, Re, Gg, Gg, Ww, Re, Re
Gg, Gg, Gg, Ss, Ss, Ww, Ss, Ss, Gg, Gs^Fp, Gs^Fp, Gs^Fp, 1 Kh, Re, Gs^Fp, Re, Gs^Fp, Re, Re, Ww^Bw/, Ww, Ww
Gg, Gg, Ss, Ss, Ww, Ww, Ss, Ss, Gg, Gg, Gs^Fp, Ch, Re, Ch, Gs^Fp, Gs^Fp, Gg, Gs^Fp, Gg, Ww, Ww, Ww
Ss, Ss, Ss, Ss, Ww, Ww, Ww, Gg, Re, Gs^Fp, Re, Re, Gs^Fp, Gs^Fp, Gg, Gg, Ss^Vhs, Gg, Ss, Ss, Ww, Ww
Ss, Ss, Gg, Ss, Ww, Ww, Re, Re, Gg, Re, Gg, Gg, Gg, Gg, Hh, Gg, Gg, Ss, Ww, Ww, Ss, Ss
Gg, Gg, Re, Re, Re, Ww^Bw/, Ww, Gg, Ss^Vhs, Gg, Gg, Hh, Hh, Hh, Gg, Gg, Ss, Ss, Ww, Ss, Ss, Ss
Re, Re, Gg, Gg, Ss, Ww, Ww, Ss, Ss, Ss, Gg, Hh, Gg, Gg, Ss, Ss, Ss, Ww, Ss, Ss, Gg, Gg
Hh, Hh, Gg, Ss, Ww, Ww, Ss, Ww, Ss, Ss, Ss, Gg, Gg, Ss, Ss, Ss, Ww, Ww, Ss, Ss, Gg, Gg
Hh, Hh, Gg, Ss, Ss, Ww, Ww, Ww, Ss, Ss, Gg, Ss, Ss, Ss, Gg, Ss, Ww, Ww, Ss, Gg, Hh, Hh
Gg, Gg, Gg, Ss, Ww, Ww, Ss, Ww, Ss, Ss, Ss, Gg, Ss, Ss, Ss, Ss, Ww, Ss, Gg, Gg, Gg, Gg
Ss, Ss, Ss, Ss, Ww, Ww, Ww, Ss, Ss, Gg, Gg, Ss, Gg, Ss, Ss, Ww, Ww, Ss, Ss, Gg, Hh, Hh
Ss, Ss, Ss, Ss, Ww, Ww, Ww, Ss, Ss, Gg, Gg, Ss, Gg, Ss, Ss, Ww, Ww, Ss, Ss, Gg, Hh, Hh
