Mm, Mm, Mm, Mm, Mm, Mm, Mm, Mm, Mm, Mm, Mm, Mm, Mm, Mm, Mm, Mm, Mm, Mm, Mm, Mm, Mm, Mm, Mm, Ai, Ai, Ai, Ai, Ai, Ai, Ai, Ai, Ai, Ai, Ai, Ai, Ai, Ai
Mm, Mm, Mm, Mm, Mm, Mm, Mm, Mm, Mm, Mm, Mm, Mm, Mm, Mm, Mm, Mm, Mm, Mm, Mm, Mm, Mm, Mm, Mm, Ai, Ai, Ai, Ai, Ai, Ai, Ai, Ai, Ai, Ai, Ai, Ai, Ai, Ai
Mm, Mm, Mm, Mm, Mm, Mm, Mm, Uu, Uu, Uu, Mm, Mm, Mm, Mm, Mm, Uu, Uu, Uu, Uu, Uu, Rb, Rb, Rb, Mm, Ai, Ai, Ai, Ai, Ai, Ai, Ai, Ai, Ai, Ai, Ai, Ai, Ai
Mm, Mm, Mm, Mm, Mm, Rb, Rb, Rb, Rb, Mm, Uu, Mm, Mm, Uu, Uu, Uu, Uu, Uu, Rb, Uu, Sm^Vhs, Sm, Ai, Ai, Uu, Uu, Uu, Ai, Ai, Ai, Ai, Ai, Ai, Ai, Ai, Ai, Ai
Mm, Mm, Mm, Rb, Rb, Rb, Ch, Ch, Ch, Rb, Uu, Mm, Mm, Uu, Uu, Uu^Vu, Uu, Rb, Rb, Sm, Sm, Sm, Rb, Rb, Uu, Uu, Uu, Ai, Ai, Ai, Sm, Ai, Sm, Ai, Ai, Ai, Ai
Mm, Mm, Mm, Mm, Rb, Rb, Ch, 2 Kh, Ch, Rb, Uu, Uu^Vu, Mm, Mm, Mm, Uu, Rb, Rb, Uu, Rb, Rb, Rb, Mm, Uu, Mm, Mm, Uu, Ai, Ai, Ai, Sm, Sm, Sm, Sm, Sm, Ai, Ai
Mm, Mm, Mm, Rb, Mm, Rb, Rb, Ch, Rb, Rb, Uu, Mm, Mm, Mm, Mm, Uu, Rb, Uu, Mm, Rb, Rb, Mm, Mm, Mm, Uu, Uu, Ai, Ai, Ai, Sm, Sm, Sm, Sm, Sm, Sm, Sm, Sm
Mm, Mm, Mm, Mm, Mm, Mm, Uu, Rb, Uu, Rb, Rb, Uu, Mm, Mm, Uu, Uu, Rb, Uu, Mm, Mm, Mm, Mm, Mm, Mm, Uu, Uu, Rb, Sm, Sm, Sm, Sm, Sm, Sm, Sm, Sm, Sm, Sm
Mm, Mm, Mm, Mm, Mm, Mm, Mm, Mm, Uu^Vu, Uu, Rb, Uu, Uu, Uu, Uu, Uu, Rb, Uu, Mm, Mm, Mm, Mm, Uu, Uu, Ai, Ai, Sm, Sm, Sm, Sm, Uu, Ai, Ai, Ai, Ai, Ai, Ai
Mm, Mm, Uu^Vu, Uu, Uu, Mm, Mm, Mm, Mm, Uu, Uu, Rb, Rb, Uu, Uu, Rb, Uu, Uu, Uu, Uu, Mm, Uu, Uu, Uu, Ai, Sm, Sm, Sm, Ai, Uu, Uu, Uu, Uu, Uu, Rb, Ai, Ai
Mm, Mm, Mm, Uu, Uu, Mm, Mm, Mm, Uu, Uu, Uu, Uu, Rb, Uu, Uu, Uu, Uu, Uu, Uu^Vu, Uu, Uu, Uu, Ai, Ai, Sm, Sm, Ai, Sm^Vhs, Rb, Uu, Uu, Uu, Mm, Uu, Uu, Ai, Ai
Mm, Mm, Uu, Uu, Uu, Uu, Uu, Mm, Uu, Uu, Uu, Uu, Rb, Rb, Rb, Rb, Rb, Uu, Uu, Uu, Ai, Uu, Rb, Sm, Sm, Ai, Uu, Rb, Uu, Uu, Mm, Mm, Mm, Uu, Uu, Mm, Mm
Mm, Mm, Uu, Rb, Sm, Rb, Rb, Rb, Rb, Rb, Rb, Uu, Uu, Uu, Uu, Rb, Sm, Uu, Rb, Uu, Ai, Sm, Sm, Sm, Ai, Uu, Rb, Rb, Uu, Uu, Uu, Mm, Mm, Uu, Uu^Vu, Mm, Mm
Mm, Mm, Mm, Rb, Rb, Sm, Sm, Sm, Sm, Sm, Ai, Uu, Ai, Uu, Ai, Sm, Sm, Sm, Sm, Ai, Sm, Sm, Sm, Sm, Rb, Rb, Uu, Uu, Uu, Uu, Mm, Mm, Mm, Mm, Mm, Mm, Mm
Mm, Mm, Uu, Uu, Uu^Vu, Rb, Rb, Sm, Rb, Sm, Rb, Ai, Ai, Ai, Ai, Sm, Sm, Sm, Sm, Sm, Ai, Ai, Rb, Uu, Uu, Uu, Uu, Uu, Mm, Mm, Mm, Mm, Uu, Mm, Mm, Mm, Mm
Mm, Mm, Mm, Uu, Uu, Rb, Uu, Rb, Uu, Rb, Uu, Uu, Rb, Ai, Sm, Sm, Sm, Uu, Rb, Sm, Rb, Uu, Uu, Uu, Uu, Uu, Uu, Mm, Mm, Mm, Uu^Vu, Uu, Rb, Uu, Uu, Mm, Mm
Mm, Mm, Mm, Mm, Mm, Uu, Mm, Mm, Mm, Uu, Uu^Vu, Uu, Uu, Sm, Sm, Sm, Sm, Rb, Rb, Rb, Rb, Uu, Uu, Uu, Rb, Uu^Vu, Uu, Uu, Mm, Mm, Uu, Rb, Sm, Rb, Uu, Mm, Mm
Mm, Mm, Mm, Mm, Mm, Mm, Mm, Mm, Mm, Uu, Rb, Uu, Rb, Rb, Sm, Sm, Sm, Sm, Uu, Rb, Rb, Rb, Rb, Uu, Rb, Rb, Uu, Uu, Uu, Uu, Rb, Sm, Sm, Rb, Uu, Mm, Mm
Mm, Mm, Uu, Uu, Uu, Uu, Uu, Mm, Uu, Mm, Rb, Sm, Sm, Sm, Sm, Sm^Vhs, Sm, Rb, Uu, Rb, Uu, Rb, Uu, Rb, Rb, Uu, Uu, Uu, Uu, Uu, Rb, Sm, Rb, Rb, Uu, Mm, Mm
Rb, Rb, Uu, Uu, Ai, Ai, Ai, Uu, Rb, Rb, Ai, Ai, Sm, Sm, Rb, Sm, Uu, Uu, Uu, Uu, Uu, Uu, Uu, Rb, Rb, Uu, Rb, Uu, Rb, Rb, Uu, Uu, Uu^Vu, Uu, Mm, Mm, Mm
Ai, Ai, Sm, Ai, Sm, Ai, Ai, Sm, Ai, Ai, Ai, Ai, Sm, Sm, Uu, Rb, Uu, Uu, Mm, Mm, Mm, Uu, Uu, Uu, Uu, Rb, Rb, Uu, Rb, Uu, Uu, Uu, Mm, Mm, Mm, Mm, Mm
Ai, Ai, Sm, Sm, Sm, Sm, Sm, Sm, Sm, Sm, Sm, Sm, Sm, Rb, Uu, Rb, Uu, Uu, Mm, Mm, Mm, Mm, Mm, Uu, Uu, Uu, Uu, Rb, Rb, Rb, Rb, Uu, Uu, Mm, Uu, Mm, Mm
Sm, Sm, Ai, Sm, Ai, Sm, Ai, Sm, Ai, Sm, Rb, Sm, Rb, Rb, Uu, Rb, Rb, Uu, Uu, Uu^Vu, Mm, Mm, Mm, Mm, Uu, Uu, Rb, Rb, Ch, Ch, Ch, Rb, Uu, Uu, Uu, Mm, Mm
Ai, Ai, Uu, Ai, Ai, Ai, Uu, Ai, Uu, Rb, Uu, Uu^Vu, Uu, Uu, Mm, Uu, Rb, Rb, Uu, Mm, Mm, Mm, Rb, Uu, Rb, Rb, Uu, Rb, Ch, 1 Kh, Ch, Rb, Uu, Uu, Mm, Mm, Mm
Mm, Mm, Uu, Uu^Vu, Uu, Mm, Mm, Uu, Uu, Uu, Mm, Uu, Mm, Uu, Mm, Uu, Uu, Rb, Uu, Uu, Rb, Rb, Sm, Rb, Mm, Uu, Uu, Rb, Rb, Ch, Rb, Rb, Uu, Mm, Mm, Mm, Mm
Mm, Mm, Uu, Uu, Mm, Mm, Mm, Mm, Uu, Mm, Uu, Uu, Mm, Mm, Mm, Mm, Uu, Uu, Mm, Mm, Rb, Sm, Rb, Rb, Mm, Uu^Vu, Mm, Uu, Uu, Rr, Uu, Uu, Mm, Uu, Mm, Mm, Mm
Mm, Mm, Mm, Mm, Mm, Mm, Mm, Mm, Mm, Mm, Mm, Mm, Mm, Mm, Mm, Mm, Mm, Mm, Mm, Mm, Mm, Mm, Mm, Mm, Mm, Mm, Mm, Mm, Uu, Rr, Rr, Uu, Mm, Mm, Mm, Mm, Mm
Mm, Mm, Mm, Mm, Mm, Mm, Mm, Mm, Mm, Mm, Mm, Mm, Mm, Mm, Mm, Mm, Mm, Mm, Mm, Mm, Mm, Mm, Mm, Mm, Mm, Mm, Mm, Mm, Uu, Rr, Rr, Uu, Mm, Mm, Mm, Mm, Mm
