Aa^Fpa, Aa^Fpa, Ha, Ha, Ha, Aa^Fpa, Aa^Fpa, Gs^Fp, Gs^Fp, Gs^Fp, Gs^Fmw, Ww, Ww, Gs^Fp, Gs^Fp, Gs^Fp, Gs^Fp, Gg, Gs^Fp, Gs^Fp, Gs^Fp, Gs^Fp
Aa^Fpa, Aa^Fpa, Ha, Ha, Ha, Aa^Fpa, Aa^Fpa, Gs^Fp, Gs^Fp, Gs^Fp, Gs^Fmw, Ww, Ww, Gs^Fp, Gs^Fp, Gs^Fp, Gs^Fp, Gg, Gs^Fp, Gs^Fp, Gs^Fp, Gs^Fp
Aa^Fpa, Aa^Fpa, Aa^Fpa, Aa^Fpa, Aa^Fpa, Aa^Fpa, Gs^Fp, Gs^Fp, Gs^Fp, Gs^Fp, Gg^Ve, Ww, Ww, Gs^Fp, Gs^Fp, Gs^Fp, Gg, Gg, Gs^Fp, Gs^Fp, Gg^Fet, Gs^Fp
Gs^Fp, Gs^Fp, Gs^Fp, Gs^Fp, Gs^Fp, Gs^Fp, Gs^Fp, Gs^Fp, Gs^Fp, Gs^Fp, Gs^Fp, Gs^Fmw, Gs^Fmw, Ww, Gg, Gs^Fp, Cvr, Cvr, Kvr, Gs^Fp, Gs^Fp, Gs^Fp
Gs^Fp, Gs^Fp, Gs^Fp, Gs^Fp, Gs^Fp, Gg, Gs^Fp, Gs^Fp, Gs^Fp, Gs^Fp, Gs^Fmw, Gs^Fmw, Gg, Ww^Bw/, Gg, Gg, Kvr, Cvr, Cvr, Gg^Efm, Gs^Fp, Gs^Fp
Gs^Fms, Gs^Fp, Gg^Fet, Gs^Fp, Gs^Fp, Gg^Ve, Gg, Gs^Fp, Gs^Fp, Gg, Gg, Gs^Fmw, Gs^Fmw, Ww, Gs^Fmw, Gs^Fp, Gg, Cvr, Gg^Efm, Gg, Gs^Fp, Gs^Fp
Gs^Fp, Gg, Gs^Fp, Gs^Fp, Gs^Fp, Gs^Fp, Gs^Fp, Gs^Fp, Gg, Gs^Fp, Gs^Fp, Gs^Fp, Gs^Fmw, Ww, Gs^Fmw, Gg^Ve, Gs^Fp, Gg, Gg^Efm, Gs^Fp, Gs^Fp, Gs^Fp
Gg, Gs^Fp, Gg, Gs^Fp, Gs^Fp, Gs^Fp, Gs^Fp, Gg, Gg, Gs^Fp, Gs^Fmw, Gs^Fmw, Wwf, Ww, Gs^Fmw, Gs^Fmw, Gs^Fp, Gg, Gs^Fp, Gg^Ve, Gs^Fp, Gs^Fp
Gs^Fp, Gs^Fp, Gg, Gs^Fp, Gs^Fp, Re, Re, Gg, Gs^Fp, Gs^Fp, Gs^Fmw, Gs^Fmw, Ww, Gs^Fmw, Gs^Fp, Gs^Fp, Gs^Fp, Gg, Gs^Fp, Gs^Fp, Gs^Fp, Gs^Fp
Gs^Fp, Re, Re, Re, Gs^Fp, Re, Gg^Efm, Gs^Fp, Gs^Fp, Gs^Fp, Gs^Fmw, Ww, Ww, Gs^Fmw, Gs^Fp, Gs^Fp, Gs^Fp, Re, Gs^Fp, Aa^Fpa, Gs^Fp, Gs^Fp
Re, Aa^Fpa, Aa^Fpa, Aa^Fpa, Re, Re, Gg^Efm, Gs^Fp, Gg^Fet, Gs^Fp, Gs^Fmw, Ww, Gs^Fmw, Gs^Fmw, Gg^Fet, Gs^Fp, Gs^Fp, Re, Aa^Fpa, Aa^Fpa, Aa^Fpa, Aa^Fpa
Aa^Fpa, Aa^Fpa, Aa^Fpa, Re, Re, Aa^Fpa, Gs^Fp, Gs^Fp, Gs^Fp, Hh, Gs^Fmw, Ww, Gs^Fmw, Gs^Fmw, Gs^Fp, Re, Re, Aa^Fpa, Aa^Vha, Aa^Fpa, Aa^Fpa, Aa^Fpa
Ms, Aa^Fpa, Aa^Fpa, Re, Aa, Aa^Fpa, Aa^Vha, Gs^Fp, Gs^Fp, Hh, Gs^Fmw, Wwf, Ww, Re, Re, Re, Aa^Fpa, Aa^Fpa, Aa^Fpa, Aa^Fpa, Aa^Fpa, Aa^Fpa
Ms, Aa^Fpa, Aa^Fpa, Aa, Aa, Re, Gs^Fp, Gs^Fp, Hh, Hh, Hh, Ww, Ww, Aa^Fpa, Aa^Fpa, Re, Aa^Fpa, Aa^Fpa, Aa^Fpa, Aa^Fpa, Aa^Fpa, Aa^Fpa
Ms, Aa^Fpa, Aa^Fpa, Re, Re, Hh, Hh, Hh, Hh, Gs^Fp, Wwf, Ww, Aa^Fpa, Aa^Fpa, Aa^Fpa, Aa^Fpa, Aa, Aa^Fpa, Aa^Fpa, Aa^Fpa, Aa^Fpa, Aa^Fpa
Aa^Fpa, Aa^Fpa, Aa^Fpa, Re, Ms, Ms, Ce, Re, Re, Aa, Ww, Aa, Aa^Fpa, Aa^Fpa, Aa^Fpa, Re, Re, Aa^Fpa, Aa^Fpa, Aa^Fpa, Ms, Ms
Aa^Fpa, Aa, Re, Ms, Ms, Ce, Ce, Re, Aa, Aa, Ww, Aa, Aa, Aa, Aa^Fpa, Re, Aa^Fpa, Aa^Fpa, Aa^Fpa, Ms, Ms, Ms
Re, Ms, Re, Ms, Ce, Ke, Ce, Aa, Aa, Ai, Ai, Aa, Aa, Re, Aa, Aa, Aa^Fpa, Aa, Ms, Ch, Ch, Ms
Ms, Ms, Aa^Vha, Ms, Ha, Ce, Ha, Aa, Ww, Ai, Aa, Aa, Re, Aa, Aa, Aa, Aa, Aa, Aa, Ch, Ch, Ch
Ms, Ms, 1 Ha, Ha, Ms, Ha, Aa, Aa, Ai, Aa, Aa, Aa, Aa, Ha, Aa, Aa, Re, Re, Aa, Aa, 3 Kh, Ch
Aa, Ms, Ms, Ms, Ms, Ha, Aa, Ww, Ww, Aa, Aa, Aa^Vha, Aa, Ha, Aa, Aa, Aa, Aa, Rb, Rb, Ur, Qxua
Ms, Ms, Aa^Vha, Aa, Ms, Aa, Aa, Ww, Aa, Aa, Aa, Ha, Ha, Ha, Ha, Ms, Aa, Aa, Rb, Ur, Qxua, Qxua
Ha, Ha, Ha, Aa, Aa, Aa, Ai, Ai, Aa, Ha, Ha, Ha, Ha, Ha, Ms, Ms, Aa, Ms, Rb, Ur, Qxua, Qxua
Ms, Ms, Ha, Ha, Ha, Aa, Ww, Ai, Aa, Ha, Ms, Ms, Ha, Ha, Ms, Ms, Ms, Ms, Ch, 2 Kh, Ch, Qxua
Ms, Ms, Ms, Ms, Ha, Ha, Aa, Ai, Aa, Ha, Ms, Ms, Ms, Ms, Ms, Ms, Ms, Ms, Ch, Ch, Ch, Ch
Ms, Ms, Ms, Ms, Ha, Ha, Aa, Ai, Aa, Ha, Ms, Ms, Ms, Ms, Ms, Ms, Ms, Ms, Ch, Ch, Ch, Ch
