Gg, Gg, Gg, Gg, Gg, Gg, Gg, Gg, Gg, Gg, Gg, Gg, Gg, Gg, Gg, Gg, Gg, Gg, Gg, Gg, Gg, Gg, Gg, Gg, Gg, Gg, Hh, Gg, Hh, Gg, Hh, Gg, Hh, Gg, Hh, Gg, Hh, Gg, Hh, Gg, Gg, Gg, Gg, Gg, Gg, Gg
Gg, Gg, Gg, Gg, Gg, Gg, Gg, Gg, Ss, Gg, Chs, Chs, Chs, Chs, Chs, Gg, Gg, Gg, Gg, Gg, Gg, Gg, Gg, Gg, Gg, Hh, Hh, Hh, Hh, Hh, Gg, Hh, Gg, Hh, Hh, Hh, Gg, Hh, Gg, Hh, Gg, Gg, Gg, Gg, Gg, Gg
Gg, Ss, Gg, Gg, Gg, Gg, Gg, Gg, Ss, Chs, Ss, Ss, Ss, Ss, Chs, Gg, Gg, Gg, Gg, Gg, Gg, Gg, Gg, Gg, Gg, Gg, Gg, Gg, Gg, Gg, Gg, Gg, Gg, Gg, Gg, Gg, Gg, Gg, Gg, Gg, Gg, Gg, Gg, Gg, Ss, Gg
Gg, Ss, Ss, Ss, Ss, Gg, Ss, Ss, Ss, Chs, Chs, Ss, 3 Khs, Ss, Chs, Gg, Ss, Gg, Gg, Ss^Vhs, Gg, Gg, Gs^Fmw, Gg, Gs^Fmw, Gg, Gg, Gg, Gg, Gg, Gg, Gg, Gg, Gg, Gg, Gg, Gg, Gg, Gg, Gg, Gg, Gg, Gg, Ss, Ss, Ss
Gg, Ss, Ss, Ss, Ss, Ss^Vhs, Ss, Ss, Ss, Ss, Ss, Chs, Ss, Chs, Ss, Ss, Ss, Ss, Ss, Ss, Ss, Ss, Ss, Gs^Fmw, Gs^Fmw, Gg, Gg, Gg, Gg, Gg, Chr, Chr, Chr, Gg, Gg, Gg, Ss, Gg, Ss, Ss, Ss, Ss, Ss, Ss, Wo, Wo
Wo, Chw, Ss, Ss, Ss, Ss, Ss, Ss, Ss, Ss, Ss, Ss, Ss, Ss, Ss, Ss, Ss, Ss, Ss, Ss, Ss, Ss, Ss, Ss^Vhs, Gs^Fmw, Gg, Ss, Gg, Gg, Chr, Chr, Ss, Ss, Chr, Ss, Ss, Ss, Ss, Wo, Ss, Wo, Wo, Wo, Wo, Wo, Wo
Wo, Wwf, Wo, Ss, Ss, Ss, Ss, Ss, Ss, Ss, Ss, Ss, Ss, Ss, Ss, Ss, Ss^Vhs, Ss, Ss, Ss, Ss, Ss, Wo, Ss, Ss, Ss, Ss, Ss, Gg, Gg, Chr, Ss, Chr, Chr, Ss, Ss, Wo, Wo, Wo, Wo, Wo, Wo, Ss, Wo, Ss, Gg
Ww, Wwf, Wo, Ss, Wo, Ss, Ss, Ss, Ss^Vhs, Ss, Ss, Ss, Wo, Ss, Wo, Ss, Wo, Ss, Ss, Ss, Wo, Wo, Wo, Wo, Wo, Ss, Ss, Ss, Gg, Gg, Ss, 4 Khs, Wo, Wo, Wo, Wo, Wo, Wo, Ss, Ss, Ss, Ss, Ss, Ss, Ss, Ss
Ww, Wwf, Ww, Wo, Ss, Wo, Wo, Wo, Wo, Wo, Wo, Wo, Wo, Wo, Wo, Wo, Wo, Wo, Wo, Wo, Wo, Wo, Ss, Wo, Wo, Wo, Wo, Ss, Gg, Gg, Wo, Ww, Wo, Wo, Wo, Wo, Ss, Ss, Ss, Ss, Ss, Ss, Gg, Ss, Ss, Gg
Gg, Gg, Ss, Ss, Ss, Ss, Ss, Wo, Ss, Ss, Ss, Wo, Ss, Ss, Ss, Ss, Ss, Ss, Ss, Ww, Ss, Ss, Ss^Vhs, Ss, Ss, Wo, Wo, Wo, Wo^Bw|, Wo, Wo, Wo, Ss, Wo, Wo, Wo, Ss, Ss, Gs^Fmw, Gs^Fmw, Gs^Fmw, Ss, Gg, Ss, Gg, Gg
Gg, Gg, Gg, Gg, Gg, Gg, Gg, Ss, Ss, Ss, Ss, Ss, Ss, Ss, Ss, Ss, Gg, Ss, Wo, Wo, Wo, Gg, Gg, Gg, Gs^Fmw, Ss, Ss, Wo, Wo^Bw|, Wo, Ss, Ss, Ss, Ss, Wo, Wo, Gg, Gg, Gg, Gs^Fmw, Gg, Gg, Gg, Gg, Gg, Gg
Gg, Gg, Gg, Gg, Gg, Gg, Gg, Gg, Gg, Gg, Gg, Gg, Gg, Gg, Gg, Gg, Gg, Gg, Wo, Ww, Wo, Gg, Gg, Gg, Gs^Fmw, Gs^Fmw, Gs^Fmw, Ss, Gg, Ss, Ss, Gg, Gg, Gg, Gg, Gg, Gg, Gg, Gg, Gg, Gg, Gg, Gg, Gg, Gg, Gg
Gg, Gg, Gg, Gg, Gg, Gg, Gg, Gg, Gg, Gg, Gg, Gg, Gg, Gg, Gg, Gg, Gg, Gg, Ww, Wo, Gg, Gg, Gg, Gg, Gg, Gg, Gg, Gg, Gg, Gg, Gg, Gg, Gg, Gg, Gg, Gg, Gg, Gg, Gg, Gg, Gg, Gg, Gg, Gg, Gg, Gg
Gg, Gg, Gg, Gg, Gg, Gg, Gg, Gs^Fmw, Gs^Fmw, Gg, Gg, Gg, Gg, Gg, Gg, Gg, Gg, Gg, Ww, Wwf, Gg, Gg, Gg, Gg, Gg, Gg, Gg, Gg, Gg, Gg, Gg, Gg, Gg, Gg, Gg, Gg, Gg, Gg, Gg, Gg, Gg, Gg, Gg, Gg, Gg, Gg
Gg, Gg, Gg, Gg, Gg, Gg, Gg, Gs^Fp, Gs^Fp, Gs^Fp, Gs^Fp, Gg, Gg, Gg, Gg, Gg, Gg, Ww, Ww, Ww, Gg, Gg, Gg, Gg, Gg, Gg, Gg, Gg, Gg, Gg, Gg, Gg, Gg, Gg, Gg, Gg, Gg, Gg, Gg, Gg, Gg, Gg, Gg, Gg, Gg, Gg
Gg, Gg, Gg, Gg, Gg, Gg, Gg, Gg, Gg^Fet, Gs^Fp, Gs^Fp, Gs^Fp, Gg, Gg, Gg, Gg, Gg, Ww, Ww, Gs^Fp, Gs^Fp, Gs^Fp, Gg, Gg, Gg, Gg, Gg, Gg, Gg, Gg, Gg, Gg, Gg, Gg^Efm, Gg, Gs^Fp, Gs^Fp, Gg, Gg, Gg, Gg, Gg, Gg, Gg, Gg, Gg
Gg, Gg, Gg, Gg, Hh, Gg^Fet, Gg^Fet, Gg^Fet, Gg^Fet, Gg^Fet, Gg^Fet, Gs^Fp, Re, Gg, Gs^Fp, Gg, Gs^Fp, Ww, Ww, Hh^Fds, Hh^Fds, Gs^Fp, Gs^Fp, Gg, Gg, Gg, Gg, Gg, Gg, Gg, Gg, Gg, Gg^Efm, Gg^Efm, Gs^Fp, Gs^Fp, Gs^Fp, Gs^Fp, Gg, Gg, Gg, Gg, Gg, Gg, Gg, Gg
Gg, Gg, Gg, Gg, Hh, Hh, Hh, Gg^Fet, Gg^Fet, Gg^Fet, Gg^Fet, Gg^Fet, Gs^Fp, Re, Gs^Fp, Gs^Fp, Hh^Fds, Ww, Ww, Hh^Fds, Hh^Fds, Gs^Fp, Re, Gg, Gg, Gg, Gg, Gg, Gg, Gg, Gg, Gg, Gg^Efm, Gg, Gg, Gs^Fp, Gs^Fp, Gs^Fp, Gg, Gg, Gg, Gg, Gg, Gg, Gg, Gg
Gg, Gg, Gg, Hh, Hh, Hh, Hh, Hh, Hh, Gg^Fet, Gs^Fp, Gs^Fp, Gs^Fp, Re, Gs^Fp, Hh^Fds, Hh^Fds, Ww, Ww, Hh^Fds, Re, Re, Gs^Fp, Gg, Gs, Gg^Wm, Gg, Gg, Gg, Gg, Gg^Efm, Gg^Efm, Gg, Gg, Gg, Gg, Gg, Gg, Gg, Gg, Gg, Gg, Gg, Gg, Gg, Gg
Gg, Gg, Gg, Gg, Hh, Hh, Hh, Hh, Hh, Gs^Fp, Gs^Fp, Gs^Fp, Gs^Fp, Re, Re, Hh^Fds, Hh^Fds, Ww, Ww^Bw/, Re, Hh^Fds, Gs^Fp, Gs^Fp, Gs, Gg, Gg, Gg, Gg, Gg, Gg, Gg, Gg^Efm, Gg, Gg, Gg, Gg, Gg, Gg, Gg, Gg, Gg, Gg, Gg, Gg, Gg, Gg
Gg, Gg, Gg, Gg, Gg, Hh, Gg, Hh, Gg, Gg, Gg, Gs^Fp, Gs^Fp, Gs^Fp, Gs^Fmw, Re, Re, Ww^Bw/, Ww, Hh^Fds, Gs^Fp, Gs^Fp, Gg, Gg, Gg, Gg, Ce, Gg, Gg, Gg, Gs, Gg^Ve, Gg, Gg, Gg, Gg, Gg, Gg, Gg, Gg, Gg, Gg, Gg, Gg, Gg, Gg
Gg, Gg, Gg, Gg, Gg, Gg, Gg, Gg, Gg, Gg, Gg, Gs^Fp, Gs^Fp, Gs^Fp, Gg, Hh^Fds, Hh^Fds, Ww, Ww, Hh^Fds, Gs^Fp, Gg, Gg, Gg, Gg, Ce, Gg, Ce, Ce, Gg, Gg, Gg, Gg, Gg, Gg, Gg, Gg, Gg, Gg, Gg, Gg^Vh, Gg, Gg, Gg, Gg, Gg
Gg, Gg, Gg, Gg, Gg, Gg, Gg, Gg, Re^Gvs, Re^Gvs, Re^Gvs, Gg, Re^Gvs, Gg, Gg, Ww, Ww, Ww, Ww, Gs^Fp, Gs^Fp, Gg, Gg, Gg, Gg, Ce, 1 Ke, Gg, Ce, Gg, Gg, Gg, Gg, Gg, Ce, Ce, 2 Ke, Gg, Gg, Gg, Gg, Gg, Gg, Gg, Gg, Gg
Gs^Fmw, Gg, Gg, Gg, Gg, Gg, Gg, Gg, Re^Gvs, Re^Gvs, Gg^Vl, Re^Gvs, Re^Gvs, Gg, Gg, Ww, Ww, Ww, Ss, Hh^Fds, Gs^Fp, Gs^Fp, Gg, Gg, Gg, Gg, Gg, Ce, Gg, Gg, Gg, Gg, Gg, Gg, Ce, Gg, Gg, Ce, Gg, Gg, Gg, Gg, Gg, Gg, Gg, Gg
Gs^Fmw, Gs^Fmw, Gs^Fmw, Gg, Gg, Gg, Gg, Re^Gvs, Re^Gvs, Re^Gvs, Re^Gvs, Gg, Gg, Gg, Gg, Ww, Wo, Ww, Ss, Gs^Fp, Gs^Fp, Gs^Fp, Gg, Gg, Gg, Gg, Gg, Gg, Gg, Gg, Gg, Gg, Gg, Gg, Ce, Gg, Ce, Ce, Gg, Gg, Gg, Gg, Re^Gvs, Gg, Re^Gvs, Gg
Gs^Fmw, Gs^Fmw, Gs^Fmw, Gg, Gg, Gg, Gg, Re^Gvs, Re^Gvs, Re^Gvs, Re^Gvs, Gg, Gg, Gg, Gs^Fmw, Ww, Wo, Ww, Ww, Gs^Fp, Gs^Fp, Gg, Gg, Gg, Gg, Gg, Gg, Gg, Gg, Gg, Gg, Gg, Gg, Gg, Gg, Ce, Gg, Gg, Gg, Gg, Gg, Re^Gvs, Re^Gvs, Re^Gvs, Re^Gvs, Re^Gvs
Gs^Fmw, Gs^Fmw, Gg, Gg, Gg, Gg, Gg, Gg, Re^Gvs, Re^Gvs, Gg, Gg, Gg, Gs^Fmw, Ww, Ww, Wo, Ww, Gs^Fmw, Ww, Ww, Gs^Fp, Gs^Fp, Gg, Gg, Gg, Gg, Gg, Gg, Gg, Gg, Gg, Gg, Gg, Gg, Gg, Gg, Gg, Gg, Gg, Re^Gvs, Re^Gvs, Re^Gvs, Re^Gvs, Re^Gvs, Re^Gvs
Gg, Gg, Gg, Gg, Gg, Gg, Gg, Gg, Gg, Re^Gvs, Gg, Gg, Gg, Gg, Ww, Ww, Wo, Ww, Gs^Fp, Gs^Fp, Gs^Fp, Ww, Ww, Gg, Gg, Gg, Gg, Gg, Gs^Fmw, Gs^Fmw, Ss, Gg, Gg, Gg, Gg, Gg, Gg, Gg, Gg, Gg, Gg, Re^Gvs, Re^Gvs, Re^Gvs, Re^Gvs, Gg
Gg, Gg, Gg, Gg, Gg, Gg, Gg, Gg, Gg, Gg, Gg, Gg, Gg, Gg, Ww, Wo, Ww, Gg, Gg, Gg, Gg, Gs^Fp, Gg, Ww, Ww, Wwf, Wwf, Gs^Fmw, Ss, Ss, Ww, Ss, Ss, Gg, Gg, Gg, Gg, Gg, Gg, Gg, Gg, Re^Gvs, Re^Gvs, Re^Gvs, Re^Gvs, Gg
Gg, Gg, Gg, Gg, Ce, Ce, Ce, Gg, Gg, Gg, Gg, Gg, Gg, Gg, Ww, Ww, Wo, Ww, Gg, Gg, Gg, Gg, Gg, Gg, Gg, Gg, Gg, Ww, Ww, Ww, Ww, Ww, Ww, Ss, Gg, Gg, Gg, Gg, Gg, Gg, Gg, Gg, Gg, Re^Gvs, Re^Gvs, Gg
Gg, Gg, Gg, Gg, Ce, 5 Ke, Ce, Gg, Gg, Gg, Gg, Gg, Gg, Gg, Gg, Ww, Wo, Ww, Gg, Gg, Gg, Gg, Gg, Gg, Gg, Gg, Gg, Gg, Gg, Ww, Ww, Ww, Ww, Ss, Gg, Gg, Gg, Gg, Ww, Ww, Ww, Gg, Gg, Gg^Vl, Re^Gvs, Gg
Gg, Gg, Gg, Gg, Gg, Ce, Gg, Gg, Gg, Gg, Gg, Gg, Gg, Gg, Gg, Ww, Wo, Ww, Gg, Gg, Gg, Gg, Gg, Gg, Gg, Gg, Gg, Gg, Gg, Gg, Gg, Gs^Fmw, Gs^Fds, Ww, Ww, Gg, Ww, Ww, Gg, Ww, Gg, Ww, Ww, Gg, Gg, Gg
Gg, Gg, Gg, Gg, Gg, Ce, Gg, Gg, Gg, Gg, Gg, Gg, Gg, Gg, Gg, Ww, Ww, Wo, Gg, Gg, Gg, Gg, Gg, Gg, Gg, Gg, Gg, Gg, Gg, Gg, Gg, Gs^Fds, Gs^Fds, Gs^Fmw, Gs^Fds, Ww, Gg, Gg, Gg, Gg, Gg, Gs^Fds, Gs^Fmw, Ww, Ww, Ww
Gg, Gg, Gg, Gg, Gg, Gg, Gg, Gg, Gg, Gg, Gg, Gg, Gg, Gg, Gg, Ww, Ww, Wo, Ww, Gg, Gg, Gg, Gg, Gg, Gg, Gg, Gg, Gg, Gs^Fp, Gg, Gs^Fp, Gs^Fmw, Gs^Fp, Gs^Fds, Gs^Fds, Gs^Fds, Gg, Gg, Gg, Gg, Gg, Gs^Fp, Gs^Fp, Gs^Fds, Gg, Gg
Gg, Gg, Gg, Gg, Gg, Gg, Gg, Gg, Gg, Gg, Gg, Gg, Gg, Gg, Gg, Ww, Ww, Wo, Gg, Gg, Gg, Gg, Gg, Gg, Gg, Gg, Gg, Gs^Fp, Gg, Gs^Fp, Gs^Fp, Gs^Fp, Gg, Gs^Fp, Gs^Fp, Gs^Fp, Gs^Fp, Gs^Fp, Gs^Fp, Gs^Fp, Gg, Gs^Fp, Gs^Fp, Gs^Fp, Gg, Gg
