Ww, Ww, Ww, Mm, Mm, Mm, Mm, Mm, Mm, Mm, Mm, Mm, Mm, Mm, Mm, Mm, Mm, Mm, Mm, Mm, Mm, Mm, Mm, Mm, Hh, Hh^Fp, Hh^Fp, Re, Gs^Fp, Gs^Fp, Mm, Mm
Ww, Ww, Ww, Mm, Mm, Mm, Mm, Mm, Mm, Mm, Mm, Mm, Mm, Mm, Mm, Mm, Mm, Mm, Mm, Mm, Mm, Mm, Mm, Mm, Hh, Hh^Fp, Gs^Fp, Re, Hh^Fp, Hh^Fp, Mm, Mm
Mm, Mm, Mm, Mm, Mm, Mm, Mm, Mm, Mm, Mm, Mm, Mm, Mm, Mm, Mm, Mm, Mm, Mm, Mm, Mm, Mm, Mm, Mm, Hh, Hh, Hh^Fp, Re, Re, Hh^Fp, Hh, Mm, Mm
Mm, Mm, Mm, Mm, Mm, Mm, Mm, Mm, Mm, Mm, Mm, Mm, Mm, Mm, Mm, Mm, Mm, Mm, Hh^Vhh, Mm, Mm, Mm, Mm, Hh, Hh, Gs^Fp, Re, Hh^Fp, Hh, Hh, Mm, Mm
Ms, Ms, Ms, Mm, Mm, Mm, Mm, Mm, Hh, Mm, Mm, Mm^Vhh, Mm, Mm, Mm, Gg, Gg, Gg, Gg, Gg, Ce, Ce, Ce, Gg, Gg, Gg, Re, Gs^Fp, Hh, Hh, Mm, Mm
Ms, Ms, Ms, Ms, Mm, Mm, Mm, Mm, Gg^Vh, Hh, Mm, Mm, Mm, Mm, Mm, Hh, Hh^Vhh, Hh, Hh, Hh, Ce, 6 Ke, Ce, Hh, Gg, Gg, Re, Gg, Mm, Mm, Mm, Mm
Ms, Ms, Ms, Mm, Mm, Mm, Mm, Hh, Mm, Hh^Fp, Gs^Fp, Hh^Fp, Gg, Gg, Gg, Gg, Gg, Gg, Re, Gg, Ce, Ce, Ce, Re, Re, Re, Hh^Vhh, Hh, Mm, Mm, Mm, Mm
Ms, Ms, Mm, Mm, Mm^Vhh, Mm, Mm, Mm, Mm, Ww, Gg, Gg, Gs, Gs, Gs, Gg, Re, Re, Gg, Re, Mm, Mm, Mm, Mm, Gg, Gg, Hh, Hh, Mm, Mm, Mm, Mm
Ms, Ms, Ms, Mm, Mm, Mm, Mm, Mm, Mm, Mm, Mm, Hh^Vhh, Gll^Fp, Gll^Fp, Gll^Fp, Gs, Re, Hh, Hh, Hh, Hh, Hh, Hh, Hh, Hh, Ss, Hh, Hh, Mm, Mm, Mm, Mm
Mm, Ms, Mm, Mm, Mm, Mm, Mm^Vhh, Mm, Mm, Mm, Mm, Hh^Fp, Gll^Fp, Gll^Fp, Gll^Fp, Gs, Re, Hh, Hh, Hh, Mm, Mm, Mm, Mm, Mm, Mm, Mm, Mm, Mm, Mm, Ms, Mm
Mm, Mm, Mm, Mm, Mm, Mm, Mm, Mm, Mm, Mm, Mm, Hh^Fp, Gll^Fp, Gll^Fp, Gg^Vh, Re, Gg, Hh, Hh, Hh, Hh, Hh, Hh, Mm, Mm, Mm, Mm, Mm, Mm, Ms, Ms, Ms
Mm, Mm, Mm, Mm, Mm, Mm, Mm, Mm, Mm, Mm, Hh^Vhh, Hh^Fp, Gll^Fp, Gs, Gg, Re, Hh, Hh, Hh, Hh, Hh, Mm, Mm, Hh^Vhh, Mm, Mm, Mm, Mm, Ms, Ms, Ms, Ms
Mm, Mm, Mm, Mm, Mm, Mm, Mm, Hh, Hh, Hh^Fp, Hh^Fp, Gll^Fp, Gs, Gs, Gs, Re, Re, Re, Re, Hh, Hh, Mm, Mm, Mm, Mm, Mm, Mm, Mm, Mm, Ms, Ms, Ms
Mm, Mm, Mm, Mm, Mm, Mm, Mm, Mm, Mm, Hh, Hh, Gll^Fp, Gll^Fp, Gll^Fp, Gll^Fp, Gll^Fp, Gll^Fp, Gs, Re, Hh, Mm, Mm, Mm, Mm^Vhh, Mm, Mm, Mm, Mm, Mm, Ms, Ms, Ms
Mm, Mm, Mm, Mm, Hh, Hh, Hh, Hh, Hh, Hh, Hh^Fp, Hh^Fp, Gll^Fp, Gll^Fp, Gll^Fp, Gll^Fp, Re, Re, Hh, Mm, Mm, Mm, Mm, Mm, Mm, Mm, Mm, Mm, Mm, Mm, Ms, Ms
Mm, Mm, Mm, Mm, Hh^Fp, Hh^Fp, Gll^Fp, Hh^Fp, Gll^Fp, Hh^Fp, Gll^Fp, Gll^Fp, Gll^Fp, Gll^Fp, Gll^Fp, Gll^Fp, Re, Hh, Hh, Mm, Mm, Mm, Mm, Mm, Mm^Vhh, Mm, Mm, Mm, Mm, Mm, Ms, Ms
Mm, Mm, Mm, Mm, Mm, Gll^Fp, Hh^Vhh, Gll^Fp, Gll^Fp, Gll^Fp, Gg^Vh, Gll^Fp, Gll^Fp, Ww, Mm, Hh, Mm, Mm, Mm, Mm, Mm, Mm, Mm, Mm, Hh^Vhh, Mm, Mm, Mm, Mm, Mm, Mm, Ms
Mm, Mm, Mm, Mm, Hh, Hh, Hh, Hh, Hh, Gll^Fp, Gll^Fp, Gll^Fp, Gll^Fp, Gll^Fp, Mm, Hh, Hh, Hh, Hh, Hh, Gs^Fp, Hh^Fp, Mm, Mm, Mm, Hh, Hh, Mm, Mm, Mm, Mm, Mm
Mm, Mm, Mm, Ce, Ce, Ce, Hh, Hh, Gs^Fp, Mm, Mm, Hhd, Mm, Mm, Mm, Hh, Hh, Hh, Hh, Gs^Fp, Hh^Fp, Gs^Fp, Mm, Mm, Mm, Mm, Hh, Gs^Fp, Mm, Mm, Mm, Mm
Mm, Mm, Hh, Ce, 7 Ke, Ce, Mm, Re, Gs^Fp, Hh^Fp, Hh, Hh, Mm, Mm, Mm, Hh, Hh, Hh, Hh, Hh, Mm, Mm, Mm, Mm^Vhh, Mm, Hh, Hh, Hh, Mm, Mm, Mm, Mm
Mm, Mm, Hh, Ce, Ce, Mm, Mm, Mm, Hh, Hh, Hh, Hh, Hh, Hh, Gll^Fp, Hh^Fp, Gll^Fp, Gll^Fp, Gll^Fp, Gll^Fp, Hh^Fp, Mm, Mm, Mm, Gs^Fp, Hh, Mm, Mm, Mm, Mm, Mm, Mm
Hh^Fp, Hh^Fp, Gll^Fp, Hh, Hh^Vhh, Hh^Fp, Gll^Fp, Hh^Fp, Gll^Fp, Hh^Fp, Gll^Fp, Gll^Fp, Gll^Fp, Gll^Fp, Hh^Fp, Gll^Fp, Hh^Fp, Gll^Fp, Hh^Fp, Gll^Fp, Hh^Fp, Gs^Fp, Gs^Fp, Mm, Hh, Hh, Mm, Mm, Mm, Mm, Mm, Mm
Gll^Fp, Gll^Fp, Gll^Fp, Gll^Fp, Gll^Fp, Gll^Fp, Gll^Fp, Gs, Gll^Fp, Gll^Fp, Gll^Fp, Mm, Mm, Mm, Mm, Mm, Mm, Mm, Mm, Mm, Mm, Mm, Mm, Hh^Vhh, Hh, Mm, Mm, Mm, Mm, Mm, Mm, Mm
Gll^Fp, Gll^Fp, Gll^Fp, Gs, Gs, Gll^Fp, Gll^Fp, Gll^Fp, Hh^Fp, Gll^Fp, Gll^Fp, Hh, Gs^Fp, Hh, Hh, Mm, Mm, Mm, Mm, Mm, Mm, Mm, Mm, Mm, Hh, Hh, Hh, Mm, Mm, Mm, Mm, Mm
Hh^Fp, Hh^Fp, Hh^Fp, Gll^Fp, Gs, Gs, Gs, Hh, Hh, Hh, Re, Re, Gs^Fp, Hh^Fp, Gs^Fp, Hh, Hh, Hh, Cud, Cud, Cud, Cud, Hh^Fp, Gs^Fp, Mm, Mm, Mm, Mm, Mm, Mm, Mm, Mm
Mm, Mm, Mm, Mm, Hh^Vhh, Mm, Hh, Ww, Hh, Hh, Hh, Hh, Gg, Re, Re, Hh^Vhh, Gg, Hh, Cud, Cud, 4 Kud, Cud, Hh, Mm, Mm, Mm, Mm^Vhh, Mm, Mm, Mm, Mm, Mm
Mm, Mm, Mm, Mm, Mm, Mm, Mm, Hh, Hh, Hh^Fp, Hh, Hh, Hh, Hh, Hh, Gll, Gg, Hh, Hh, Cud, Cud, Cud, Cud, Mm, Mm, Mm, Mm, Mm, Mm, Mm, Mm, Mm
Mm, Mm, Mm, Mm, Mm, Gll^Fp, Gll^Fp, Hh^Fp, Gll^Fp, Hh^Fp, Gll^Fp, Hh^Fp, Gg, Hh, Hh, Hh, Hh, Hh, Hh, Hh, Hh, Hh, Hh, Mm, Mm, Mm, Mm, Mm, Mm, Mm, Mm, Mm
Mm, Mm, Mm, Mm, Hh^Fp, Hh^Fp, Gll^Fp, Gll^Fp, Gll^Fp, Gll^Fp, Gll^Fp, Mm, Hh, Gg, Gg, Gg, Gg, Hh, Hh, Mm, Mm, Mm, Mm, Mm, Mm, Mm, Hh, Mm, Mm, Mm, Mm, Mm
Ms, Mm, Mm, Mm, Mm, Mm, Mm, Mm, Mm, Gs, Gg, Gs, Gg, Gg, Gg^Es, Gg, Hh^Fp, Hh^Fp, Hh^Fp, Hh^Fp, Mm, Mm, Mm, Mm, Mm, Mm, Mm, Mm, Gs^Fp, Mm, Mm, Mm
Ms, Ms, Ms, Mm, Mm, Mm, Mm, Mm, Hh^Vhh, Mm, Gg, Gg, Gg, Gg, Gg, Gg, Gg, Gg, Gg, Gg, Gg, Gll, Re, Ce, Ce, Ce, Mm, Mm, Gs^Fp, Mm, Mm, Mm
Ms, Ms, Ms, Mm, Mm, Mm, Mm, Mm, Hh, Hh, Hh, Hh, Hh, Hh, Hh^Fp, Re, Hh^Vhh, Hh^Fp, Hh^Fp, Hh, Hh, Hh, Mm, Ce, 5 Ke, Ce, Ce, Ce, Hh, Mm, Mm, Mm
Ms, Ms, Ms, Ms, Mm, Mm, Mm, Hh^Fp, Hh^Fp, Hh^Fp, Hh^Fp, Hh^Fp, Gll^Fp, Gs, Re, Hh^Fp, Hh, Hh, Mm, Gll^Fp, Gll^Fp, Hh, Hh, Ce, Ce, Ce, Hh, Mm, Mm, Mm, Mm, Mm
Ms, Ms, Ms, Mm, Mm, Mm, Mm, Mm, Mm, Hh, Hh, Hh, Hh, Gll^Fp, Gll^Fp, Gll^Fp, Gll^Fp, Gll^Fp, Gll^Fp, Gll^Fp, Gll^Fp, Gll^Fp, Hh, Hh, Mm, Hh, Mm, Mm, Mm, Mm, Mm, Mm
Ms, Ms, Mm, Mm, Mm, Mm, Mm, Mm, Mm, Mm, Mm, Mm, Gs, Gs, Gs, Gs, Gs, Gs, Gs^Em, Gll^Fp, Gll^Fp, Gll^Fp, Gll^Fp, Gll^Fp, Gs, Gg, Gg, Hh, Hh, Mm, Mm, Mm
Mm, Mm, Hh, Mm, Mm, Mm, Mm, Mm, Mm, Mm, Mm, Mm, Hh^Fp, Gll^Fp, Gll^Fp, Gll^Fp, Gll^Fp, Gll^Fp, Gll^Fp, Gll^Fp, Gll^Fp, Gll^Fp, Gll^Fp, Gll^Fp, Gll^Fp, Hh^Fp, Hh^Fp, Mm, Hh, Hh^Fp, Hh^Fp, Hh^Fp
Mm, Mm, Hh, Mm, Mm^Vhh, Mm, Mm, Mm, Mm, Mm, Mm, Mm, Mm, Gll^Fp, Gll^Fp, Gll^Fp, Gll^Fp, Gll^Fp, Gll^Fp, Gll^Fp, Gll^Fp, Gll^Em, Gll^Fp, Gll^Fp, Gll^Fp, Gll^Fp, Gll^Fp, Hh^Fp, Gs, Hh^Fp, Hh^Fp, Hh^Fp
Mm, Mm, Mm, Mm, Mm, Mm, Mm, Hh^Fp, Gll^Fp, Hh^Fp, Gll^Fp, Hh^Vhh, Gll^Fp, Gll^Fp, Gll^Fp, Gll^Fp, Gg, Ce, Ce, Gll^Fp, Gll^Fp, Gll^Fp, Gll^Fp, Gll^Fp, Gll^Fp, Gll^Fp, Gll^Fp, Gll^Fp, Hh^Fp, Mm, Hh, Hh
Hh, Hh, Mm, Mm, Mm, Mm, Mm, Hh^Fp, Gll^Fp, Gll^Fp, Gll^Fp, Gll^Fp, Gll^Fp, Gll^Fp, Ce, Gll^Fp, Gll^Fp, 1 Ke, Ce, Gll^Fp, Gll^Fp, Gll^Fp, Ce, Gll^Fp, Gll^Fp, Gll^Fp, Gll^Fp, Mm, Mm, Mm, Hh, Hh
Mm, Mm, Mm, Mm, Mm, Mm, Mm, Mm, Hh^Vhh, Gll^Fp, Gll^Fp, Gll^Fp, Gll^Em, Ce, 3 Ke, Gll^Fp, Gll^Fp, Gll^Fp, Gll^Fp, Gll^Fp, Gll^Fp, Ce, 2 Ke, Ce, Gll^Fp, Gll^Fp, Gll^Fp, Gll^Fp, Hh^Fp, Hh^Fp, Mm, Mm
Mm, Mm, Mm, Mm, Mm, Mm, Mm, Hh^Fp, Gll^Fp, Gll^Fp, Gll^Fp, Gll^Fp, Gll^Fp, Ce, Gll^Fp, Gll^Fp, Gll^Fp, Gll^Fp, Gll^Fp, Gll^Fp, Gll^Fp, Gg, Gll^Fp, Gg, Gll^Fp, Gll^Fp, Gll^Fp, Gll^Fp, Mm, Mm, Mm, Mm
Mm, Mm, Mm, Mm, Mm, Mm, Mm, Hh^Fp, Gll^Fp, Gll^Fp, Gll^Fp, Gll^Fp, Gll^Fp, Gll^Fp, Gll^Fp, Gll^Fp, Gll^Fp, Gll^Fp, Gll^Fp, Gll^Fp, Gll^Fp, Gll^Fp, Gll^Fp, Gll^Fp, Gll^Fp, Gll^Fp, Gll^Fp, Gll^Fp, Mm, Mm, Mm, Mm
