Mm, Mm, Mm, Mm, Mm, Mm, Mm, Mm, Hh, Hh, Hh, Hh, Hh, Hh, Hh, Hh, Hh, Hh, Hh, Hh, Hh, Hh, Hh, Hh, Hh, Hh, Hh, Hh, Hh, Hh, Ww, Ww, Ww, Hh, Hh, Hh, Hh, Hh, Hh, Hh, Hh, Ha, Ha, Ms, Ms, Ha, Hh, Hh, Hh, Hh, Gg, Gg, Ai, Ai, Ai, Gg
Mm, Mm, Mm, Mm, Mm, Hh, Mm, Hh, Hh, Hhd, Ce, Hhd, Ce, Hh, Hh, Hh, Hh, Hh, Hh, Hh, Hh, Hh, Hh, Hh, Hh, Hh, Hh, Hh, Hh, Hh, Wwg, Ww, Wwg, Hh, Hh, Hh, Hh, Hh, Hh, Hh, Hh, Ha, Ha, Ms, Ms, Ha, Ha, Hh, Hh, Hh, Gs, Gg, Ai, Ai, Ai, Gg
Mm, Mm, Hh, Hh, Hh, Hh, Hh, Hh, Hhd, Ce, Ke, Ce, Ce, Hhd, Gd, Gs, Gs, Gg, Gll^Fp, Hh^Fp, Hh^Fp, Hh^Fp, Gd^Fmf, Hh^Vhh, Gd^Fmf, Gll^Fp, Gd^Fmf, Gs^Fdf, Gs^Fds, Ss, Ss, Ww, Wwg, Ss, Ss, Ss, Ss, Ss, Ss, Wwg, Ww, Ai, Aa^Fma, Aa^Fma, Rb, Aa, Aa^Voa, Gs, Gg^Es, Gg, Re, Re, Ai, Ai, Ai, Gg
Hh, Mm, Hh, Hh, Hhd, Hhd, Hhd, Hh, Hhd, Ce, Ce, Ce, Hhd, Hhd, Gs, Gd^Fmf, Gd^Fdf, Gll^Fp, Gd^Fmf, Gll^Fp, Gd^Fmf, Gd^Fmf, Gs^Fms, Gs^Fms, Gs^Fms, Gd^Fmf, Ss, Ss, Ss, Ss, Ss, Ww, Ww, Gs^Fds, Gs^Fds, Gs^Fds, Gs^Fds, Wwg, Wwg, Gd^Fmf, Hhd^Fmf, Hhd^Fmf, Gs^Fp, Gs^Fp, Gs^Fp, Rb, Rb, Rb, Aa^Voa, Gs^Fp, Re, Re, Re, Ai, Ai, Gg
Hh, Hh, Hhd, Hhd, Re, Ce, Ce, Hhd, Hhd, Hhd, Hhd, Ms, Ms, Ms, Gll^Fp, Gd^Fmf, Ss^Fdw, Gd^Fdf, Gs^Fds, Hh^Fms, Gs^Fms, Hh^Fms, Gs^Fms, Gg^Vl, Gs^Fms, Gs^Fds, Gs^Fds, Gs^Fds, Wwg, Wwg, Wwg^Es, Ww, Ww, Ww, Gs^Fds, Wwg, Wwr, Ww, Ww^Es, Ww, Gs^Fms, Hh^Vo, Ms, Ms, Ms, Coa, Co, Coa, Ms, Ms, Ms, Mm, Mm, Gs^Fp, Gs^Fp, Gg
Re, Re, Re, Re, Re, Ke, Ce, Ce, Hhd, Hhd, Hhd, Hh, Ss, Gll^Fp, Ss, Ss, Ss, Ss, Ss, Gs^Fds, Gs^Fds, Gs^Vht, Gs^Fds, Gs^Fms, Gll^Fp, Gll^Fp, Gs^Fds, Gs^Fds, Wwg, Hhd^Fdf, Ww, Ww, Ww, Ww, Ww, Ww^Es, Hhd^Fdf, Ww^Es, Ww, Ww, Gs^Fms, Gs^Fp, Ms, Ms, Ms, Coa, Koa, Coa, Ms, Ms, Ms, Hh^Fp, Gs^Fp, Gs^Fp, Gs^Fp, Gg
Re, Ce, Ce, Re, Re, Ce, Ce, Ce, Hhd, Hhd, Hhd, Wwg, Ss, Wwg, Ss, Ss, Ss, Ss, Gs^Fds, Hh^Fds, Gs^Fds, Wwg, Gs^Fds, Gs^Fds, Gs^Fds, Gs^Fds, Gs^Fds, Ss, Ww, Ww, Gg^Ve, Gs^Fds, Gs^Fds, Gs^Fds, Ww, Ww, Ww^Es, Wwr, Hhd^Fdf, Ww, Gs^Fds, Gs^Fp, Gs^Fp, Ms, Ms, Coa, Coa, Coa, Ms, Ms, Ms, Ms, Gs^Fp, Gs^Fp, Gs^Fp, Gg
Re, Ce, Ke, Re, Re, Re, Re, Re, Ww, Ww^Es, Hhd^Fdf, Wwg, Wwg, Ss, Wwg, Ss, Ss, Gs^Fds, Gs^Fds, Gs^Fds, Wwg, Ww, Hhd^Fdf, Ww, Ww, Ww, Ww, Ww, Gs^Fds, Gs^Fds, Gs^Fms, Gs^Fms, Gs^Fms, Gs^Fds, Gs^Fds, Gs^Fds, Ww, Ww, Hh^Fms, Gs^Fds, Ww, Gs^Fms, Gs^Fp, Ms, Ms, Ms, Ms, Hh^Fp, Ms, Ms, Gs^Fp, Gs^Fp, Gs^Fp, Gs^Fp, Gs^Fp, Gg
Re, Ce, Ce, Ce, Re, Re, Gd, Gd, Ww, Ww, Ww, Hhd^Fdf, Gs^Fds, Ss, Wwg, Wwg, Wwg, Wwg, Hhd^Fdf, Ss, Ww, Ww, Ww, Gs^Fds, Ww, Hhd^Fdf, Ww, Gs^Fds, Gg^Vl, Gs^Fms, Gs^Fms, Hh^Fms, Gs^Fms, Gg^Ve, Gs^Fms, Gs^Fds, Ww, Ww, Gs^Fds, Hh^Fds, Ww, Gs^Fms, Gs^Fms, Gs^Fp, Gd^Fmf, Hh^Vo, Gd^Fmf, Gs^Fp, Gd^Fmf, Gs^Fp, Gs^Fp, Gs^Fp, Gs^Fp, Gs^Fp, Gs^Fp, Gg
Re, Ce, Re, Ce, Gs, Gs, Gs^Fds, Gs, Gs^Fds, Gs^Fds, Gs^Fds, Gs^Fds, Gs^Fds, Gs^Fds, Gs^Fds, Hh^Fds, Gs^Fds, Ww, Ww, Ww, Ww^Es, Gs^Fds, Gs^Fds, Gs^Fds, Gs^Fds, Gs^Fds, Gs^Fds, Gs^Fds, Gs^Fms, Gs^Fms, Gs^Fds, Ds, Ds^Es, Gs^Fms, Gs^Fms, Hh^Fds, Gs^Fds, Hh^Fds, Gs^Fms, Gs^Fds, Ww^Es, Ww^Es, Hh^Fds, Gs^Fms, Ww, Ww, Gd^Fmf, Hhd^Fmf, Gd^Fdf, Gs^Fms, Gs^Fms, Gg^Fet, Gs^Fp, Gs^Fp, Gs^Fp, Gg
Gg, Re, Gd, Gd, Gs^Fds, Gs^Fds, Hh^Fds, Gs^Fds, Gs^Fds, Gs^Fds, Hh^Fds, Gs^Fds, Ww, Ww, Ww, Ww, Ww, Gs^Fds, Gs^Fds, Gs^Fds, Gs^Fds, Gg^Vl, Gs^Fms, Gs^Fds, Ce, Ce, Gs^Fds, Gs^Fms, Gs^Fms, Gs^Fms, Gs^Fds, Ds, Hd, Gs^Fds, Gs^Fds, Ce, Ke, Ce, Gs^Fds, Hh^Fms, Ww, Ww, Gs^Fms, Ww^Es, Ww, Wwr, Ww^Es, Ww, Ww, Hh^Fds, Gs^Fms, Gs^Fms, Gs^Fms, Gs^Fms, Gs^Fp, Gg
Gg, Gg, Gs^Fds, Gs, Gs^Fds, Hh^Fds, Gs^Fds, Gs^Fds, Ww, Ww, Ww, Ww, Ww, Ww, Hh^Fds, Gs^Fds, Gs^Fds, Gs^Fds, Gs^Fms, Gs^Fms, Gs^Fms, Gs^Fms, Re^Fms, Gll^Fp, Ce, Ke, Gs^Fds, Ce, Ce, Gs^Fds, Ds^Es, Ww, Ww^Es, Ds, Gs^Fds, Ce, Gs^Fds, Ce, Gs^Fds, Gs^Fds, Gs^Fms, Hh^Fds, Ww, Gs^Fds, Ww, Hhd^Fdf, Gs^Fds, Gs^Fds, Gs^Fds, Gs^Fds, Gs^Fds, Gs^Fds, Gs^Fds, Gs^Fms, Gs^Fms, Gg
Gs^Fds, Hh^Fds, Hh^Fds, Hh^Fds, Gs^Fds, Hh^Fds, Hh^Fds, Ww, Ww, Ww, Ww, Ww, Ww, Gs^Fds, Ce, Ke, Ce, Gs^Fms, Gg^Vl, Gs^Fp, Gs^Fms, Gll^Fp, Gg^Efm, Gs^Fds, Gs^Fds, Gll^Fp, Gll^Fp, Ke, Ce, Gs^Fds, Gs^Fds, Gs^Fds, Gs^Fds, Ww, Ww, Ds, Gs^Fds, Gs^Em, Gs^Fds, Gs^Fds, Gs^Fds, Gs^Fds, Gs^Fds, Gs^Fds, Gs^Fds, Gs^Fds, Ww, Ww, Gg^Ve, Gs^Fds, Gs^Fds, Gs^Fds, Gs^Fds, Gg^Em, Gg, Gg
Gs^Fds, Hh^Fds, Hh^Fds, Hh^Fds, Ww, Ww, Wo, Wo, Ww, Ww, Ww, Ww, Hh^Fds, Hh^Fds, Gs^Fms, Ce, Gs^Fms, Gs^Fms, Gll^Fp, Gg^Vl, Gs^Fms, Gll^Fp, Re^Fms, Gs^Fds, Ce, Ke, Ce, Gs^Fds, Gs^Fds, Gs^Fds, Gs^Fds, Ds, Ww, Gg^Efm, Gg^Vh, Gs, Gg, Gs, Gg, Gg^Efm, Gg, Hh^Fds, Gs^Fds, Gs^Fds, Gs^Fds, Wwg, Gs^Fds, Gs^Fds, Gs^Fds, Gg, Gg, Gg, Gg, Gg, Gg, Gg
Hh^Fds, Hh^Fds, Ww, Ww, Wo, Wo, Wo, Wo, Ww, Ww, Ww, Gs^Fds, Ce, Ce, Gs^Fds, Gg^Fet, Ce, Gs^Fms, Gll^Fp, Gs^Fms, Gs^Fp, Gs^Em, Gs^Fp, Re^Fms, Gs^Fms, Ce, Gs^Fms, Gs^Fds, Gs^Fds, Gs^Fds, Gg, Gg, Gg, Rp^Ve, Rp, Gg, Gd, Gg, Gd, Gg, Gg, Gg, Gg, Gg, Gg, Wwf, Wwg, Gg, Gs, Gg, Gg, Gg^Efm, Gg, Gg, Gg, Gg
Ww, Ww, Wwr, Wo, Wo, Wwr, Ww, Ww, Gs^Fds, Gs^Fds, Gs^Fms, Ss, Ce, Ke, Gs^Fds, Ke, Ce, Gs^Fds, Gs^Fds, Gs^Fms, Gs^Fms, Gg^Ve, Gs^Fms, Gs^Fms, Gs^Fms, Gs^Fp, Gg, Gg, Gg, Gg, Gg, Gs, Re, Rp, Gg, Gd, Gg, Gd, Gg, Gd, Gg^Ve, Gs, Gg, Gg, Gg, Gg, Ww, Wwg, Wwf, Wwg, Wwf, Gs, Gg, Gg, Gg, Gg
Wo, Wo, Wo, Wo, Ww, Ww, Gs^Fds, Gs^Fds, Hh^Fds, Gs^Fds, Gs^Fds, Hh^Fds, Gs^Fds, Hh^Fds, Gs^Fds, Ce, Gs^Fds, Ss, Gs^Fds, Gs^Fms, Gs^Fms, Gs^Fms, Gg^Es, Gs, Gg, Gg^Ve, Gg, Gg, Gs, Gs, Re, Re, Rb^Vh, Rp, Gg, Gg, Re, Re, Re, Gs, Re, Gs, Gg, Gg^Es, Gg, Gg, Gg, Gs, Wwf, Wwf, Wwg, Gg, Gg^Vh, Gg, Gg, Gg
Wo, Wo, Ww, Ww, Gs^Fds, Ww, Gs^Fds, Gs^Fds, Gs^Fds, Gs^Fds, Gs^Fds, Gs^Fds, Gs^Fds, Gs^Fds, Gs^Fds, Gs^Fds, Gs^Fds, Gs^Fds, Re, Gg, Gg, Gg, Gg, Gg, Gg, Gs, Re, Re, Re, Re, Re, Re, Rp, Rp, Gg, Re, Re^Gvs, Re^Gvs, Re^Gvs, Re^Gvs, Re^Gvs, Re, Re, Gg, Gg, Gg, Gg, Gg, Gg, Gs, Ww, Ww, Gs, Gg, Gg, Gg
Ww, Ww, Hh^Fds, Hh^Fds, Gs^Fds, Gs^Fds, Gs^Fds, Gs^Fds, Gs^Fds, Gs^Fds, Gs^Fds, Gg^Em, Gg, Gg, Gs, Gg^Em, Gg, Re, Rb^Vh, Re, Gs, Gg, Re, Gg, Re, Re, Re^Gvs, Re^Gvs, Re^Gvs, Re, Gs, Gs, Rp, Gg, Gg, Re, Re^Gvs, Re^Gvs, Re^Gvs, Re^Gvs, Re^Gvs, Re^Gvs, Re^Gvs, Re, Gs, Gg, Gg, Gg, Gg, Gg, Gs, Ww^Es, Ww, Ww, Ww, Gg
Ww, Hh^Fds, Gs^Fds, Hh^Fds, Gs^Fds, Gs^Fds, Gg, Gg, Gg, Gg, Gg, Gg, Gg, Gs^Vh, Gs, Gs, Gs, Re, Re, Re, Re, Re, Re^Gvs, Re, Re^Gvs, Re^Gvs, Re^Gvs, Re^Gvs, Re^Gvs, Re, Re, Gs, Rp, Gs, Re, Re, Re^Gvs, Re^Gvs, Re^Gvs, Re^Gvs, Re^Gvs, Re^Gvs, Re^Gvs, Re^Gvs, Re, Gg, Rb, Rb^Vh, Rb, Gs, Gg, Gg, Ww, Ww, Ww, Gg
Hh^Fds, Hh^Fds, Gs^Fds, Gs^Fds, Gg, Gg, Gg, Gg, Gg, Gg, Gg, Gg, Gg, Gg, Gs, Gs, Re, Re, Re^Gvs, Re^Gvs, Re, Re^Gvs, Re^Gvs, Re^Gvs, Re^Gvs, Re^Gvs, Re^Gvs, Re^Gvs, Re^Gvs, Re, Re, Rb^Vh, Rp, Gs, Re, Re^Gvs, Re^Gvs, Re^Gvs, Re^Gvs, Re^Gvs, Re^Gvs, Re^Gvs, Re, Re, Gs, Gg, Gg, Re, Ds, Ds, Gs, Gg, Gg, Gg, Gg, Gg
Gs^Fds, Gs^Fds, Gg, Gg^Em, Gg, Gg, Gg, Gg, Gg, Gg, Gg, Gg, Gg, Gg, Re, Re, Re^Gvs, Re^Gvs, Re^Gvs, Re^Gvs, Re^Gvs, Re, Re^Gvs, Re^Gvs, Re^Gvs, Re^Gvs, Re^Gvs, Re^Gvs, Re^Gvs, Re, Gs, Gs, Rp, Gs, Re, Re^Gvs, Re^Gvs, Re^Gvs, Re^Gvs, Re^Gvs, Re^Gvs, Re^Gvs, Re, Gg, Gg, Gg, Gg, Re, Re, Gs, Gg^Ve, Gg, Gg, Gg, Gg, Gg
Gg, Gg, Gg, Gg, Gg, Gg, Gs, Gs, Gg, Gg, Gg, Gg, Gg, Gg, Re, Re^Gvs, Re^Gvs, Re^Gvs, Re^Gvs, Re^Gvs, Re^Gvs, Re, Re, Re^Gvs, Re^Gvs, Re^Gvs, Re^Gvs, Re^Gvs, Re^Gvs, Re, Re, Gs, Rp, Gs, Gg, Re, Re, Re, Re, Re, Re, Re, Gs, Gg, Gg, Gg, Gg, Gg, Re, Gs, Gs, Gs, Gg, Gg, Gg, Gg
Gg, Gg, Gg, Gg, Gg, Gg, Gg, Gg, Gg, Gg, Gg, Gg, Gg, Gs, Re, Re^Gvs, Re^Gvs, Re^Gvs, Re^Gvs, Re^Gvs, Re^Gvs, Re^Gvs, Re, Re, Re, Re^Gvs, Re^Gvs, Re^Gvs, Re^Gvs, Re, Re, Rb^Vh, Rp, Gg, Gg, Gs, Gg, Gg, Re, Ww, Ww, Re, Ww, Ww, Hh, Hh, Hh, Hh, Gg, Re, Gs, Gg, Gg, Gg, Gg, Gg
Gg, Gg, Gg, Gg^Efm, Gg, Gg, Gg, Gg, Gg, Gg, Gg, Gg, Gg, Gg, Re, Re^Gvs, Re^Gvs, Re^Gvs, Re^Gvs, Re^Gvs, Re^Gvs, Re^Gvs, Re, Re^Gvs, Re, Re, Re^Gvs, Re^Gvs, Re^Gvs, Re, Gs, Gg, Rp, Gg, Gg, Gg, Gs, Gg, Gs, Re^Vh, Re, Re, Re^Vh, Ww, Ww, Hh, Hh^Fp, Hh, Gg, Re, Gg^Ve, Gg, Gg, Gg, Gg, Gg
Gs, Gg, Gg, Gg, Gg, Gg, Gg, Gg, Gg, Gg, Gg, Gg, Gg, Gs, Gg, Re, Re, Re^Gvs, Re, Re, Re, Re, Re^Gvs, Re^Gvs, Re^Gvs, Re, Re, Re^Gvs, Re, Re, Gs, Re, Rp, Gg, Gg^Es, Gg, Gg, Gg, Ww, Re, Ch, Ch, Ch, Re, Ww, Gg, Hh, Gg, Re, Re, Gs, Gs, Gg, Gg, Gg, Gg
Gs, Gg, Gg, Gg, Gs, Gs, Gs, Gg, Gg, Gg, Gs, Gg, Gg, Gg, Gg^Efm, Gg, Gs, Re, Re, Re^Gvs, Re^Gvs, Re^Gvs, Re^Gvs, Re^Gvs, Re^Gvs, Re^Gvs, Re^Gvs, Re, Re, Gs, Re, Rb^Vh, Rp, Gg, Gg, Gg, Gg, Gg, Gg, Ww, Ch, Ch, Ch, Ch, Re, Gg, Gg, Re, Gg^Vh, Gs, Gg, Gg, Gs^Fds, Gg, Gg, Gg
Gs, Gs, Gs, Gg, Gs, Ce, Ce, Gs, Gs, Gg, Gg, Gg, Gg, Gg, Gg, Gg, Gg, Gs, Re, Re^Gvs, Re^Gvs, Re^Gvs, Re^Gvs, Re^Gvs, Re^Gvs, Re^Gvs, Re^Gvs, Re^Gvs, Re, Gg, Gg, Re, Gg, Rp, Gg, Gg, Gg, Gs, Ww, Ww, Ch, Ch, Kh, Ch, Re, Re, Re, Re, Rb, Rb, Gg^Em, Gs^Fds, Gs^Fds, Gg, Gg, Gg
Gg, Gs, Gs, Gg, Re, Ke, Ce, Ce, Re, Gg, Gg, Gg, Gg, Gg, Gg, Gg, Gg, Gg, Gg, Re, Re, Re^Gvs, Re, Re^Gvs, Re, Re, Re, Re, Gg, Gg, Gg^Efm, Gg, Gg, Rp, Rp, Gg, Gg, Ww, Gg, Gg, Ch, Ch, Ch, Ww, Ww, Rb^Wm, Re, Gg, Gg^Efm, Gg, Gs^Em, Gs^Fds, Gs^Fds, Gg, Gg, Gg
Gg, Gg, Gs, Gg, Re, Ce, Rb, Ce, Rb, Re, Re, Gg, Gg, Gg, Gg, Gg, Gg, Gg, Gg, Gg, Gg, Re, Gs, Re, Gs, Gs, Gg, Gg, Gg, Gg, Gg, Gg, Gg, Gs, Gg, Rp, Gg, Ww, Gs, Gd, Re, Gd, Gs, Ww, Re, Re, Gg, Gg, Gg, Gs, Gd^Fdf, Gs^Fds, Gs^Fds, Gg, Gg, Gg
Gg, Gg, Gs, Gg, Re, Rb, Rb, Rb, Rb, Rb, Ce, Gd, Gd, Gg, Gg, Gg, Gg, Gg, Gg, Gg, Gd, Gs, Gs, Gd, Gd, Gs, Gd, Gg, Gg, Gg, Gs, Gg, Gg, Gg, Gg, Rp, Rp, Gs, Re, Re, Rp^Vhc, Re, Re, Wwf, Gg, Gg, Gg, Gg, Gg, Gs, Gg, Gs, Gg, Gg, Gg, Gg
Gs, Gg, Gg, Gg, Re, Ce, Ce, Ce, Rb, Ce, Rb, Ce, Re, Gg, Gg, Gg, Gg, Gg, Gg, Gg, Gg, Gs, Rb, Re, Rb, Gs, Gs, Gg, Gg, Gg, Gg, Gg, Gg, Gg, Re, Re, Re, Rp, Rrc, Rp, Rrc, Rrc, Rp^Vhc, Ww, Gg, Gg, Gg, Gg, Gg, Gg, Gg, Gg, Gg, Gg, Gg, Gg
Gs, Gs, Gg, Gg, Gg, Ke, Ce, Ce, Rb, Rb, Ce, Rb, Re, Gg, Gg, Gg, Gg, Gg^Efm, Gg, Gg, Gg^Es, Re, Rb^Vh, Rb, Rb^Vh, Re, Rb, Gg, Gg, Gg^Efm, Gg, Gg, Gs, Gs, Re, Rp^Vhc, Rp, Rp^Vhc, Rp^Vhc, Rrc, Rp^Vhc, Rp, Ww, Ww, Gg, Gg, Gg, Gg, Gg, Gg, Gg, Gg, Gg, Gg^Vh, Gg, Gg
Gg, Gs, Gg, Gg, Gg, Ce, Rb, Rb, Rb, Ce, Ke, Re, Gd, Gg, Gg, Gg, Gg, Gg, Gg, Gg, Gs, Rb, Re, Re, Re, Rb^Vh, Rb, Gg, Gg, Gg, Gg, Gg, Re, Re, Rp, Rp, Rrc, Rrc, Rrc, Rrc, Ds, Re, Ww, Ww, Ww^Es, Gg, Gg^Efm, Gg, Gg, Gs, Gg, Gg, Gg, Gg, Gg, Gg
Gg, Gg, Gg, Gg, Gg, Re, Rb, Rb, Rb, Ce, Ce, Ce, Gd, Gg, Gg, Gg, Gg, Gg, Gg, Gg, Re, Re, Re^Gvs, Re, Re, Re, Re, Gs, Gg, Gg, Gs, Gs, Re, Rp^Vhc, Rp, Rp^Vhc, Rrc, Rp^Vhc, Rp, Rp, Ww, Ww, Ww^Es, Ww, Gg, Gg, Gg, Gg, Gg, Gg, Gg, Gg^Es, Gg, Gg, Gg, Gg
Gs, Gg, Gg, Gg, Gg, Re, Re, Rb, Rb, Ce, Rb, Re, Gd, Gg, Gg, Gg, Gg, Gg, Gg, Re, Re^Gvs, Re^Gvs, Re^Gvs, Re^Gvs, Re^Gvs, Re^Gvs, Re^Gvs, Re, Re, Gg, Gs, Gs, Rb, Rb, Rrc, Rrc, Rp, Rp, Re, Ds, Ww, Ww^Es, Ww^Es, Ww, Gg, Gg, Gg, Gg, Gg, Gg, Gg, Gg, Gg, Gg, Gg, Gg
Gg, Gs, Gg, Gg, Gg, Gg, Gg, Re, Rb, Rb, Ce, Re, Re, Gs, Gg, Gg, Gg, Gg, Gs, Re, Re^Gvs, Re^Gvs, Re^Gvs, Re^Gvs, Re^Gvs, Re^Gvs, Re^Gvs, Re, Re^Gvs, Re, Re, Rb^Vh, Rb, Rr, Rb, Rp^Vhc, Rp, Rp^Vhc, Re, Ds, Ww, Ds, Gs, Ww, Gg, Gg, Gg, Gg, Gg, Gg, Gg, Gg, Gg, Gg, Gg, Gg
Gg, Gs, Gs, Gg, Gg, Gg, Gg, Re, Rb, Ce, Rb, Ce, Re, Gs, Gg, Gg, Gg, Gg, Re, Re, Re, Re, Re, Re^Gvs, Re, Re^Gvs, Re^Gvs, Re^Gvs, Re^Gvs, Re^Gvs, Re, Gs, Rp, Rp, Rb, Rb, Gs, Re, Gg, Gg, Ds, Ds, Gs, Ww, Gg, Gg^Es, Gg, Gg, Aa, Aa, Gg^Vh, Gg, Gg, Gg, Gg, Gg
Re, Gs, Gs, Gg, Gg, Gg, Re, Re, Rb, Rb, Ce, Rb, Re, Gg, Gg, Gg, Gg, Gg, Re, Re^Gvs, Re^Gvs, Re^Gvs, Re^Gvs, Re, Re^Gvs, Re, Re, Re^Gvs, Re, Re, Re, Re, Gs, Rb, Gd, Rb^Vh, Rb, Gg, Gg, Gg, Ww, Gs^Vh, Ww, Wwf, Gg, Gg, Gg, Gg, Gg, Gg, Gg, Gg, Gg, Gg, Gg, Gg
Rb, Ce, Ce, Gs, Gg, Gg, Re, Rb, Rb, Ce, Ce, Ce, Re, Gg, Gg, Gg, Gg, Gg, Gs, Re, Re^Gvs, Re^Gvs, Re^Gvs, Re^Gvs, Re^Gvs, Re^Gvs, Re^Gvs, Re, Re^Gvs, Re, Gg, Gs, Gg, Rb^Vh, Rb, Rb, Gg, Gg, Gg, Ds, Gg, Gg^Vh, Ww, Gg, Gg, Gg, Gg, Gs, Gg, Gg, Gg, Gg, Gg, Gg, Gg, Gg
Rb, Ke, Ce, Ce, Gg, Gg, Re, Rb, Rb, Ke, Ce, Re, Gg, Gg, Gg, Gg, Gg, Gg^Efm, Gg, Re, Re, Re^Gvs, Re^Gvs, Re^Gvs, Re^Gvs, Re^Gvs, Re^Gvs, Re^Gvs, Re, Re, Gg, Gg, Gg, Rb, Gg^Efm, Gg, Gg, Gg, Gg, Ds, Gg, Gg, Wwf, Gg, Gg, Re, Gg, Gg, Gg, Gg, Rp, Gg^Vh, Gg, Gg, Gg, Gg
Rb, Ce, Rb, Ce, Gs, Gg, Re, Re, Rb, Ce, Aa, Aa, Rb, Gg, Gg, Gg, Gg, Gg, Gg, Gs, Re, Re^Gvs, Re^Gvs, Re^Gvs, Re^Gvs, Re^Gvs, Re^Gvs, Re^Gvs, Re, Gs, Gg, Gg, Gg, Gg, Gg, Gg, Gg, Gg, Gg, Rr, Rr, Rr, Wwf, Rr, Rr, Rp, Rr, Rr, Rr, Rr, Rp, Rr, Rr, Rr, Rr, Gg
Rb, Rb, Rb, Re, Re, Re, Gg, Re, Ai, Ai, Ai, Aa^Vha, Rb, Gg, Gs, Gg, Gg, Gg, Gs, Gg, Gg, Re, Re, Re, Re, Re^Gvs, Re, Re, Gg, Rb^Vh, Rb, Gg, Gg, Gg, Gg, Gg, Gg, Gg, Rr, Rp, Gg, Gg, Ww, Gg, Gg, Gg, Gg, Gg, Gg, Gg, Re, Gg, Gg, Gg^Vh, Gg, Gg
Rb, Rb, Rb, Re, Gs, Gg, Gg, Gg, Ww, Ww, Ww, Rb, Gg, Gg, Gg, Gg, Gg, Gg, Gg, Gg, Gg, Gg, Re, Gs, Re, Re, Gg, Gg, Gg^Es, Rb, Gg, Gg, Gg, Gg, Gg, Gg, Gg, Rp, Rr, Gg, Gg, Gg, Ww, Ww, Ww, Ww, Ww, Ww, Gg, Gg, Gg, Gg, Gg, Gs^Fds, Gs^Fds, Gg
Rb, Ce, Ce, Ce, Gg, Gg, Gg, Gg, Ww, Ww, Aa, Gg, Gg, Gg, Rb^Vh, Gg, Gg, Gg, Gg, Gg, Gg, Gg, Re, Rb^Vh, Gs, Gg, Gg, Gg, Gg, Gg, Gg, Gg, Gg, Gg, Gg, Gg, Rr, Rp, Gg, Gg, Gg, Ww, Ww, Ww, Wwr, Ww, Ww, Ww, Ww, Gg, Gg, Gg, Gs^Fds, Gs^Fds, Gs^Fds, Gg
Rb, Ke, Ce, Ce, Gs, Gg, Gg, Gg, Ww, Ww, Ww, Gg, Gg, Gg, Gg, Gg, Gg, Gg, Rb, Gg, Gg, Gg, Gg, Re, Gg, Ww, Gg, Gg, Gg, Gg, Gg, Gg, Gg, Gg, Gg, Rr, Rp, Gg, Gg, Gg, Gg, Ww^Es, Ww, Ww, Ww, Ww, Gg, Ww, Ww, Gg, Gg, Gg^Em, Gs^Fms, Gs^Fds, Gs^Fds, Gg
Re, Ce, Re, Re, Re, Gs, Gs, Gg, Ww, Ww, Ww, Gg, Gg, Gg, Gs, Gg, Gg, Rb, Rb^Vh, Rb, Gg, Gg, Gg, Ww, Ww, Ww, Ww, Gg, Gg, Gg, Gg, Gg, Gg, Rp, Rr, Rp, Gg, Gg, Gg, Gg, Gg, Ww, Ww, Ww, Ww, Ww, Gg, Ww, Ww, Gg, Re, Gs^Fms, Gs^Fms, Gs^Fms, Gs^Fms, Gg
Gg, Re, Re, Re^Gvs, Re^Gvs, Re^Gvs, Re, Gs, Gg, Gg, Ww, Gg, Rb, Gg, Gg, Gg, Ce, Ce, Ce, Rb, Gg, Ww, Wwf, Ww, Rb, Gg, Ww, Ww, Ww, Ww, Gg, Gg, Rp, Rr, Gg, Gg, Gg, Gg, Gg^Es, Gg, Gg, Gg, Wwf, Ww, Ww, Ww, Gg, Ww, Gg, Re^Vh, Re, Re^Vh, Gd^Fmf, Gs^Fms, Gs^Fms, Gg
Gg, Re, Re^Gvs, Re^Gvs, Re^Gvs, Re^Gvs, Re^Gvs, Re, Gs, Gg, Ww, Ww, Rb^Vh, Aa, Gg, Gg, Gg, Gg, Gg, Ww, Ww, Ww, Ww, Rb^Vh, Rb, Gg, Rb, Gg, Ww, Ww^Es, Gg, Gg, Rr, Gg, Gg, Gg, Gg, Gg, Gg, Gg, Gg^Efm, Gg, Wwf, Ww, Ww, Gg, Gg, Ww, Gg, Gg, Re, Re^Vh, Gd^Fmf, Gd^Fmf, Hhd^Fmf, Gg
Gg, Gs, Re^Gvs, Re^Gvs, Re^Gvs, Re^Gvs, Re^Gvs, Re, Gs, Gg, Gg, Ww, Aa^Vha, Aa, Aa, Gg, Gg, Gg, Gg, Ww, Gg, Gg, Gg, Rb, Gg^Efm, Rb, Rb, Rb^Vh, Gg, Ww, Gg, Gg, Rr, Gg, Gg, Gg, Gg, Gg, Gg, Gg, Gg, Gg, Gg, Ww, Ww, Ww, Gg, Ww, Gg, Gg, Gg^Em, Gd^Fmf, Gd^Fmf, Gd^Vh, Hhd^Fmf, Gg
Gg, Gs, Re, Re^Gvs, Re^Gvs, Re^Gvs, Re, Re, Gg, Gg, Gg, Ww, Wwf, Gs, Gg, Gg, Gg, Gg, Wwf, Ww, Gg, Gg, Gg, Gg, Gg, Gg, Gg, Rb^Vh, Gg, Ww, Gg, Rp, Rr, Gg, Gg, Gg, Gg, Ww, Gg, Ww, Gg, Ww, Ww, Ww, Gg, Ww, Ww, Ww, Gg, Gg, Gs^Fp, Gs^Fp, Hhd^Fmf, Gs^Fp, Gs^Fp, Gg
Gg, Gg, Gs, Re^Gvs, Re^Gvs, Re^Gvs, Re, Gs, Gg, Gg, Gg, Gg, Ww, Gg, Gg, Ww, Wwf, Ww, Ww, Gg, Gg, Ai, Ai, Ai, Ai, Gg, Gg, Gg, Gg, Ww, Gg, Rr, Gg, Gg, Gg, Ww, Ww, Wwf, Ww, Ww, Ww, Wwf, Ww, Gg, Gg, Gg, Ww, Ww, Gg, Gd^Fmf, Gs^Fp, Hhd^Fmf, Hh^Fp, Gs^Fp, Gs^Fp, Gg
Gg, Gg, Gg, Re, Gs, Re, Gg, Gg, Gg, Gg, Gg, Gg, Ww, Ww, Ww, Ww, Ww, Gg, Gg, Ai, Ai, Ai, Ai, Ai, Ai, Ai, Gg, Gg, Gg, Ww, Ww, Rr, Wwf, Wwf, Ai, Ww, Ww, Gg, Gg^Efm, Gg, Gg, Gg, Gg, Gg^Efm, Gg, Gg, Ww, Ww, Gg, Gg^Em, Gs^Fp, Hh^Fp, Gs^Fp, Gs^Fp, Gs^Fp, Gg
Gg, Gg, Gg, Gg, Gg, Gg, Gg, Gg, Gg, Gg, Gg, Gg, Ww, Ww^Es, Ww, Ww, Ww, Gg, Gg, Ai, Ai, Ai, Ai, Ai, Ai, Ai, Gg, Gg, Gg, Ww, Ww, Rr, Wwf, Wwf, Ai, Ai, Ww, Gg, Gg, Gg, Gg, Gg, Gg, Gg, Gg, Gg, Ww, Ww, Gg, Gg, Gs^Fp, Gs^Fp, Gs^Fp, Gs^Fp, Gs^Fp, Gg
Gg, Gg, Gg, Gg, Gg, Gg, Gg, Gg, Gg, Gg, Gg, Gg, Gg, Gg, Gg, Gg, Gg, Gg, Gg, Gg, Gg, Gg, Gg, Gg, Gg, Gg, Gg, Gg, Gg, Gg, Gg, Gg, Gg, Gg, Gg, Gg, Gg, Gg, Gg, Gg, Gg, Gg, Gg, Gg, Gg, Gg, Gg, Gg, Gg, Gg, Gg, Gg, Gg, Gg, Gg, Gg
Gg, Gg, Gg, Gg, Gg, Gg, Gg, Gg, Gg, Gg, Gg, Gg, Gg, Gg, Gg, Gg, Gg, Gg, Gg, Gg, Gg, Gg, Gg, Gg, Gg, Gg, Gg, Gg, Gg, Gg, Gg, Gg, Gg, Gg, Gg, Gg, Gg, Gg, Gg, Gg, Gg, Gg, Gg, Gg, Gg, Gg, Gg, Gg, Gg, Gg, Gg, Gg, Gg, Gg, Gg, Gg
