Gg, Gg, Gg, Gg, Gg, Gg, Gg, Gg, Gg, Gg, Gg, Gg, Gs^Fdf, Gs^Fdf, Gs^Fdf, Gs^Fdf, Gs^Fdf, Gs^Fdf, Gg, Ww, Ww, Ww, Ww, Ww, Gs^Fdf, Gs^Fdf, Gg, Gg, Gg, Gg, Gg, Gg, Hh, Hh, Mm, Mm, Mm, Mm, Mm, Mm
Gg, Gg, Gg, Gg, Gg, Gg, Gg, Gg, Gg, Gg, Gg, Gg, Gs^Fdf, Gs^Fdf, Gs^Fdf, Gs^Fdf, Gs^Fdf, Gs^Fdf, Gg, Ww, Ww, Ww, Ww, Ww, Gs^Fdf, Gs^Fdf, Gg, Gg, Gg, Gg, Gg, Gg, Hh, Hh, Mm, Mm, Mm, Mm, Mm, Mm
Gg, Gg, Gg, Gg, Gg, Gg, Gg, Gg, Ce, Ce, Ce, Gg, Gs^Fdf, Gs^Fdf, Gs^Fdf, Gs^Fdf, Gs^Fdf, Gs^Fdf, Gs^Fdf, Gg, Ww, Ww, Ww, Gs^Fdf, Gs^Fdf, Gs^Fdf, Gg, Gg, Ce, Ce, Gg, Gg, Gg, Hh, Hh, Mm, Hh, Mm, Hh, Hh
Gg, Gg, Gg, Gg, Gg, Gg, Gg, Gg, Gg, Gg^Vc, Gg, Ce, Gg, Gs^Fdf, Gs^Fdf, Gs^Fdf, Gs^Fdf, Gs^Fdf, Gg, Gg, Gg, Ww, Ww, Gs^Fdf, Gg, Gg^Vc, Gg, Ce, Gg, Gg^Vc, Gs^Fdf, Gg, Gg, Gg, Hh, Hh, Hh, Hh^Vhh, Hh, Hh
Rr, Rr, Rr, Rr, Rr, Gg, Ce, Ce, Ce, Gg, Gg^Vc, Ce, Gg, Gs^Fdf, Gs^Fdf, Gs^Fdf, Gg, Gs^Fdf, Gs^Fdf, Gg, Gg, Wwf, Wwf, Gg, Gg, Gg, Gg, Ce, Gg^Vc, Gs^Fdf, Ce, Ce, Ce, Gg, Hh^Vhh, Hh, Hh, Hh, Mm, Mm
Gg, Gg, Gg^Vc, Ce, Gg, Rr, Ce, 6 Ke, Ce, Gg, Ce, Ce, Gg, Gg, Gg, Gg, Gg, Gg, Gg, Gg, Re^Gvs, Wwf, Wwf, Gg, Gg, Gs^Fdf, Gs^Fdf, Ce, Gs^Fdf, Gs^Fdf, Ce, 5 Ke, Ce, Gg, Gg, Gg, Hh, Hh, Mm, Mm
Gg, Gg, Gg, Ce, Gg, Rr, Rr, Ce, Gg, Gg, Gs^Fdf, Gg, Gs^Fdf, Gg, Gg, Gg, Re^Gvs, Re^Gvs, Re^Gvs, Re^Gvs, Re^Gvs, Ww, Ww, Gg, Gg, Gs^Fdf, Gs^Fdf, Ce, Gs^Fdf, Re, Gg, Ce, Hh, Gg, Hh, Gg, Hh, Mm, Mm, Mm
Gg, Gg, Gg, Ce, Ce, Gg^Vc, Rr, Gg, Gg, Gg, Gg, Gs^Fdf, Gs^Fdf, Gs^Fdf, Gs^Fdf, Gs^Fdf, Gg, Re^Gvs, Re^Gvs, Re^Gvs, Gg, Ww, Ww, Gg, Gg, Gg, Gg, Gs^Fdf, Re, Re, Ce, Gg, Hh, Hh^Vhh, Ce, Ce, Hh, Hh, Hh, Hh
Gg, Gg, Gg, Gg, Gg, Ce, Rr, Re^Gvs, Re^Gvs, Re^Gvs, Gg, Gg, Gg, Gg, Gg, Gg, Re^Gvs, Gg, Gg, Gg, Re^Gvs, Ww, Re^Gvs, Re^Gvs, Re^Gvs, Gg, Gg, Gg, Re, Gg, Gg, Ce, Ce, Ce, Hh, Hh, Hh, Hh, Hh, Hh
Gs^Fdf, Gs^Fdf, Gs^Fdf, Gg, Gg, Gg, Re^Gvs, Rr, Re^Gvs, Re^Gvs, Rr, Re^Gvs, Re^Gvs, Re^Gvs, Gg, Gg, Re^Gvs, Re^Gvs, Re^Gvs, Re^Gvs, Re^Gvs, Ww, Ww, Re^Gvs, Re^Gvs, Re^Gvs, Re^Gvs, Re^Gvs, Re, Gg, Hh^Vhh, Hh, Hh, Hh, Gg, Hh, Gg, Hh, Hh, Hh
Gs^Fdf, Gs^Fdf, Gg, Gg, Re^Gvs, Gg, Gg, Rr, Rr, Rr, Gs^Fdf, Rr, Gg^Vo, Re^Gvs, Rr, Gg, Rr, Re^Gvs, Re^Gvs, Re^Gvs, Ww, Ww, Ss, Ww, Re^Gvs, Re^Gvs, Re, Re, Re^Gvs, Hh, Hh, Hh, Gg, Gg, Re^Gvs, Gg, Hh, Gg, Hh, Hh
Gs^Fdf, Gs^Fdf, Gs^Fdf, Gg, Re^Gvs, Re^Gvs, Re^Gvs, Gg, Gs^Fdf, Gs^Fdf, Gs^Fdf, Rr, Rr, Rr, Gg, Rr, Gg, Rr, Rr, Ww, Ss, Ss, Co, Ww, Wwf, Re, Re^Gvs, Re^Gvs, Re^Gvs, Hh, Gg, Hh, Gg, Gg, Re^Gvs, Hh, Hh, Hh, Hh, Hh
Gs^Fdf, Gs^Fdf, Gg^Vc, Re^Gvs, Re, Re^Gvs, Re^Gvs, Gg, Re, Gs^Fdf, Gg, Re^Gvs, Re^Gvs, Re^Gvs, Gg, Gg, Re^Gvs, Re^Gvs, Re^Gvs, Ww^Bw\, Re, Co, Co, Co, Wwf, Re^Gvs, Re^Gvs, Re^Gvs, Gg, Gg, Gg, Gg, Re^Gvs, Re^Gvs, Re^Gvs, Hh, Hh, Hh, Hh, Hh
Re, Re, Re, Re, Re, Re, Re, Re, Re^Gvs, Re, Re, Gg, Gg, Gg, Re^Gvs, Re^Gvs, Re^Gvs, Re^Gvs, Ww, Ww, Gg^Vo, Co, Hh, Co, Ww, Re^Gvs, Re^Gvs, Re^Gvs, Re^Gvs, Re^Gvs, Re^Gvs, Re^Gvs, Re^Gvs, Re^Gvs, Re, Hh, Hh^Vhh, Hh, Hh, Hh
Re, Re, Re, Re, Re^Gvs, Re^Gvs, Gs^Fdf, Re^Gvs, Ce, Ce, Ce, Re, Re, Re^Gvs, Re^Gvs, Re^Gvs, Ww, Ww, Co, Co, Co, Co, Gg^Vo, 2 Ko, Co, Ww, Ww, Gg^Vo, Ww, Re^Gvs, Re^Gvs, Re^Gvs, Re, Re, Re^Gvs, Re^Gvs, Re^Gvs, Gg, Hh, Hh
Gs^Fdf, Gs^Fdf, Gs^Fdf, Re^Gvs, Gg, Gg, Gs^Fdf, Ce, Re, Re, Re, Gg^Vo, Re^Gvs, Re, Re, Wwf, Wwf, Re, Co, Co, Co, Gg^Vo, Gg^Vo, Hh, Co, Co, Gg^Vo, Ww, Re^Gvs, Ww, Ww, Re^Gvs, Wwf, Re^Gvs, Re^Gvs, Re^Gvs, Gg, Gg, Hh, Hh
Gs^Fdf, Gs^Fdf, Gs^Fdf, Gs^Fdf, Gg, Gg, Re, Ce, Gg, Gg, Ce, Gs^Fdf, Gs^Fdf, Re^Gvs, Re, Wwf, Ww, Hh, Hh, Ko, Co, Hh, Co, Co, Co, Co, Hh, Re^Gvs, Re^Gvs, Re^Gvs, Re, Wwf, Re, Ww, Ww, Gg, Hh, Hh, Wo, Wo
Gs^Fdf, Gs^Fdf, Gg, Gg^Vc, Re, Re, Gg, Gg, Gs^Fdf, Ce, Ce, Gs^Fdf, Gs^Fdf, Re^Gvs, Re, Ww, Ww, Ss, Hh, Gg^Vo, Hh, Co, Gg^Vo, Co, Re, Hh, Hh, Re^Gvs, Re, Re, Re^Gvs, Gg^Vo, Re^Gvs, Re^Gvs, Re^Gvs, Ww, Wo, Wo, Gg, Gg
Gs^Fdf, Gs^Fdf, Gg, Re, Gg, Gg, Gs^Fdf, Gs^Fdf, Gs^Fdf, 3 Ke, Ce, Ce, Gg, Re^Gvs, Re, Ss, Ww, Ss, Ss, Re^Gvs, Re^Gvs, Re^Gvs, Re^Gvs, Re^Gvs, Re^Gvs, Re, Re, Re, Re^Gvs, Re^Gvs, Re^Gvs, Re^Gvs, Re, Re^Gvs, Re^Gvs, Re^Gvs, Re, Gg, Hh, Gg
Gg, Gg, Gg, Re, Gg, Gs^Fdf, Gs^Fdf, Gs^Fdf, Gg, Gs^Fdf, Gs^Fdf, Gg, Re, Ce, Ww, Ww, Gs^Fdf, Ww, Ss, Re^Gvs, Gs^Fdf, Re^Gvs, Gg^Vo, Re^Gvs, Re^Gvs, Re^Gvs, Re^Gvs, Re, Re, Re^Gvs, Re, Re, Re^Gvs, Re, Re, Re, Hh, Hh, Hh, Hh
Gs^Fdf, Gs^Fdf, Gg, Re, Re, Gg, Gg, Gg^Vo, Gg, Gg, Ce, Gg, Ce, Ce, Ww, Gs^Fdf, Gs^Fdf, Ww, Ss, Gg, Gs^Fdf, Re^Gvs, Gs^Fdf, Re^Gvs, Gg, Re^Gvs, Re^Gvs, Re^Gvs, Re, Re, Re^Gvs, Re^Gvs, Re^Gvs, Gg^Vo, Re^Gvs, Re^Gvs, Hh, Hh, Hh, Hh
Gs^Fdf, Gs^Fdf, Gg^Vc, Gs^Fdf, Re, Gg, Gs^Fdf, Gg, Gs^Fdf, Gs^Fdf, Gs^Fdf, Ce, Re, Gg, Ww, Gs^Fdf, Gs^Fdf, Ww, Ww, Gg, Gg, Gs^Fdf, Gs^Fdf, Gg, Gg, Gg, Re^Gvs, Re^Gvs, Re, Re^Gvs, Re^Gvs, Re^Gvs, Re^Gvs, Re^Gvs, Gg, Re^Gvs, Hh, Hh, Hh, Hh
Gs^Fdf, Gs^Fdf, Gs^Fdf, Gs^Fdf, Re, Gs^Fdf, Gs^Fdf, Gs^Fdf, Gg, Gs^Fdf, Gs^Fdf, Gg^Vo, Re, Gg, Ww, Gs^Fdf, Gs^Fdf, Gs^Fdf, Ww, Gg, Gg, Gs^Fdf, Gg, Gg, Gg, Gg, Re^Gvs, Re^Gvs, Re, Re^Gvs, Re^Gvs, Re^Gvs, Re^Gvs, Re^Gvs, Re^Gvs, Gg, Hh, Hh, Hh, Hh
Gs^Fdf, Gs^Fdf, Gs^Fdf, Gs^Fdf, Re, Gs^Fdf, Gs^Fdf, Gg^Vc, Gs^Fdf, Gg, Re, Re, Gg, Ww^Bw\, Gg, Gg, Gs^Fdf, Gs^Fdf, Ww, Gg, Gg, Gg, Gg, Gg, Gg^Vo, Re^Gvs, Re^Gvs, Re^Gvs, Re, Re, Re, Re, Re, Re^Gvs, Re^Gvs, Re^Gvs, Hh, Hh, Hh, Hh
Gs^Fdf, Gs^Fdf, Gs^Fdf, Re, Gs^Fdf, Gs^Fdf, Gs^Fdf, Gs^Fdf, Gg, Re, Gg, Gg, Ww, Ww, Gg, Gg, Gg, Gs^Fdf, Gg, Gg, Gg, Gg, Gs^Fdf, Gs^Fdf, Re^Gvs, Re^Gvs, Re, Re, Re^Gvs, Re^Gvs, Re^Gvs, Re^Gvs, Re^Gvs, Re, Hh, Hh, Hh, Hh, Mm, Mm
Gs^Fdf, Gs^Fdf, Gs^Fdf, Re, Gs^Fdf, Gs^Fdf, Gs^Fdf, Gs^Fdf, Gs^Fdf, Re, Gg, Ww, Ww, Gg, Gg, Gg, Gg, Gg, Gg, Gg, Gs^Fdf, Gs^Fdf, Gg, Gs^Fdf, Re^Gvs, Re^Gvs, Re, Re^Gvs, Re^Gvs, Re^Gvs, Re^Gvs, Re^Gvs, Re^Gvs, Hh, Hh, Hh, Mm, Hh^Vhh, Mm, Mm
Gs^Fdf, Gs^Fdf, Gs^Fdf, Re, Re, Gs^Fdf, Gs^Fdf, Gs^Fdf, Gs^Fdf, Re, Gg, Ww, Gg, Gg, Gg, Gg, Gg, Gg^Vo, Gg, Gg, Gs^Fdf, Gs^Fdf, Gg, Gg, Ce, Re, Re, Re^Gvs, Ce, Gg, Gg, Gg, Gg, Hh, Hh, Mm, Mm, Mm, Mm, Mm
Gs^Fdf, Gs^Fdf, Gs^Fdf, Gs^Fdf, Gs^Fdf, Re, Re, Re, Re, Re, Gg, Ww, Gg, Gs^Fdf, Gs^Fdf, Gg, Gg, Gg, Gg, Gg, Gg, Gg, Ce, Ce, Gg, Ce, Re, Ce, Hh^Vhh, Ce, Ce, Gg, Hh, Hh, Hh, Hh, Hh, Mm, Mm, Mm
Gs^Fdf, Gs^Fdf, Gs^Fdf, Gs^Fdf, Gs^Fdf, Gs^Fdf, Gs^Fdf, Gg, Gg, Gg, Gg, Ww, Ww, Gs^Fdf, Gs^Fdf, Gs^Fdf, Gs^Fdf, Gg, Gg, Gg, Gg, Gg, Ce, Gg, Re, Re, Ce, Gg, Hh, Hh, Ce, Hh, Hh, Hh, Hh, Hh^Vhh, Hh, Hh, Mm, Mm
Gs^Fdf, Gs^Fdf, Gs^Fdf, 1 Gs^Fdf, Gs^Fdf, Gs^Fdf, Gg^Vc, Gs^Fdf, Gg, Gg, Ww, Ww, Gg, Gg, Gg, Gs^Fdf, Gg, Gg, Gg, Gg, Gg, Gg, Ce, Gg^Vc, Re, Ce, 4 Ke, Ce, Gg, Hh^Vhh, Ce, Hh, Hh, Hh, Mm, Mm, Mm, Mm, Mm, Mm
Gg, Gg^Vc, Gg, Gs^Fdf, Gs^Fdf, Gs^Fdf, Gg, Gg, Gg, Gs^Fdf, Ww, Ww, Gg, Gg, Gg, Gs^Fdf, Gg, Gg, Gg, Gg, Gg, Gg, Re, Re, Gg, Ce, Ce, Ce, Hh, Hh, Hh, Hh, Mm, Mm, Mm, Mm, Mm, Mm, Mm, Mm
Gg, Gg, Gg, Gs^Fdf, Gs^Fdf, Gs^Fdf, Gg, Gg, Gg, Gs^Fdf, Ww, Ww, Gg, Gg, Gg, Gs^Fdf, Gg, Gg, Gg, Gg, Gg, Gg, Re, Re, Gg, Ce, Ce, Ce, Hh, Hh, Hh, Hh, Mm, Mm, Mm, Mm, Mm, Mm, Mm, Mm
