Mm, Md^Xm, Mm, Mm, Mm, Mm, Mm, Mm, Mm, Mm, Mm, Gd, Gd, Gd, Gd^Fds, Gd^Fds, Gd^Fds, Gd^Fds, Gd^Fds, Gd^Fds, Rr, Rr, Ds, Ds, Co, Ds, Co, Ds, Md, Md, Md, Md
Mm, Mm, Mm, Mm, Mm, Mm, Mm, Mm, Mm, Mm, Mm^Vhh, Mm, Gs, Gd, Gd^Fds, Rr^Vd, Rr^Vd, Gd^Fds, Gd^Fds, Gd^Fds, Rr, Rr, Ds, Ds, Ds, Co, Co, Ds, Hd, Md, Md, Md
Mm, Hhd, Hhd, Hhd^Fds, Hhd, Hhd^Fds, Mm, Mm, Mm, Mm, Mm, Mm, Ss, Gs, Gs^Fds, Gd^Fds, Ds, Rr, Ds, Rr, Ds, Ds, Ds, Co, Co, Co, 3 Ko, Co, Hd, Md, Md, Md
Gd^Fds, Gd^Fds, Hhd^Fds, Hhd^Fds, Hhd^Fds, Gs^Fds, Hhd^Vhh, Gd, Gd, Gs, Ss^Vm, Ss, Gs, Ss, Gs, Gd, Ds, Ds, Ds, Ds, Gd, Ds, Ds, Ds, Ds, Co, Co, Co, Hd, Hd, Hd, Hd
Gd^Fds, Gd^Fds, Gd^Fds, Hhd^Fds, Gd^Fds, Hhd, Hhd^Fds, Gd^Fds, Gd^Fds, Hh^Fds, Hh, Hh, Gd, Gs, Gd, Gd, Gs, Gd, Gs, Gd, Gd, Gd, Rr, Rr, Rr, Ds, Hd, Hd, Hd, Hd, Hd, Hd
Gd^Fds, Gd^Fds, Gd^Fds, Gd^Fds, Hhd^Fds, Gd^Fds, Gd^Fds, Gs, Gd, Gd, Gd, Gd, Re^Gvs, Re^Gvs, Re^Gvs, Re^Gvs, Re^Gvs, Re^Gvs, Re^Gvs, Re^Gvs, Re^Gvs, Gd, Gd, Rr, Rr, Rr, Hd, Hd, Hd, Hd, Hd, Hd
Gd^Fds, Gd^Em, Gd^Fds, Gd^Fds, Gd^Fds, Gd^Fds, Gd^Fds, Gd^Fds, Gd, Gs, Re^Gvs, Re^Gvs, Re^Gvs, Gs^Es, Re^Gvs, Re^Gvs, Re^Gvs, Re^Gvs, Re^Gvs, Gs^Es, Re^Gvs, Gd, Gd, Rr, Rr, Hd, Hd, Hd, Hd, Hd, Hd, Hd
Gd^Fds, Gd^Fds, Gd^Fds, Gd^Fds, Gd^Fds, Gd^Fds, Gd^Fds, Gd, Gg^Efm, Gd, Re^Gvs, Re^Gvs, Re^Gvs, Re^Gvs, Re^Gvs, Re^Gvs, Gd, Re^Gvs, Gd, Re^Gvs, Gd, Gd, Rr, Rr, Rr, Hd, Hd, Hd, Hd, Hd, Hd, Hd
Gd^Fds, Gd^Fds, Gd^Fds, Gd^Fds, Gd^Fds, Gd^Fds, Gd^Fds, Gd, Gd, Gd, Gd, Re^Gvs, Gd, Gd, Gd, Gd, Gd, Gd, Rr, Gd, Gd, Gd, Rr, Rr, Gd, Hd, Hd, Hd, Hd, Hd, Hd, Hd
Gd^Fds, Gd^Fds, Gd^Fds, Gd^Fds, Gd^Fds, Gd^Em, Gd, Gd, Gs, Gs, Gs, Gd, Rr, Rr, Rr^Vd, Rr, Rr, Rr^Vd, Ds, Rr, Rr^Vd, Rr, Ds, Rr, Gd^Efm, Gd, Gd, Gd, Hd, Hd, Hd, Hd
Gd^Fds, Gd^Fds, Hhd^Fds, Gd^Fds, Gd^Fds, Gd^Fds, Gs, Gs, Gs, Ss, Gs^Fds, Gd^Fds, Gd^Fds, Ds, Ds, Ds, Ds, Ds, Ds, Ds^Es, Ds, Ds, Ds, Rr, Gd, Gd, Gd, Hd, Hd, Hd, Hd, Hd
Gd^Fds, Gd^Fds, Gd^Fds, Gd^Fds, Gd^Fds, Gs^Fds, Ss, Ss, Gs, Ss, Ss, Gs^Fds, Gs^Fds, Ds, Rr^Vd, Ds^Es, Ds, Rr, Ds, Ds, Ds, Ds, Rr, Rr, Gd, Hd, Hd, Hd, Hd, Hd, Hd, Hd
Gs, Gd^Fds, Gd^Fds, Gd^Fds, Gd^Fds, Gs^Fds, Gs^Fds, Gs^Fds, Gs, Gs, Ss, Ss, Gs, Rp, Rp, Ds, Rr, Rr, Rr, Rr, Rr, Rr, Gd, Gd, Hd, Hd, Hd, Hd, Hd, Hd, Hd, Hd
Gg, Gs, Gs, Gs, Gd, Gs, Ss, Gs, Gs, Ss, Ss^Vhs, Ss, Ss, Ss, Rp, Rr, Gd^Fds, Rr^Vd, Rr, Rr, Rr, Rr, Rr, Hd, Hd, Hd, Hd, Hd, Hd, Md, Md, Md
Gg, Gd, Gd, Gd, Gd, Gs, Ss, Ss, Ss, Ss, Ss, Gs, Ss, Ss, Rp, Rr, Gd^Fds, Gd^Fds, Gd^Fds, Gd^Fds, Gd^Fds, Rr, Hhd^Fds, Hd, Hd, Hd, Hd, Hd, Md, Md, Md, Md
Gg, Gd, Gd, Gd, Gd, Gs, Gs, Ss, Ss, Ss, Wwg, Ss, Wwg, Rp, Rp, Rp, Rp, Gd^Fds, Gd^Fds, Gd^Fds, Rr^Vd, Gd^Fds, Gd^Fds, Gd^Fds, Hd, Hd, Hd, Hd, Md, Md, Md, Md
Gg, Gd, Gg, Gd, Gs, Gs, Gs, Gs, Gs, Gs, Rp, Rp, Rp, Rp, Ss, Ss, Gs^Fds, Gd^Fds, Gd^Fds, Gd^Fds, Rr, Rr, Gd, Gd^Fds, Gd^Fds, Gd^Fds, Gd^Fds, Hd, Md, Md, Md, Md
Gd^Fds, Gd^Fds, Gd^Fds, Gd^Fds, Gs^Fds, Wwg, Wwg, Gs, Ss, Rp, Ss, Rp^Vd, Hh, Hh, Gs, Gs, Gs, Gd, Gd, Rr, Rr, Rr, Gd, Gd, Gd, Gd^Fds, Gd^Fds, Hd, Hd, Md, Md, Md
Gd^Fds, Gd^Fds, Gd^Fds, Gd^Fds, Gd^Fds, Gs^Fds, Gs, Gs, Gs, Rp, Rp, Ss, Rp, Gd, Gs, Ss, Ss, Gs, Gs, Rr, Rr, Gd^Fds, Gd^Fds, Hhd^Fds, Hd, Hd, Hd, Hd, Hd, Md, Md, Md
Gd^Fds, Gd^Fds, Gd^Fds, 1 Gd^Fds, Gd^Fds, Gd^Fds, Gd^Fds, Gd^Fds, Gd^Fds, Gd^Fds, Rp, Rp, Rp, Rr, Rp, Rp, Ss, Ss, Rp, Rr, Rr, Gd, Gd, Gd, Hd, Hd, Hd, Hd, Hd, Hd, Hd, Hd
Gd^Fds, Gd^Fds, Gd^Fds, Gd^Fds, Gd^Fds, Gd^Fds, Gs^Fds, Gs^Fds, Rp, Rp, Ss, Ss, Ss, Rp^Vd, Ss, Rp, Rp, Ss, Rp^Vd, Rr, Rr, Hd, Hd, Hd, Hd, Hd, Hd, Hd, Hd, Hd, Hd, Hd
Gd^Fds, Gd^Fds, Gd^Fds, Gd^Fds, Gd^Fds, Gd^Fds, Rp, Ss, Rp, Ss, Rp, Ss, Ss, Rp, Gs^Fds, Rp, Ds, Rp, Ds, Rr, Ko^Vd, Hd, Hd, Hd, Hd, Hd, Hd, Hd, Hd, Hd, Hd, Hd
Gd^Fds, Gd^Fds, Gd^Fds, Gd^Fds, Gd^Fds, Gs^Fds, Ss, Rp, Rp, Rp^Vd, Rr, Rp, Gs^Fds, Gs^Fds, Gd^Fds, Rr, Ds, Ds, Ds, Rr, Ds, Rr, Rr, Rr, Rr, Hd, Hd, Hd, Hd, Hd, Hd, Hd
Gd^Fds, Gd^Fds, Gd^Fds, Gd^Fds, Rr, Rp, Rp^Vd, Ss, Rp, Rr, Rr, Ds, Ds, Gd^Fds, Rr, Rr, Ds, Rr, Ds, Ds, Rr, Rr, Rr, Ds, Rr, Rr, Rr, Hd, Hd, Hd, Hd, Hd
Gd^Fds, Gd^Fds, Gd^Fds, Gd^Fds, Gd^Fds, Gd^Fds, Gd^Fds, Gs^Fds, Gd^Fds, Gd^Fds, Ds, Ds, Ds, Ds, Ds, Rr, Rr, Rr, Rr^Vd, Ds, Ds, Co, 2 Ko, Co, Rr, Rr, Rr, Hd, Hd, Hd, Hd, Hd
Gd, Gd^Fds, Gd^Fds, Gd^Fds, Gd^Fds, Gd^Fds, Gs^Fds, Gs^Fds, Gs^Fds, Ds, Ds, Ds, Ds, Rr^Vd, Rr, Rr, Ds, Ds, Ds, Rr, Rr, Ds, Co, Ds, Rr^Vd, Rr, Rr, Hd, Hd, Hd, Hd, Hd
Re^Gvs, Gd, Gd, Gd, Re^Gvs, Gs, Ss, Wwg, Ss, Gs, Ds, Rr, Rr, Rr, Ds, Ds, Ds, Ds, Rr^Vd, Ds, Ds, Rr, Rr, Rr, Rr, Rr, Hd, Hd, Hd, Hd, Hd, Hd
Re^Gvs, Re^Gvs, Re^Gvs, Re^Gvs, Re^Gvs, Gs, Gs, Gs, Rp, Rp, Rr, Rr, Rr, Rr^Vd, Rr, Ds, Ds, Ds, Rr, Rr, Rr, Rr, Rr, Rr, Rr, Hd, Hd, Hd, Hd, Hd, Hd, Hd
Re^Gvs, Re^Gvs, Gs^Es, Re^Gvs, Gd, Gd^Fds, Gd^Fds, Gd^Fds, Rr^Vd, Gd^Fds, Gd^Fds, Gd^Fds, Gd^Fds, Rr^Vd, Gd^Fds, Gd^Fds, Gd^Fds, Gd^Fds, Gd^Fds, Gd^Fds, Rr, Rr, Rr, Rr, Rr, Hd, Hd, Rr^Vd, Hd, Hd, Hd, Hd
Re^Gvs, Re^Gvs, Re^Gvs, Re^Gvs, Re^Gvs, Gd, Gd^Fds, Rr^Vd, Gd^Fds, Gd^Fds, Rr, Rr, Rr, Gd^Fds, Rr, Rr, Rr, Ds, Rr^Vd, Ds, Gd^Fds, Gd^Fds, Rr^Vd, Gd^Fds, Gd^Fds, Gd^Fds, Gs^Fds, Ww, Ww, Ww, Ww, Ww
Re^Gvs, Re^Gvs, Re^Gvs, Re^Gvs, Gd, Gd^Fds, Gd^Fds, Gd^Fds, Gd^Fds, Gd^Fds, Gd^Fds, Gd^Fds, Gd^Fds, Gd^Fds, Gd^Fds, Gd^Fds, Gd^Fds, Gd^Fds, Gd^Fds, Gd^Fds, Gd^Fds, Gd^Fds, Gd^Fds, Gd^Fds, Gd^Fds, Gd^Fds, Gd^Fds, Gs^Fds, Ww, Wo, Wo, Wo
Re^Gvs, Re^Gvs, Re^Gvs, Re^Gvs, Gd, Hhd^Fds, Hhd^Fds, Gd^Fds, Gd^Fds, Gd^Fds, Gd^Fds, Gd^Fds, Gd^Fds, Gd^Fds, Gd^Fds, Gd^Fds, Gd^Fds, Gd^Fds, Gd^Fds, Gd^Fds, Gd^Fds, Gd^Fds, Gd^Fds, Gd^Fds, Gd^Fds, Gd^Fds, Gd^Fds, Gs^Fds, Ww, Wo, Wo, Wo
