Gd^Fdf, Gd^Fdf, Gd, Re, Gs, Gd^Fdf, Gd^Fdf, Gd^Fdf, Gd^Fdf, Gd^Fdf, Gd^Fdf, Gd^Fmf, Gd^Fdf, Gd^Fdf, Gd^Fmf, Gd^Fmf, Gd^Fp, Gd^Fp, Gd^Fp, Ww, Ww, Gd^Fp, Gd^Fp, Gs, Gd^Fp, Gd^Fp, Gd^Fp, Gd^Fp, Gd^Fp, Gd^Fp, Gd^Fp, Gd^Fp
Gd^Fdf, Gd^Fdf, Gd, Re, Gs^Vl, Gd^Fdf, Gd^Fdf, Gd^Fdf, Gd^Fdf, Gd^Fdf, Gd^Fdf, Gd^Fmf, Gd^Fdf, Gd^Fmf, Gd^Fmf, Gd^Fmf, Gd^Fp, Gd^Fp, Gs^Fp, Ww, Ww, Gd^Fp, Gd^Fp, Gs^Vc, Gd^Fp, Gd^Fp, Gd^Fp, Gd^Fp, Gd^Fp, Gd^Fp, Gd^Fp, Gd^Fp
Gd^Fdf, Gd^Fdf, Gs^Vl, Re, Re, Gd^Fdf, Gd^Fdf, Gd^Fdf, Gd^Fmf, Gd^Fdf, Gd^Fmf, Gd^Fdf, Gd^Fmf, Gd^Fdf, Gd^Fmf, Gd^Fp, Gd^Fp, Gd^Fp, Gs^Fp, Gs^Fp, Gd^Fp, Ww, Ww, Gd^Fp, Gd^Fp, Gd^Fp, Gd^Fp, Chr, 2 Khr, Chr, Gd^Fp, Gd^Fp
Gd^Fdf, Gd^Fdf, Gd^Fdf, Gs, Gd^Fdf, Gd, Re, Gd^Fdf, Gd^Fdf, Gd^Fmf, Gd^Fdf, Gd^Fmf, Gd^Fdf, Gd^Fmf, Gd^Fdf, Ss, Gd^Fp, Gd^Fp, Gs^Fmf, Gs^Fp, Gd^Fp, Ww, Ww, Gd^Fp, Gd^Fp, Gd^Fp, Gd^Fp, Chr, Rd, Chr, Gd^Fp, Gd^Fp
Gd^Fdf, Gd^Fdf, Gd^Fdf, Gd^Fdf, Gd^Fmf, Gd^Fdf, Re, Re, Re, Gd^Fmf, Gd^Fdf, Gd^Fmf, Gd^Fmf, Gd^Fmf, Gd^Fmf, Gd^Fmf, Gd^Fdf, Gd^Fmf, Gd^Fmf, Gd^Fp, Gd^Fp, Gd^Fp, Gs^Fp, Ww, Ww, Gd^Fp, Gd^Fp, Gd^Fp, Rd, Gd^Fp, Gs^Vc, Gg
Gd^Fdf, Gd^Fdf, Gd^Fmf, Gd^Fmf, Ce, Ce, Ce, Gd^Fmf, Gd^Fdf, Gd, Gd, Gd^Fmf, Gd^Fmf, Gd^Fmf, Gd^Fmf, Ss, Ss, Gd^Fdf, Gd^Fdf, Gd^Fmf, Gd^Fmf, Gs^Fp, Gs^Fp, Ww, Ww, Gd^Fp, Gs^Vc, Gd^Fp, Gd^Fp, Gd^Fp, Gd^Fp, Gd^Fp
Gd^Fdf, Gd^Fdf, Gd^Fdf, Gd^Fmf, Ce, 1 Ke, Ce, Gd^Fdf, Gs^Vh, Gd^Fmf, Gd^Fmf, Gd^Fmf, Gd^Fmf, Gd^Fmf, Gd^Fdf, Ss, Gd^Fdf, Gd^Fdf, Gd^Fmf, Gd^Fmf, Gd^Fp, Gd^Fp, Gd^Fp, Gd^Fp, Ww, Gd^Fp, Gd^Fp, Rd, Gd^Vc, Gd^Fp, Gd^Fp, Gd^Fp
Gd^Fdf, Gd^Fmf, Gd^Fmf, Gd^Fmf, Gd^Fmf, Ce, Gd^Fdf, Gd^Fmf, Gd, Gd, Gd^Fmf, Gd^Fmf, Gd^Fmf, Gd^Fmf, Gd^Fdf, Gd^Fdf, Ss, Gd^Fmf, Gd^Fdf, Gd^Fmf, Gd^Fmf, Gd^Fp, Gd^Fp, Gd^Fp, Gd^Fp, Ww, Rd, Rd, Rd, Gd^Fp, Gd^Fp, Gd^Fp
Gd^Fdf, Gd^Fdf, Gd^Fmf, Gd^Fp, Gd^Fp, Gd^Fmf, Gd, Gd, Gs, Gd^Fmf, Gd^Fmf, Gd^Fmf, Gd^Fmf, Gd^Fmf, Gd^Fp, Ss, Ss, Gd^Fp, Gd^Fp, Gd^Fmf, Gd^Fmf, Gd^Fp, Gd^Fp, Gd^Fp, Rd, Ww^Bw/, Ww, Gd^Fp, Gd^Fp, Rd, Gd^Fp, Gd^Fp
Gd^Fdf, Gd^Fdf, Gd^Fmf, Gd^Fp, Gd^Fp, Gd^Fmf, Gd, Gd^Fdf, Gd^Fdf, Gs, Gs, Gd^Fmf, Gd^Fmf, Gd^Fmf, Ss, Ss, Ss, Ss^Vhs, Gd^Fdf, Gd^Fdf, Gd^Fp, Gd^Fp, Gs, Rd, Gd^Fp, Ww, Ww, Gd^Fp, Gd^Fp, Rd, Gd^Fp, Gd^Fp
Gd^Fdf, Gd^Fdf, Gd^Fp, Gd^Fp, Gd^Fmf, Gs^Vht, Gs, Gd^Fdf, Gd^Fp, Gd^Fmf, Gs, Gd^Fmf, Gd^Fmf, Gd^Fdf, Gd^Fdf, Gd^Fp, Gd^Fdf, Ss, Gd^Fmf, Gd^Fp, Gs, Gd^Fp, Gd^Fp, Gd^Fp, Gd^Fp, Gd^Fp, Ww, Gd^Fp, Gd^Fp, Gd^Fp, Gs^Fp, Gd^Fp
Gd^Fmf, Gd^Fmf, Gd^Fdf, Gd^Fp, Gd^Fmf, Gd^Fp, Gd, Gd^Fmf, Gd^Fp, Gd^Fp, Gd^Fp, Gs, Gd^Fmf, Gd^Fmf, Gs, Gd^Fdf, Gd^Fp, Gd^Fmf, Gs, Gd^Fp, Gd^Fp, Gd^Fp, Gs^Fp, Gd^Fp, Gd^Fp, Gd^Fp, Ww, Gd^Fp, Gs^Fp, Gs, Gs^Fp, Gs^Fp
Gd^Fp, Gd^Fmf, Gd^Fmf, Gd^Fmf, Gd^Fmf, Gd^Fmf, Gd, Gd^Fmf, Gd^Fp, Gd^Fp, Gd^Fp, Gd^Fp, Gd^Fp, Gs, Gd^Fmf, Gs, Gs, Gs, Gd^Fp, Gd^Fp, Gd^Fp, Gs^Fp, Gs^Fp, Gs^Fp, Gs^Fp, Ww, Ww, Gd^Fp, Gd^Fp, Gs^Fp, Gs^Fp, Gd^Fp
Gd^Fmf, Gd^Fp, Gd^Fp, Gs^Vht, Gs, Gd, Gd^Fp, Gd^Fp, Gd^Fp, Gd^Fp, Gd^Fp, Gd^Fmf, Gd^Fdf, Gd^Fmf, Gs^Fet, Gs, Gd^Fp, Gd^Fp, Gs^Fet, Gd^Fp, Gd^Fp, Gs^Fp, Gd^Fp, Gs^Fp, Ww, Ww, Gs^Fp, Gd^Fp, Gs^Vc, Gd^Fp, Gs^Fp, Gs^Fp
Gd^Fmf, Gd^Fmf, Gd^Fmf, Gd^Fp, Gs, Gd^Fmf, Gd^Fp, Gd^Fp, Gd^Fp, Gd^Fp, Gd^Fmf, Gd^Fmf, Gs^Fet, Gd^Fmf, Ss, Gd, Gd, Ss, Ss, Gd^Fp, Gd^Fp, Gd^Fp, Gd^Fp, Gd^Fp, Ww, Gs^Fp, Gs^Fp, Gd^Fp, Gd^Fp, Gs, Gs^Fp, Gd^Fp
Gd^Fmf, Gd^Fmf, Gd^Fp, Gd^Fmf, Gs, Gd^Fp, Gd^Fp, Gd^Fp, Gd^Fmf, Gd^Fmf, Gd^Fmf, Gd^Fdf, Gd^Fdf, Ss, Ss, Gs^Fet, Gd, Gs^Fet, Ss, Gs^Fet, Gd^Fp, Gd^Fp, Gd^Fp, Gd^Fp, Ww, Gs^Fp, Gd^Fp, Gs^Fp, Gs^Fp, Gs, Gd^Fp, Gd^Fp
Gd^Fp, Gd^Fp, Gs^Vht, Gd^Fp, Gs, Gd^Fp, Gd^Fp, Gd^Fp, Gd^Fmf, Gd^Fdf, Gd^Fdf, Gd^Fdf, Gs^Fet, Ss, Ss, Chr, 4 Khr, Chr, Ss, Ss, Gs^Fet, Gd^Fp, Gs^Fp, Gd^Fp, Ww, Gs^Fp, Gs^Fp, Gs^Fp, Gd^Fp, Gs^Fp, Gd^Fp, Gd^Fp
Gd^Fp, Gd^Fp, Gd^Fp, Gs, Gd^Fp, Gd^Fp, Gd^Fp, Gd^Fp, Gd^Fmf, Gd^Fdf, Gd^Fmf, Gd^Fdf, Gd^Fdf, Gd^Fdf, Ss, Chr, Gs^Fet, Chr, Ss, Ss, Gd^Fdf, Gd^Fp, Gs^Fmf, Gs^Fp, Ww, Gd^Fp, Gd^Fp, Gd^Fp, Gd, Gs, Gd^Fp, Gd^Fp
Ww, Ww, Ww, Gs, Gd^Fp, Gd^Fp, Ww, Gd^Fp, Ww, Gd^Fmf, Gd^Fmf, Gd^Fdf, Gd^Fdf, Gs^Fet, Ss, Ss, Ss, Ss, Gd^Fdf, Gs^Fet, Gd^Fdf, Gs^Fmf, Gs^Fp, Gs^Fp, Ww, Gd^Fp, Gs^Fp, Gs^Fp, Gd, Gs^Vc, Gd^Fp, Gd^Fp
Gs^Fp, Gs^Fp, Gd^Fp, Ww^Bw|, Ww, Ww, Ww, Ww, Gd^Fp, Ww, Ww, Gd^Fdf, Ss, Ss, Gs^Fet, Ss, Gd^Fdf, Gs^Fet, Gd^Fdf, Gd^Fdf, Gd^Fdf, Gd^Fmf, Gd^Fmf, Gd^Fp, Ww, Ww, Ww, Gs^Fp, Gd^Fp, Gs, Gd^Fp, Gd^Fp
Gs^Fp, Gs^Fp, Gd^Fp, Gs, Gs, Gs^Fp, Gd^Fp, Gs^Fp, Gd^Fp, Gd^Fp, Gs^Fp, Ww, Ww, Ss, Ss, Ss, Gd^Fmf, Gd^Fdf, Gd^Fdf, Gd^Fdf, Gd^Fmf, Hh^Fmf, Hh^Fmf, Gd^Fp, Gd^Fp, Ww, Ww, Gd^Fp, Gs, Gd^Fp, Gs^Fp, Gd^Fp
Gd^Fp, Gd^Fp, Gd^Fp, Gd^Fp, Gs, Gd^Fp, Gd^Fp, Gd^Fp, Gd^Fp, Gd^Fp, Gd^Fp, Gs^Fp, Gs^Fp, Ww, Ss, Gd^Fmf, Gd^Fdf, Gd^Fdf, Gd^Fmf, Gd^Fmf, Gd^Fp, Hh^Fmf, Hh, Gd^Fp, Hh^Fp, Gd^Fp, Gd, Ww^Bw/, Ww, Gd^Fp, Gs^Fp, Gs^Fp
Gd^Fp, Gd^Fp, Gd^Fp, Gd^Fp, Gd^Fp, Gs, Gs, Gd^Fp, Gd^Fp, Gs^Fp, Gs^Fp, Gd^Fp, Gs^Fp, Ww, Ww, Gd^Fmf, Gd^Fmf, Gd^Fdf, Gd^Fmf, Gd^Fmf, Gd^Fp, Hh, Gd, Gd, Hh, Hh^Fp, Gd, Gd^Fp, Ww, Gs^Fp, Gs^Fp, Gs^Fp
Gd^Fp, Gd^Fp, Gs^Fp, Gs^Fp, Gd^Fp, Gd^Fp, Gs, Gd^Fp, Gd^Fp, Gs^Fp, Gs^Fp, Gs^Fp, Gs^Fp, Gs^Fp, Gs^Fp, Ww, Ww, Ww, Ww, Gd^Fp, Gd^Fmf, Gd^Fp, Hh^Fp, Hh, Hh^Fp, Gd^Fp, Gd^Fp, Gd^Fp, Ww, Ww, Ww, Ww
Gd^Fp, Gd^Fp, Gs^Fp, Gs^Fp, Gd^Fp, Gd^Fp, Gd, Gd^Fp, Gd^Fp, Gd^Fp, Gd^Fp, Gs^Fp, Gd^Fp, Gs^Fp, Gs^Fp, Gd^Fp, Gd^Fp, Gd^Fp, Ww, Ww, Ww, Gd^Fp, Ww, Hh^Fp, Gd^Fp, Gd^Fp, Gd, Gd^Fp, Ww, Ww, Ww, Ww
Gd^Fp, Gs^Fp, Gs^Fp, Gs^Fp, Gs^Fp, Gd^Fp, Gd^Fp, Gd, Gs^Vc, Gd^Fp, Gs^Fp, Gd^Fp, Gd^Fp, Gd^Fp, Gd^Fp, Gd^Fp, Gd^Fp, Gd^Fp, Gd^Fp, Gs^Fp, Gs^Fp, Ww, Ww, Ww, Ww, Ww, Ww^Bw|, Ww, Gs^Fp, Ww, Gs^Fp, Gs^Fp
Gd^Fp, Gd^Fp, Gs^Fp, Gs^Fp, Gs^Fp, Gd^Fp, Gd^Fp, Gd, Gd, Gs^Fp, Gs^Fp, Gs^Fp, Gd^Fp, Gd^Fp, Gs^Vc, Gd^Fp, Gd^Fp, Gd^Fp, Gd^Fp, Gs^Fp, Gs^Fp, Gd^Fp, Gd^Fp, Gd^Fp, Gd^Fp, Gs^Vc, Gd, Gs^Fp, Gs^Fp, Gs^Fp, Gs^Fp, Gs^Fp
Gd^Fp, Gd^Fp, Gs^Fp, Gs^Fp, Gs^Fp, Gd^Fp, Gd^Fp, Gd^Fp, Rd, Gd^Fp, Gd^Fp, Gd^Fp, Gd^Fp, Gd^Fp, Gd^Fp, Gd^Fp, Gd^Fp, Gd^Fp, Gs^Fp, Gs^Fp, Gs^Fp, Gs^Fp, Gs^Fp, Gs^Fp, Gs^Fp, Gd^Fp, Gs, Gs^Fp, Gs^Fp, Gs^Fp, Gs^Fp, Gs^Fp
Gd^Fp, Gd^Fp, Gd^Fp, Gs^Fp, Gs^Fp, Gs^Fp, Gd^Fp, Gd^Fp, Gd, Gd^Fp, Gd^Fp, Gd^Fp, Gd, Gd, Rd, Gd, Gd^Fp, Gs, Gd, Gs^Fp, Gd^Fp, Gs^Fp, Gs, Gs, Gs^Fp, Gs, Gs^Fp, Gs^Fp, Gs^Fp, Gs^Fp, Gs^Fp, Gs^Fp
Gd^Fp, Gd^Fp, Gd^Fp, Gd^Fp, Gd^Fp, Gd^Fp, Gd^Fp, Gd^Fp, Rd, Gd, Rd, Rd, Gd^Fp, Chr, 3 Khr, Chr, Gd^Fp, Gd^Fp, Gd^Fp, Gd^Fp, Gd, Gd^Fp, Gd^Fp, Gs^Fp, Gs^Fp, Gs^Fp, Gs^Fp, Gs^Fp, Gs^Fp, Gs^Fp, Gs^Fp, Gd^Fp
Gd^Fp, Gd^Fp, Gd^Fp, Gd^Fp, Gd^Fp, Gd^Fp, Gd^Fp, Gd^Fp, Rd, Gs^Vc, Gd^Fp, Gd^Fp, Gd^Fp, Chr, Gd^Fp, Chr, Gd^Fp, Gd^Fp, Gd^Fp, Gs^Vc, Gd^Fp, Gs, Gd^Fp, Gd^Fp, Gd^Fp, Gd^Fp, Gd^Fp, Gd^Fp, Gd^Fp, Gs^Fp, Gd^Fp, Gd^Fp
Gd^Fp, Gd^Fp, Gd^Fp, Gd^Fp, Gd^Fp, Gd^Fp, Gd^Fp, Gd^Fp, Rd, Gs, Gd^Fp, Gd^Fp, Gd^Fp, Gd^Fp, Gd^Fp, Gd^Fp, Gd^Fp, Gd^Fp, Gd^Fp, Gs, Gd^Fp, Gs, Gd^Fp, Gd^Fp, Gd^Fp, Gd^Fp, Gd^Fp, Gd^Fp, Gd^Fp, Gd^Fp, Gd^Fp, Gd^Fp
