Xu, Xu, Xu, Xu, Xu, Xu, Xu, Xu, Xu, Xu, Xu, Xu, Xu, Xu, Xu, Xu, Xu, Xu, Xu, Xu, Xu, Xu, Xu, Xu, Xu, Xu, Xu
Xu, Xu, Xu, Xu, Xu, Xu, Xu, Xu, Xu, Xu, Xu, Xu, Uu, Uu, Uu, Xu, Uu, Xu, Xu, Xu, Qxu, Xu, Qxu, Xu, Xu, Xu, Xu
Xu, Xu, Xu, Xu, Xu, Xu, Xu, Xu, Uu, Uu, Uu^Vu, Uu, Uu, Uu, Uu, Uu, Uu^Vu, Uu, Uu, Qxu, Qxu, Qxu, Qxu, Qxu, Xu, Xu, Xu
Xu, Xu, Xu, Xu, Xu, Xu, Uu, Uu, Qxu, Uu, Uu, Uu, Cud, Cud, Cud, Uu, Uu, Uu, Qxu, Uu, Uu, Qxu, Qxu, Qxu, Xu, Xu, Xu
Xu, Xu, Xu, Xu, Qxu, Xu, Uh, Uu, Uu, Qxu, Uu, Uu, Cud, 2 Kud, Cud, Uu, Uu, Uu, Qxu, Uu, Uu, Qxu, Xu, Xu, Xu, Xu, Xu
Xu, Xu, Xu, Xu, Qxu, Qxu, Uh, Uh, Uu, Qxu, Uu^Vu, Uu, Uu, Cud, Uu, Uu, Uu^Vu, Qxu, Uu, Uu, Uu, Xu, Xu, Xu, Xu, Xu, Xu
Xu, Xu, Qxu, Qxu, Qxu, Qxu, Uh, Uh, Uu, Uu, Uu, Uu, Uu, Uu, Uu, Uu, Uh, Uh, Uu, Uu^Es, Uu, Xu, Xu, Xu, Xu, Xu, Xu
Xu, Xu, Xu, Qxu, Qxu, Qxu, Qxu, Qxu, Uu, Uu, Uu, Xu, Xu, Xu, Xu, Xu, Uu, Uu, Uu, Xu, Xu, Xu, Xu, Xu, Xu, Xu, Xu
Xu, Xu, Xu, Xu, Xu, Xu, Xu, Uh, Uu, Uu^Es, Uu, Uu, Uu, Uu, Uu, Uu, Uh, Uh, Uu, Uu, Xu, Xu, Xu, Xu, Xu, Xu, Xu
Xu, Xu, Xu, Xu, Xu, Xu, Xu, Uh, Uu, Qxu, Uu, Uh, Uh, Uu, Uu, Uu, Qxu, Qxu, Uu, Uh, Xu, Xu, Xu, Xu, Xu, Xu, Xu
Xu, Xu, Xu, Xu, Xu, Xu, Xu, Uu, Uu, Uu, Xu, Xu, Uh, Uu, Xu, Uu, Uu^Vu, Qxu, Uh, Uh, Xu, Xu, Xu, Xu, Xu, Xu, Xu
Xu, Xu, Xu, Xu, Xu, Xu, Xu, Xu, Uu^Vu, Uu, Xu, Uh, Uh, Uu, Xu, Uh, Uu, Uu, Uu^Uf, Xu, Xu, Xu, Xu, Xu, Xu, Xu, Xu
Xu, Xu, Xu, Xu, Xu, Xu, Xu, Xu, Xu, Uu, Uu, Uu, Xu, Xu, Xu, Xu, Uu, Uu, Xu, Xu, Xu, Xu, Xu, Xu, Xu, Xu, Xu
Xu, Xu, Xu, Xu, Xu, Xu, Xu, Xu, Xu, Uu^Uf, Uu, Uu, Xu, Xu, Xu, Xu, Uu^Es, Uu, Xu, Xu, Xu, Xu, Xu, Xu, Xu, Xu, Xu
Xu, Xu, Xu, Xu, Xu, Xu, Uh, Xu, Uu, Uu, Re, Uu, Re, Uu, Re^Uf, Re, Re^Es, Uu^Es, Uu, Xu, Xu, Xu, Xu, Xu, Xu, Xu, Xu
Xu, Xu, Xu, Xu, Xu, Uu^Uf, Uu^Es, Uu^Uf, Uu^Uf, Re, Ww, Ww, Ww, Re^Uf, Ww, Ww, Ww, Uu, Uu, Uu, Uu, Uu, Uu, Xu, Xu, Xu, Xu
Xu, Xu, Wo, Wo, Wo, Uu, Ww^Bw\, Ww, Ww, Ww, Wo, Wo, Wo, Ww, Wo, Wo, Wo, Ww, Ww, Ww, Ww^Bw/, Uu, Wo, Xu, Wo, Xu, Xu
Xu, Xu, Xu, Xu, Re, Ww, Uu^Uf, Uu, Uu^Uf, Ww, Ww, Wo, Ww, Wo, Ww, Wo, Ww, Ww, Uu^Uf, Uu, Uu, Ww, Uu, Wo, Xu, Xu, Xu
Xu, Xu, Xu, Xu, Re, Re, Uu^Vu, Uu, Uu, Uu^Uf, Uu^Uf, Ww, Uu^Uf, Ww, Uu^Uf, Ww, Uu^Uf, Uu^Uf, Re, Re^Es, Uu^Vu, Uu, Uu, Xu, Xu, Xu, Xu
Xu, Xu, Xu, Xu, Xu, Uu, Uu, Uu^Uf, Uu^Uf, Uu, Xu, Uu^Uf, Xu, Uu^Ufi, Xu, Uu^Uf, Xu, Uu, Re^Es, Re, Uu^Uf, Uu^Uf, Xu, Xu, Xu, Xu, Xu
Xu, Xu, Xu, Xu, Xu, Xu, Xu, Xu, Uu^Uf, Re, Uu, Xu, Xu, Xu, Xu, Xu, Uh, Uu, Uu, Xu, Xu, Xu, Xu, Xu, Xu, Xu, Xu
Xu, Xu, Xu, Xu, Xu, Xu, Xu, Uu, Xu, Re^Es, Uu, Uu, Uu, Uu^Vu, Uu, Uh, Uu, Uu, Xu, Uh, Xu, Xu, Xu, Xu, Xu, Xu, Xu
Xu, Xu, Xu, Xu, Xu, Xu, Xu, Uu, Uu, Uu, Uu, Uu, Cud, Uu^Ii, Cud, Uu, Uu, Uu, Uh, Uh, Xu, Xu, Xu, Xu, Xu, Xu, Xu
Xu, Xu, Xu, Xu, Xu, Xu, Xu, Xu, Xu, Uu^Vu, Uh, Uu, Cud, 1 Kud, Cud, Re, Uu, Uu^Vu, Xu, Xu, Xu, Xu, Xu, Xu, Xu, Xu, Xu
Xu, Xu, Xu, Xu, Xu, Xu, Xu, Xu, Xu, Xu, Uh, Uh, Uh, Cud, Uu, Uh, Uh, Xu, Xu, Xu, Xu, Xu, Xu, Xu, Xu, Xu, Xu
Xu, Xu, Xu, Xu, Xu, Xu, Xu, Xu, Xu, Xu, Xu, Xu, Xu, Uh, Xu, Xu, Xu, Xu, Xu, Xu, Xu, Xu, Xu, Xu, Xu, Xu, Xu
Xu, Xu, Xu, Xu, Xu, Xu, Xu, Xu, Xu, Xu, Xu, Xu, Xu, Uh, Xu, Xu, Xu, Xu, Xu, Xu, Xu, Xu, Xu, Xu, Xu, Xu, Xu
