Wot, Wot, Wot, Wot, Wot, Wot, Wot, Wot, Wot, Wot, Wot, Wot, Wot, Wo, Wo, Wo, Wo, Wo, Wo, Wo, Ww, Wo, Ww, Wo, Wo, Wo, Wo, Wo, Wo, Wo, Wo, Ww, Ds, Gg, Gg, Gg, Gg, Gs^Fds, Gs^Fp, Gs^Fp, Gs^Fp
Wot, Wot, Wot, Wot, Wot, Wot, Wot, Wot, Wot, Wot, Wot, Wot, Wo, Wo, Wo, Wo, Wo, Wo, Ww, Ww, Ww, Ww, Gg, Ww, Wo, Wo, Wo, Wo, Wo, Wo, Wo, Ww, Ds, Gg, Gg, Gg, Gg, Gs^Fds, Gs^Fp, Gs^Fp, Gs^Fp
Wot, Wot, Wot, Wot, Wot, Wot, Wot, Wot, Wot, Wot, Wo, Wot, Wo, Wo, Wo, Wo, Wo, Wo, Ww, Ww, Gg^Ve, Gs^Fds, Gg^Ve, Ww, Ww, Wo, Wo, Wo, Wo, Wo, Ww, Ww, Ww, Ds, Gg, Gg, Gg, Gs^Fms, Gs^Fms, Gs^Fms, Gs^Fms
Wot, Wot, Wot, Wot, Wot, Wot, Wot, Wot, Wot, Wo, Wo, Wo, Wo, Wo, Wo, Wo, Wo, Ww, Ww^Bw\, Ww, Gs^Fds, Gs^Fds, Gs^Fds, Ww, Ds, Ww, Ww, Ww, Ww, Ww, Ww, Ww, Ww, Ds, Ds, Gs^Fds, Gg, Gg, Gg, Gg, Gg
Wot, Wot, Wot, Wot, Wot, Wot, Wot, Wot, Wot, Wot, Wot, Wo, Wo, Wo, Wo, Wo, Wo, Ww, Ww, Gg, Gg^Ve, Gs^Fds, Gs^Fds, Ds^Ve, Gs^Fds, Ww^Vm, Ww, Ww, Wo, Ww, Wo, Wo, Ww, Ds, Ds, Gs^Fds, Gg, Gs^Fms, Gs^Fms, Gs^Fms, Gs^Fms
Wot, Wot, Wot, Wot, Wot, Wot, Wot, Wot, Wot, Wot, Wot, Wo, Wo, Wo, Wo, Wo, Wo, Ww, Ww, Gg, Ww^Vm, Cv, 4 Kv, Cv, Gs^Fds, Ds, Ww, Ww, Wo, Wo, Wo, Wo, Wo, Ww, Ds, Gg, Gg^Ve, Gg, Gg, Gg, Gg
Wot, Wot, Wot, Wot, Wot, Wot, Wot, Wot, Wot, Wot, Wot, Wot, Wot, Wo, Wo, Wo, Wo, Ww, Ww, Ww, Gs^Fds, Gg^Ve, Cv, Gg^Ve, Ds, Ds, Ww, Wo, Wo, Wo, Wo, Wo, Wo, Ww, Ww, Gg, Ww, Gg, Gg, Gg, Gg
Wot, Wot, Wot, Wot, Wot, Wot, Wot, Wot, Wot, Wot, Wot, Wot, Wo, Wo, Wo, Wo, Wo, Wo, Wo, Ww, Ww, Gs^Fds, Ds, Gs^Fds, Ds, Wwr, Ww, Wo, Wo, Wo, Wo, Wo, Wo, Ww, Ds, Ww, Ww, Ww, Ww, Ww, Ww
Wot, Wot, Wot, Wot, Wot, Wot, Wot, Wot, Wot, Wot, Wot, Wot, Wo, Wo, Wo, Wo, Wo, Wo, Wo, Ww, Ww, Ds, Ww^Vm, Ds, Wwr, Wwr, Wwr, Wo, Wo, Wo, Wo, Wo, Ww, Ww, Ds, Gg, Gg, Ww, Ww, Ww, Ww
Wot, Wot, Wot, Wot, Wot, Wot, Wot, Wot, Wot, Wot, Wot, Wot, Wot, Wo, Wo, Wo, Wo, Wo, Wo, Ww, Ww, Ww, Ww, Ds, Ww, Ww, Wwr, Wo, Wo, Wo, Wo, Wo, Ww, Ww^Vm, Gg, Gg, Gg, Gg^Ve, Gg, Gg, Gg
Wot, Wot, Wot, Wot, Wot, Wot, Wot, Wot, Wot, Wot, Wot, Wot, Wot, Wo, Wo, Wo, Wo, Wo, Wo, Wo, Ww, Ww, Ww, Wwr, Ds, Ww, Ww, Wwr, Ww, Wo, Wo, Wo, Ww, Ds, Gg, Gg^Ve, Gg, Gg, Gg, Gg, Gg
Wot, Wot, Wot, Wot, Wot, Wot, Wot, Wot, Wot, Wot, Wot, Wot, Wot, Wot, Wot, Wo, Wo, Wo, Wo, Wo, Wo, Ww, Ww, Ds, Ds, Ww^Vm, Ww, Wwr, Wwr, Wo, Wo, Wo, Ww^Vm, Ds, Gg, Gg, Gg, Gg, Gg, Gg^Ve, Gg
Wot, Wot, Wot, Wot, Wot, Wot, Wot, Wot, Wot, Wot, Wot, Wot, Wot, Wot, Wot, Wot, Wo, Wo, Wo, Wo, Wo, Ww, Ww, Wwr, Ww, Ww, Ww, Wwr, Ww, Ww, Wo, Ww, Ds, Ds, Gg, Gg, Cv, Cv, Gg^Ve, Gg, Gg
Wot, Wot, Wot, Wot, Wot, Wot, Wot, Wot, Wot, Wot, Wot, Wot, Wot, Wot, Wot, Wot, Wot, Wo, Wo, Wo, Wo, Wo, Ww, Ww, Ww, Wwr, Wwr, Ww, Ww^Vm, Ww, Ww, Ww, Ds, Ds, Gg, Gg, Cv, 2 Kv, Cv, Gg, Gg
Wot, Wot, Wot, Wot, Wot, Wot, Wot, Wot, Wot, Wot, Wot, Wot, Wot, Wot, Wot, Wot, Wo, Wo, Wo, Wo, Wo, Wo, Ww, Ww, Ww, Wwr, Wwr, Ds, Ww, Ww, Ww, Ww, Ds, Gg, Gg, Gg, Gg, Cv, Gg, Gg, Gg
Wot, Wot, Wot, Wot, Wot, Wot, Wot, Wot, Wot, Wot, Wot, Wot, Wot, Wot, Wot, Wot, Wo, Wot, Wot, Wo, Wo, Wo, Ww, Ww, Ww, Ww, Ww, Wwr, Ww, Ww, Ww, Ds, Gg, Gg^Ve, Gg, Gg, Gg, Gg, Gg^Ve, Gg, Gg
Wot, Wot, Wot, Wot, Wot, Wot, Wot, Wot, Wot, Wot, Wot, Wot, Wot, Wot, Wot, Wot, Wot, Wot, Wot, Wo, Wo, Wo, Wo, Ww, Ww^Vm, Ww, Ww, Wwr, Wwr, Ww, Ds, Ds, Gs, Gg, Gg, Gg, Gg, Gg, Gg, Gg, Gg
Wot, Wot, Wot, Wot, Wot, Wot, Wot, Wot, Wot, Wot, Wot, Wot, Wot, Wot, Wot, Wot, Wot, Wot, Wot, Wot, Wot, Wot, Ww, Ww, Ww, Ww, Wwr, Wwr, Ww, Ww, Ds, Ds, Gg, Gg, Gg, Gg, Gg, Gg, Gg, Gg, Gg
Wot, Wot, Wot, Wot, Wot, Wot, Wot, Wot, Wot, Wot, Wot, Wot, Wot, Wot, Wot, Wot, Wot, Wot, Wot, Wot, Wot, Wot, Wot, Ww, Wwt, Ww, Ww, Wwr, Ds, Ds, Gs, Gs, Gs, Gg^Ve, Gs^Fds, Gg, Gg^Ve, Gg, Gg, Gg, Gg
Wot, Wot, Wot, Wot, Wot, Wot, Wot, Wot, Wot, Wot, Wot, Wot, Wot, Wot, Wot, Wot, Wot, Wot, Wot, Wot, Wot, Wot, Wot, Wwt, Wwt, Wwt, Ds, Ds, Gs, Ds, Gs, Gg, Gg, Gs^Fds, Gs^Fms, Gs^Fds, Gg, Gg, Gg^Ve, Gg, Gg
Wot, Wot, Wot, Wot, Wot, Wot, Wot, Wot, Wot, Wot, Wot, Wot, Wot, Wot, Wot, Wot, Wot, Wot, Wwt, Wot, Wwt, Wot, Wwt, Wwt, Ds, Ds, Gs, Ds, Gs, Gs, Gg, Gg, Gs^Fms, Gs^Fds, Gg^Ve, Gs^Fds, Gg, Gg, Gg, Gg, Gg
Wot, Wot, Wot, Wot, Wot, Wot, Wot, Wot, Wot, Wot, Wot, Wot, Wot, Wot, Wot, Wot, Wwt, Wwt, Wwt, Wot, Wwt, Wwt, Ds, Ds, Gs, Ds, Gs, Gs, Gs, Gg, Gs^Fds, Gs^Fds, Gs^Fp, Gs^Fms, Gs^Fp, Gs^Fp, Gs^Fds, Gs^Fds, Gs^Fds, Gs^Fds, Gs^Fds
Wot, Wot, Ds, Wot, Wwt, Wwt, Wwt, Ww^Vm, Wwt, Wot, Wot, Wot, Wwt, Wwt, Wwt, Wot, Wwt, Wwt, Ds, Wwt, Ds, Ds, Gs, Ds, Gs, Gs, Gg^Ve, Gg, Gg, Gg, Gs^Fms, Gs^Fp, Gs^Fp, Gs^Fms, Gs^Fp, Gs^Fp, Gs^Fds, Gs^Fds, Gs^Fds, Gs^Fds, Gs^Fds
Ds, Ds, Gs, Ds, Ds, Wwt, Wwt, Wwt, Wwt, Wwt, Wot, Wot, Wwt, Ww^Vm, Wwt, Wwt, Ds, Wwt, Ds, Ds, Gs, Gs, Gg, Gs, Gs, Gg, Gs^Fds, Gg, Gs^Fds, Gs^Fds, Gs^Fms, Gs^Fms, Gs^Fds, Gs^Fms, Gs^Fms, Gs^Fds, Gs^Fds, Gg^Ve, Gs^Fds, Gs^Fds, Gs^Fds
Gs^Fds, Gs, Gs, Gs, Gs, Ds, 1 Khr, Wwt, Wwt^Bw/r, Wwt, Wwt, Wot, Wwt, Wwt, Ds, Ds, Gs, Ds, Gs, Gs, Gg, Gs, Gg, Gs, Gg, Gs^Fds, Gs^Fds, Gs^Fds, Gs^Fds, Gs^Fms, Gs^Fds, Gs^Fds, Gg, Gs^Fds, Gs^Fds, Gs^Fds, Gs^Fds, Gs^Fds, Gs^Fds, Gs^Fds, Gs^Fds
Gs^Fds, Gs^Fds, Gs^Ve, Gs^Fds, Gs^Fds, Chr, Chr, Chr, Chr, Wwt, Wwt, Wwt, Ds, Ds, Gs, Gs, Gg^Ve, Gs, Gg, Gs, Gg, Gg, Gg, Gg, Gg, Gs^Fds, Gs^Fds, Gs^Fds, Gs^Fds, Gs^Fds, Gs^Fds, Gg, Gg, Gg, Gg, Gs^Fds, Gs^Fds, Gs^Fds, Gs^Fds, Gs^Fds, Gs^Fds
Gs^Fds, Gs^Fds, Gs^Fds, Gs^Fds, Gs^Fds, Gs^Fds, Gs^Fds, Chr, Ds, Wwt, Gs^Ve, Wwt, Ds, Gs, Gs^Fds, Gs, Gg, Gg, Gg, Gg, Gg, Gg, Gg, Gg, Gg, Gs^Fds, Gs^Fds, Gs^Fds, Gs^Fds, Gs^Fds, Gg, Gg^Ve, Gg, Gg, Gg, Gg, Gs^Fds, Gs^Fds, Gs^Fds, Gs^Fds, Gs^Fds
Gs^Fds, Gs^Fds, Gs^Fds, Gs^Fds, Gs^Fds, Gs^Fds, Gs^Fds, Gs, Ds, Wwt, Wwt, Wwt, Ds, Gs^Fds, Gs^Fds, Gs^Fds, Gg, Gg, Gg^Ve, Gg, Gg, Gg, Gg, Gg, Gg, Gg, Gg, Gg, Gg, Gg, Gg, Gg, Gg, Gg, Hh, Gg, Gg, Gs^Fds, Gg, Gg, Gg
Gs^Fds, Gs^Fds, Gs^Fds, Gs^Fds, Gs^Fds, Gs^Fds, Gs^Fds, Gs, Ds, Wwt, Wwf, Wwt, Ds, Gs^Fds, Gs^Fds, Gs^Fds, Gg, Gg, Gg, Gg, Gg, Gg, Gg, Gg, Gg, Gg, Gg, Gg, Gg, Gg, Gg, Gg, Hh, Hh, Hh, Hh, Hh, Gg, Gg, Gg, Gg
Gs, Gs^Fds, Hh, Gs^Fds, Gs^Fds, Gs^Fds, Gs^Fds, Gs, Gs^Ve, Ds, Ds, Wwf, Ds, Gs, Gs, Gg, Gg, Gg, Gg, Gg, Gg, Gg, Gg, Gg, Gg, Gg, Gg, Gg, Gg, Gg, Gg, Hh, Hh, Hh, Hh, Hh, Hh, Hh, Hh, Hh, Hh
Gs, Hh, Hh, Hh, Gs, Gs^Fds, Gs, Gs, Gs^Fds, Gs, Ds, Wwf, Ds, Gs, Gs, Gs^Fds, Gs^Fds, Gs^Fds, Gg, Gg, Gg, Gg, Gg, Gg, Gg, Gg, Gg, Gg, Gg, Gg, Hh, Hh, Hh, Hh, Hh, Hh, Hh, Hh, Hh, Hh, Hh
Hh, Hh, Hh, Hh, Hh, Gs, Gs, Gs, Gs^Fds, Gs^Fds, Gs^Fds, Wwf, Gs, Gs, Gs, Gs^Fds, Gs^Fds, Gs^Fds, Gg, Gg, Gg, Gg, Gg, Gg, Gg, Gg, Hh, Gg, Hh, Hh, Hh, Hh, Hh, Hh, Hh, Hh, Hh, Hh^Vhh, Hh, Hh, Hh
Hh, Hh, Hh, Hh, Hh, Hh, Hh, Gs, Gs^Fds, Gs^Fds, Wwt, Wwt, Gs, Gs, Gs^Fds, Gs^Fds, Gs^Fds, Gs^Fds, Gg, Gg, Gg, Gg, Hh, Gg, Hh, Hh, Hh, Hh, Hh, Hh, Hh, Hh, Hh, Hh, Hh, Hh, Hh, Hh, Hh, Hh, Hh
Hh, Hh, Hh, Hh, Mm, Hh, Hh, Hh^Vhh, Gs, Gs^Fds, Wwt, Gs, Gs, Gs, Gs^Fds, Gs^Fds, Gg, Gg, Hh, Hh, Hh, Hh, Hh, Hh, Hh, Hh, Hh, Hh, Hh, Hh, Hh, Hh, Hh, Hh, Hh, Hh, Hh, Hh, Hh, Hh, Hh
Hh, Hh, Hh, Mm, Mm, Mm, Hh, Hh, Hh, Gs, Gs, Wwt, Gs, Gs^Fds, Gs, Gg, Hh, Hh, Hh, Hh, Hh, Hh, Hh, Hh, Hh^Vhh, Hh, Hh, Hh, Hh, Hh^Vhh, Hh, Hh, Hh, Hh, Hh, Hh, Hh, Hh, Hh, Hh, Hh
Hh, Hh, Hh, Hh, Hh, Hh, Hh, Hh, Hh, Hh, Hh, Wwt, Hh, Gs, Hh, Hh, Hh, Hh, Hh, Hh, Hh, Hh, Hh, Hh, Hh, Hh, Hh, Hh, Hh, Hh, Hh, Hh, Hh, Hh, Hh, Hh^Vhh, Hh, Hh, Hh^Vhh, Hh, Hh
Gs, Hh, Hh, Hh, Hh, Hh, Gs, Hh, Hh, Hh, Hh, Wwt, Gs, Hh, Hh, Hh, Hh, Hh, Hh, Hh, Hh, Hh, Hh, Hh, Hh, Hh, Hh, Hh, Hh, Hh, Hh, Hh, Hh, Hh, Hh, Hh, Hh, Hh, Hh, Hh, Hh
Gs, Hh, Wwt, Gs, Wwt, Wwt, Wwt, Gs, Wwt, Hh, Wwt, Wwt, Wwt, Gs, Gs, Hh, Hh, Hh, Hh, Hh, Hh, Hh, Hh, Hh, Hh, Hh, Hh, Hh, Hh, Hh, Hh, Hh^Vhh, Hh, Hh, Hh, Hh, Hh, Hh, Mm^Vhh, Hh, Mm
Wwt, Wwt, Gs, Wwt, Gs, Gs, Gs, Wwt, Gs, Wwt, Hh, Hh, Gs, Wwt^Bw/, Gs, Hh, Hh, Hh, Hh, Hh, Hh^Vhh, Hh, Hh, Hh, Hh, Hh^Vhh, Cud, Hh, Hh, Hh, Hh, Hh, Mm, Mm, Mm, Mm, Mm, Mm, Mm, Mm, Mm
Gs, Gs, Gs, Gs, Gs, Gs, Gs, Gs, Gs^Ve, Gs, Gs, Hh, Hh, Wwt, Gs, Hh, Hh, Hh, Hh, Hh, Hh, Hh, Hh, Hh, Hh, Cud, 3 Kud, Hh^Vhh, Hh, Hh, Hh, Hh, Mm, Mm, Mm, Mm, Mm, Mm, Mm, Mm, Mm
Gs, Gs, Gs, Gs, Gs, Gs, Gs, Gs, Gs, Gs, Gs, Hh, Gs, Wwt, Wwt, Hh, Hh, Hh, Hh, Hh, Hh, Hh, Hh, Hh, Hh^Vhh, Hh, Cud, Cud, Hh, Hh, Mm, Hh^Vhh, Mm, Mm, Mm, Mm, Mm, Mm, Mm^Vhh, Mm, Mm
Gs, Gs, Gs, Gs, Gs, Gs, Gs, Gs, Gs, Gs, Hh, Hh, Gs, Wwt, Wwt, Wwt, Wwt, Hh, Hh, Hh, Hh, Hh, Hh, Hh, Hh, Hh, Mm, Mm, Mm, Mm, Mm, Mm, Mm, Mm, Mm, Mm, Mm, Mm, Mm, Mm, Mm
