Xu, Xu, Xu, Xu, Xu, Xu, Xu, Xu, Xu, Xu, Xu, Xu, Xu, Xu, Xu, Xu, Xu, Xu, Xu, Xu, Xu, Xu, Xu, Xu, Xu, Xu, Xu, Xu, Xu, Xu, Xu, Xu
Xu, Xu, Xu, Xu, Xu, Xu, Xu, Xu, Xu, Xu, Xu, Xu, Xu, Xu, Xu, Xu, Xu, Xu, Xu, Xu, Xu, Xu, Xu, Xu, Xu, Xu, Xu, Xu, Xu, Xu, Xu, Xu
Xu, Xu, Xu, Xu, Uu^Uf, Uu^Vu, Uh, Xu, Xu, Xu, Xu, Xu, Xu, Xu, Xu, Xu, Xu, Xu, Xu, Xu, Xu, Xu, Uu^Vu, Xu, Uu^Uf, Xu, Uu^Vu, Xu, Uu^Uf, Xu, Xu, Xu
Xu, Xu, Uh, Uh, Uu^Uf, Uu^Uf, Uu^Uf, Uu, Uu^Vu, Xu, Xu, Xu, Uu, Uu^Vu, Uu, Uu^Uf, Uu, Xu, Xu, Xu, Xu, Uh, Uu^Uf, Uu^Uf, Uu, Uu, Uu, Uu, Uu^Uf, Xu, Xu, Xu
Xu, Xu, Uu, Uu, Cud, Uh, Cud, Uu, Uu, Xu, Xu, Xu, Uu, Uu, Uu, Uu, Uu, Uu, Xu, Xu, Xu, Xu, Uu, Uu, Cud, Uu, Cud, Uu, Uu^Vu, Xu, Xu, Xu
Xu, Xu, Uu^Vu, Uu, Cud, 2 Kud, Cud, Uu, Xu, Xu, Xu, Xu, Uu, Uu, Xu, Xu, Xu, Uu, Xu, Xu, Xu, Xu, Uu, Ur, Cud, 3 Kud, Cud, Uu, Uh, Uh, Xu, Xu
Xu, Xu, Uu, Uu, Uu, Uu, Uu, Uu, Uu, Uu^Vu, Uu, Uu, Uu^Uf, Uu, Uu, Xu, Uu, Uu, Uh, Uh, Xu, Uu^Vu, Ur, Ur, Uu, Ur, Ur, Uu, Uh, Uh, Xu, Xu
Xu, Xu, Uh, Uu, Uh, Uu, Uu, Uu, Xu, Uu, Uu, Uu^Uf, Xu, Xu, Uu, Uu, Uu, Xu, Xu, Uh, Uu, Uu, Uu, Xu, Uu, Ur, Uu^Vu, Uu, Xu, Uh, Xu, Xu
Xu, Xu, Uh, Uu^Vu, Xu, Xu, Uh, Uu, Uu, Xu, Uu, Xu, Uu, Uu, Xu, Uu^Vu, Xu, Uu, Uu, Xu, Uu, Xu, Uu, Uu, Xu, Xu, Xu, Xu, Xu, Xu, Xu, Xu
Xu, Xu, Xu, Uh, Xu, Xu, Xu, Uu, Uu, Uu, Xu, Uu, Ur, Uu^Uf, Xu, Xu, Xu, Xu, Uu, Uu, Xu, Uu, Uu, Uu, Xu, Xu, Xu, Xu, Xu, Xu, Xu, Xu
Xu, Xu, Xu, Xu, Xu, Xu, Xu, Xu, Uu, Uu, Xu, Uh, Ur, Xu, Xu, Xu, Xu, Xu, Uu, Xu, Uh, Uu, Uu, Uu, Uu, Xu, Xu, Xu, Xu, Xu, Xu, Xu
Xu, Xu, Xu, Xu, Xu, Xu, Uh, Uu, Uu, Uu, Xu, Xu, Uu, Xu, Ww, Ww, Ww, Xu, Uu, Xu, Xu, Xu, Uu, Xu, Uu, Xu, Xu, Xu, Xu, Xu, Xu, Xu
Xu, Xu, Xu, Xu, Xu, Uh, Uu, Uu, Xu, Ur, Ur, Uu, Ww^Bw\, Ww, Ww^Ii, Ww^Ii, Ww^Ii, Ww, Ww^Bw/, Uu, Uu^Ii, Uu, Xu, Uu, Uu, Uu^Uf, Xu, Xu, Xu, Xu, Xu, Xu
Xu, Xu, Xu, Xu, Xu, Xu, Uu, Uu^Uf, Xu, Xu, Ur, Ww, Ww, Ww^Bw\, Ur^Ii, Uh^Ii, Ur^Ii, Ww^Bw/, Ww, Ww^Ii, Uu^Ii, Xu, Xu, Uu, Uu, Uu, Xu, Xu, Xu, Xu, Xu, Xu
Xu, Xu, Xu, Uh, Uu, Uu, Xu, Uu, Uu, Uu, Xu, Ww, Ww^Ii, Ur, Cud, Cud^Ii, Cud, Uu, Ww, Ww, Xu, Uu, Uu, Uu, Uh, Uu, Uu, Uh, Uh, Xu, Xu, Xu
Xu, Xu, Xu, Uu, Uu, Xu, Uu^Vu, Xu, Uu, Xu, Xu, Ww^Ii, Ww^Ii, Uu^Ii, Cud, 1 Kud, Cud, Uu^Vu, Ww^Ii, Ww, Xu, Xu, Uu, Xu, Xu, Xu, Uu^Vu, Uu, Uh, Xu, Xu, Xu
Xu, Xu, Xu, Uu, Uu, Uu, Xu, Xu, Uu, Uu^Vu, Xu, Ww^Ii, Ww^Ii, Ur^Ii, Uu^Vu, Cud, Ur, Uu^Ii, Ww^Ii, Ww^Ii, Xu, Uu^Vu, Uu, Uu^Uf, Xu, Xu, Uu, Uu, Xu, Xu, Xu, Xu
Xu, Xu, Xu, Xu, Uu^Uf, Uu, Uu, Uu, Uu, Xu, Xu, Ww, Ww, Uu, Uu, Ur, Uu, Uu^Ii, Ww^Ii, Ww^Ii, Xu, Xu, Ur, Uu, Uu, Uu, Uu, Uu^Uf, Uu^Uf, Xu, Xu, Xu
Xu, Xu, Xu, Xu, Xu, Uu^Uf, Uu, Xu, Xu, Uu, Uu^Ii, Ww^Ii, Ww^Bw/, Ww^Bw/, Ww, Uh, Ww, Ww^Bw\, Ww^Bw\, Ww, Uu, Ur, Xu, Xu, Uu, Uu, Xu, Uu^Uf, Xu, Xu, Xu, Xu
Xu, Xu, Xu, Xu, Xu, Uh, Uh, Uu, Uu, Uu, Xu, Ur^Ii, Ur, Ww, Ww^Ii, Ww^Ii, Uh^Ii, Ww, Uu, Uu, Xu, Uu, Uu, Uu, Xu, Uh, Xu, Xu, Xu, Xu, Xu, Xu
Xu, Xu, Xu, Xu, Xu, Xu, Uh, Uu, Uu, Xu, Xu, Xu, Uu, Xu, Xu, Uh^Ii, Uh, Xu, Uu^Ii, Xu, Xu, Xu, Uu, Uu, Xu, Xu, Xu, Xu, Xu, Xu, Xu, Xu
Xu, Xu, Xu, Xu, Xu, Xu, Uu, Uu, Ur, Uu^Uf, Xu, Uh, Uu, Xu, Xu, Xu, Xu, Xu, Uu, Xu, Xu, Uu^Vu, Uu, Uu, Uu, Uu^Vu, Xu, Xu, Xu, Xu, Xu, Xu
Xu, Xu, Xu, Xu, Xu, Uu^Vu, Uu, Uu^Uf, Xu, Ur, Ur, Ur, Xu, Uu, Uu, Uu^Vu, Uu, Uu, Xu, Uu, Uu, Uu, Xu, Uu, Ur, Uu, Uu, Xu, Uu^Vu, Xu, Xu, Xu
Xu, Xu, Uh, Uu^Vu, Uu, Uu, Uu, Xu, Uu, Uu^Vu, Uu, Uu, Uu^Uf, Xu, Uu, Uu, Uu, Xu, Uu, Uu, Xu, Uu, Uu, Xu, Ur, Ur, Uu, Uu, Uu^Uf, Xu, Xu, Xu
Xu, Xu, Uu, Uu, Cud, Uu, Cud, Uu, Xu, Uu, Uu^Uf, Uu, Uu, Uu, Xu, Xu, Xu, Uu, Uu, Xu, Xu, Xu, Xu, Uu, Cud, Ur, Cud, Uu, Uu^Uf, Uu^Uf, Xu, Xu
Xu, Xu, Uu^Uf, Uu, Cud, 4 Kud, Cud, Uu, Uh, Xu, Xu, Xu, Xu, Uu, Xu, Uu^Vu, Uu, Uu, Uh, Uh, Xu, Xu, Uu, Uu^Vu, Cud, 5 Kud, Cud, Uu^Uf, Uu^Uf, Xu, Xu, Xu
Xu, Xu, Uu^Uf, Uu, Uu, Uu, Uh, Uh, Uh, Xu, Xu, Xu, Xu, Uu, Uu, Uu, Uu, Uu, Uu^Uf, Xu, Xu, Uu, Xu, Uu, Uu, Uh, Uh, Uu^Uf, Uh, Xu, Xu, Xu
Xu, Xu, Xu, Uu^Vu, Uu, Uu, Uh, Uh, Uh, Xu, Xu, Xu, Xu, Xu, Xu, Uu^Uf, Xu, Uu^Uf, Xu, Xu, Xu, Xu, Xu, Uu, Uu, Uu, Uu, Uu, Uh, Xu, Xu, Xu
Xu, Xu, Xu, Xu, Uu^Uf, Uu^Vu, Xu, Xu, Xu, Xu, Xu, Xu, Xu, Xu, Xu, Xu, Xu, Xu, Xu, Xu, Xu, Xu, Xu, Xu, Xu, Uu^Vu, Xu, Uh, Xu, Xu, Xu, Xu
Xu, Xu, Xu, Xu, Xu, Xu, Xu, Xu, Xu, Xu, Xu, Xu, Xu, Xu, Xu, Xu, Xu, Xu, Xu, Xu, Xu, Xu, Xu, Xu, Xu, Xu, Xu, Xu, Xu, Xu, Xu, Xu
Xu, Xu, Xu, Xu, Xu, Xu, Xu, Xu, Xu, Xu, Xu, Xu, Xu, Xu, Xu, Xu, Xu, Xu, Xu, Xu, Xu, Xu, Xu, Xu, Xu, Xu, Xu, Xu, Xu, Xu, Xu, Xu
Xu, Xu, Xu, Xu, Xu, Xu, Xu, Xu, Xu, Xu, Xu, Xu, Xu, Xu, Xu, Xu, Xu, Xu, Xu, Xu, Xu, Xu, Xu, Xu, Xu, Xu, Xu, Xu, Xu, Xu, Xu, Xu
