Ds, Ds, Gg, Gg, Gg, Gg, Gs^Fds, Gs^Fds, Gs^Fds, Gs^Fds, Gs^Fds, Gs^Fds, Gs^Fds, Gs^Fds, Gs^Fds, Gg, Gg, Gg, Gg, Ss, Gg, Gg
Ds, Ds, Gg, Gg^Vh, Gg, Gg, Gs^Fds, Gs^Fds, Gs^Fds, Gs^Fds, Gs^Fds, Gs^Fds, Gs^Fds, Gs^Fds, Gs^Fds, Gg, Gg, Gg, Gg, Ss, Gg, Gg
Ww, Ww, Ww, Gg, Gg, Gg, Gg, Gs^Fds, Ww, Gs^Fds, Gg, Gg, Gg, Gs^Fds, Gg, Gg, Gg, Gg, Ss, Gg, Gg, Gg
Ww, Ww, Ww, Ds, Gg, Gg, Ww, Ww, Ww, Ww, Ww, Gg, Ww, Gg, Gg, Gg, Ss, Ss, Ss, Ss, Ss, Ss
Wo, Wo, Ww, Ww, Ww, Ww, Ww, Ww, Gg, Ww, Gg, Ww, Gg, Ww^Bw/, Ww, Ww, Ww, Ss, Ww, Ww, Ww, Ww
Wo, Wo, Wo, Wo, Ww, Ww, Gg, Gg, Gg, Gg, Gs^Fds, Gg^Ve, Gg, Ww, Ww, Ww, Ww, Ww, Ss, Ss^Vhs, Ww, Ww
Wo, Wo, Wo, Wo, Ww, Gs^Fds, Gs^Fds, Gs^Fds, Gs^Fds, Gg, Gg, Gg, Ww^Bw\, Ww, Gg, Gg, Gg, Ss, Ss, Ss, Ss, Ss
Wo, Wo, Wo, Ww, Ww, Ds, Gs^Fds, Gs^Fds, Ww, Ww, Ww, Gg, Ww, Gg, Gg, Gg, Gs^Fds, Gs^Fds, Gs^Fds, Ss, Gg, Gg
Wo, Wo, Wo, Ww, Wo, Ww, Ww, Ww, Ww, Ww, Ww, Ww, Ww, Gg, Gg, Gs^Fds, Gs^Fds, Ss, Gs^Fds, Gs^Fds, Gs^Fds, Gs^Fds
Wo, Wo, Wo, Wo, Wo, Wo, Ww, Ww, Gg, Gg, Gg, Ww, Gg, Gg, Gg, Gs^Fds, Gs^Fds, Gs^Fds, Gs^Fds, Gs^Fds, Gs^Fds, Gs^Fds
Wo, Wo, Wo, Wo, Ww, Ww, Ds, Gg, Gg, 1 Gg, Gg, Gg, Gg, Gg, Gg, Gg^Vh, Gs^Fds, Gs^Fds, Gs^Fds, Gs^Fds, Gs^Fds, Gs^Fds
Wo, Wo, Wo, Wo, Ww, Ww, Ds, Gg, Gg, Gg, Gg, Gg, Gg, Gg, Gg, Gg, Gs^Fds, Gs^Fds, Gs^Fds, Gs^Fds, Gs^Fds, Gs^Fds
