Gg, Gg, Gs^Fds, Gs^Fds, Gs^Fds, Gs^Fds, Gs^Fds, Gg, Gg, Gg, Gg, Gg, Gg, Hh, Hh, Mm, Hh, Gs^Fds, Gs^Fds, Gs^Fds, Gs^Fds, Gs^Fds, Gg, Gg, Gg, Gg, Gg, Gg, Gg, Gg, Gg, Gg, Gg, Gg, Re, Gg, Gg, Gg, Gg, Gg, Gg, Gg, Gg, Gs^Fds, Gs^Fds, Gs^Fds, Gs^Fds, Gs^Fds, Gs^Fds, Gs^Fds, Gs^Fds, Gs^Fds
Gg, Gg, Gs^Fds, Gs^Fds, Gs^Fds, Gs^Fds, Gs^Fds, Gg, Gg, Gg, Gg, Gg, Gg, Hh, Hh, Mm, Hh^Fds, Hh^Fds, Hh^Fds, Gs^Fds, Hh^Fds, Gs^Fds, Gg, Gg, Gg, Gg, Gg, Gg, Gg, Gg, Gg, Gg, Gg, Gg, Re, Gg, Gg, Gg, Ce, Gg, Gg, Gg, Gg, Gs^Fds, Gs^Fds, Gs^Fds, Gs^Fds, Gs^Fds, Gs^Fds, Gs^Fds, Gs^Fds, Gs^Fds
Gs^Fds, Gs^Fds, Gs^Fds, Gs^Fds, Gs^Fds, Gs^Fds, Gs^Fds, Gs^Fds, Gg, Gg, Gg, Gg, Gg, Gg, Gg, Gs^Fds, Gs^Fds, Hh^Fds, Hh^Fds, Gs^Fds, Hh^Fds, Gs^Fds, Gs^Fds, Gg, Gg, Gg, Gg, Gg, Gg, Gg, Gg, Gg, Gg, Gg, Gg, Re, Gg, Ce, 1 Ke, Ce, Gg, Gg, Gg, Gg, Gg^Ve, Gs^Fds, Gs^Fds, Gs^Fds, Gs^Fds, Gs^Fds, Gs^Fds, Gs^Fds
Gs^Fds, Gs^Fds, Gs^Fds, Gs^Fds, Gs^Fds, Gg, Gg, Gg, Gg, Gs^Fds, Gs^Fds, Gg^Vh, Gs^Fds, Gg, Gg, Gg, Gg, Gg, Mm, Hh, Hh, Hh^Fds, Gs^Fds, Gg, Gg, Gg, Gg, Gg, Gg, Gg, Gg, Gg, Gs^Fds, Gg, Gg, Gg^Ve, Gg, Ce, Ce, Re, Re, Gg, Gg, Gg, Gg, Gs^Fds, Gs^Fds, Gs^Fds, Gs^Fds, Gs^Fds, Gs^Fds, Gs^Fds
Gg, Gg, Gg, Gs^Fds, Gg, Gg, Gg, Gg, Gg, Gs^Fds, Gs^Fds, Gs^Fds, Gs^Fds, Gs^Fds, Gg, Gg, Gg, Gg^Ve, Hh, Mm, Hh, Gs^Fds, Gg, Gg, Gg, Gg, Gs^Fds, Gg^Vh, Gs^Fds, Gg, Gs^Fds, Gg, Gg, Gg, Gs^Fds, Gg, Gg, Gg, Gg, Gg, Re, Gg, Gg, Gg, Gs^Fds, Gg, Gs^Fds, Gs^Fds, Gs^Fds, Gg^Vh, Gs^Fds, Gs^Fds
Gg, Gg, Gg, Gg, Gg, Gg, Gg, Gg^Ecf, Gg, Gg, Gg, Gs^Fds, Gg, Gg, Gg, Gg, Gg, Gg, Gg, Gg, Gg, Gg, Gg, Gg, Gg, Gs^Fds, Gs^Fds, Gs^Fds, Gs^Fds, Gs^Fds, Gs^Fds, Gg, Gg, Gs^Fds, Gs^Fds, Gs^Fds, Gs^Fds, Gg, Gg, Gg, Gg, Gg, Gg, Gs^Fds, Gs^Fds, Gs^Fds, Gs^Fds, Gs^Fds, Gg, Gs^Fds, Gs^Fds, Gs^Fds
Gg, Gg, Gg^Vh, Gg, Gg, Gg, Gg, Gg, Gg^Ve, Gg, Gg, Gg, Gg, Gg, Gg, Gg, Gg, Gg, Gg, Gg, Gg, Gg, Gg, Gg, Gg, Gs^Fds, Hh^Fds, Gs^Fds, Gs^Fds, Gs^Fds, Gg, Gg, Gs^Fds, Gs^Fds, Gs^Fds, Gs^Fds, Gs^Fds, Gg^Ve, Gs^Fds, Gs^Fds, Gg, Re, Gg, Gs^Fds, Gs^Fds, Gs^Fds, Gs^Fds, Gs^Fds, Gs^Fds, Gs^Fds, Gs^Fds, Gs^Fds
Gg, Gg, Gg, Gg, Gg, Gg, Gs^Fds, Gg, Gs^Fms, Gg, Gg, Gg, Gg, Gg, Gg, Gg, Gg, Gg, Gg, Ss, Ss, Gg, Gg, Gg, Hh, Hh^Fds, Hh, Gs^Fds, Hh^Fds, Gs^Fds, Gs^Fds, Gs^Fds, Gg, Gs^Fds, Gs^Fds, Gs^Fds, Gs^Fds, Gs^Fds, Ss, Gs^Fds, Gs^Fds, Gg, Gs^Fds, Gs^Fds, Gs^Fds, Gs^Fds, Gs^Fds, Gs^Fds, Gs^Fds, Gs^Fds, Gs^Fds, Gs^Fds
Gg, Gg, Gg, Gg, Gs^Fds, Gs^Fms, Gs^Fms, Gs^Fms, Gs^Fms, Gs^Fms, Gs^Fms, Gs^Fp, Gs^Fp, Gg, Gg, Gg, Gg, Gg, Gg, Ss, Gg, Gg, Gg, Gg, Hh, Mm, Mm, Hh^Fds, Hh^Fds, Gs^Fds, Gs^Fds, Gs^Fds, Gs^Fds, Gs^Fds, Gs^Fds, Gs^Fds, Gs^Fds, Gs^Fds, Ss, Ss, Gs^Fds, Re, Gs^Fds, Gs^Fds, Gs^Fds, Ss, Gs^Fds, Gs^Fds, Gs^Fds, Gs^Fds, Gs^Fds, Gs^Fds
Gg, Gg, Gg, Gg, Gs^Fms, Gs^Fms, Gs^Fms, Gs^Fp, Gs^Fp, Gs^Fms, Gs^Fms, Gs^Fms, Gs^Fp, Gg, Gg, Gg, Gg, Gg, Gg, Gg, Gg, Gg, Gg, Gg, Gg^Ve, Mm, Hh, Hh, Gs^Fds, Gs^Fds, Gg, Gs^Fds, Gs^Fds, Gs^Fds, Gs^Fds, Gs^Fds, Gs^Fds, Gs^Fds, Gs^Fds, Gs^Fds, Gs^Fds, Re, Gs^Fds, Gs^Fds, Gs^Fds, Ss, Gs^Fds, Gs^Fds, Gg^Vh, Ss, Gg, Gg
Gg, Gg, Gg, Gg, Gg, Gs^Fds, Gg^Vh, Gs^Fp, Gs^Fp, Gs^Fp, Gg, Gs^Fms, Gs^Fp, Gg, Gg, Gg, Gg^Vh, Gs^Fms, Gs^Fms, Gg, Gg, Gg, Gg, Gg, Gg, Hh, Gg, Gg, Gg, Gs^Fds, Gg, Gg, Gs^Fds, Gs^Fds, Gs^Fds, Ss, Gs^Fds, Gs^Fds, Gg, Gs^Fds, Gg, Gg, Gg, Gs^Fds, Gg, Gs^Fds, Gs^Fds, Gs^Fds, Gg, Gg, Gg, Gg
Gg, Gg, Gg, Gg, Gg, Gg, Gg, Gg, Gs^Fp, Gs^Fp, Gs^Fp, Gs^Fp, Gg, Gg, Gs^Fp, Gs^Fp, Gs^Fp, Gs^Fms, Gs^Fms, Gg, Gg, Gg, Gg, Gg, Gg, Gg, Gg, Gg, Gg, Gg, Gg, Gg^Vh, Gg, Gs^Fds, Gs^Fds, Gs^Fds, Gs^Fds, Gs^Fds, Gg, Gg, Gg, Re, Gg, Gg, Gg, Gg, Gg, Ss, Ss, Ss, Ss, Ss
Gg, Gg, Gg, Gg, Gs^Fds, Gg, Gg, Gg, Gs^Fp, Gs^Fp, Gs^Fp, Gs^Fp, Gg, Gg, Gs^Fp, Gs^Fp, Gs^Fp, Gs^Fms, Gg, Gs^Fp, Gg, Gg, Gg, Gg, Gg, Gg, Gg, Gg, Gg, Gg, Gg, Gg, Gg, Gs^Fds, Gg, Gs^Fds, Gg, Gg, Ss, Gg, Gg, Re, Gg, Gg, Ss, Ss, Ss, Ss, Ss, Ss, Ss, Ss
Gg, Gg, Gg, Gg, Gs^Fds, Gs^Fms, Gs^Fp, Gg, Gg, Gs^Fp, Gg, Gs^Fp, Gg, Gg, Gs^Fms, Gs^Fms, Gs^Fp, Gs^Fp, Gs^Fp, Gs^Fp, Gg, Gg, Gg, Gg, Gs^Fms, Gs^Fds, Gs^Fds, Gg, Gg, Gg, Gg, Gg, Gg, Gg, Gg, Gg, Gg, Ss, Ss, Gg, Gg, Gg, Re, Gg^Ve, Ss, Ss, Ss, Gg, Gg, Ss, Gg, Gg
Gg, Gg, Gg, Gg, Gg, Gs^Fms, Gg, Gg, Gg, Gg, Gg, Ce, Ce, Gg, Gg, Gs^Fds, Gs^Fms, Gg, Gs^Fp, Gs^Fms, Gg, Gg, Gg, Gg, Gg, Gs^Fms, Gs^Fds, Gg, Gg, Gg, Gg, Gg, Gs^Fds, Gg, Gs^Fds, Gg, Gg, Ss, Gg, Gg, Gg, Gg, Gg, Re, Gg, Gg, Gg, Gg, Gg, Ss, Ww, Ww
Gg, Gg, Gg, Gg, Gg, Gg, Gg, Gg, Gg, Gg, Ce, 6 Ke, Re, Gg, Gg, Gs^Fms, Gs^Fms, Gs^Fms, Gs^Fms, Gs^Fms, Gg, Gg, Gg, Gg, Gs^Fds, Gs^Fds, Gg, Gg, Gg, Gg, Gs^Fds, Gs^Fds, Gs^Fds, Gs^Fds, Gs^Fds, Gs^Fds, Gs^Fds, Gg, Gg^Ve, Gg, Gg, Gg, Gg, Re, Gg, Gg, Ss, Gg, Ww, Ww, Ww, Ww
Ds, Ds, Ww, Gg, Ds, Gg, Ds, Gg, Gg, Gg, Gg, Ce, Gg, Re, Gg, Gs^Fds, Gg, Gs^Fds, Gs^Fms, Gg^Ve, Gg, Gg, Gg, Gg, Gs^Fms, Gs^Fms, Gg, Gg, Gg, Gg^Ve, Gs^Fds, Gs^Fds, Gs^Fds, Ss, Gs^Fds, Gs^Fds, Gs^Fds, Gs^Fds, Gg, Gg, Gg, Gg, Ww, Re, Gg, Gg, Ww, Ww, Ww, Ww, Gg, Gg
Ww, Ww, Ww, Ww, Ww, Ds, Ds, Gg^Vh, Gg, Gg, Gs^Fds, Gs^Fds, Gg, Re, Re, Gg, Gg, Gs^Fms, Gg, Gg, Gg, Gg^Ecf, Gg, Gg, Gg, Gs^Fds, Gg, Gg, Gg, Gg, Ss, Gs^Fds, Gg, Gs^Fds, Gg, Gs^Fds, Gs^Fds, Gs^Fds, Gg, Gg, Ww, Ww, Ww, Ww^Bw|, Ww, Ww, Ww, Ww, Gs^Fds, Gs^Fds, Gg^Vc, Gg
Ww, Ww, Wo, Ww, Ww, Ww, Ww, Ds, Gg, Gg, Gg, Gs^Fds, Gg, Gg, Gg, Re, Re, Gg, Re, Gg, Re, Gg, Gg, Gg, Gg, Gg, Gg, Gg, Gg, Ss, Ss, Ss, Gg, Gg, Ss, Ss, Gg, Gg, Ww, Ww, Ww, Ww, Gg, Ww^Bw|, Ww, Ww, Ww, Gs^Fds, Gs^Fds, Gs^Fds, Gg, Gg
Wo, Wo, Wo, Wo, Wo, Ww, Ww, Ww^Bw/, Gg, Gg, Gg, Gg, Gg, Gg, Gs^Fds, Gs^Fms, Gg^Vh, Re, Gg, Re, Gg, Re, Re, Gg, Gg, Gg, Gg, Gg, Gg, Ss, Ss, Ss, Gg, Gg, Ss, Ss, Ss, Gg, Ww, Ww, Gg, Gg, Gg^Vc, Re, Gg, Gg, Gg, Gs^Fds, Gs^Fds, Gs^Fds, Gs^Fds, Gs^Fds
Wo, Wo, Wo, Wo, Wo, Ww, Ww, Ww, Gg, Gg, Gg, Gg, Gg, Gg, Gs^Fds, Gs^Fms, Gs^Fds, Gg, Gg, Gg, Gg, Gg, Gg, Re, Gg, Gg^Vh, Gg, Gg, Ww, Gg, Ww, Gg, Ww, Ss, Gg, Gg, Ww, Ww, Ww, Ww, Gg, Gg, Re, Re, Gg, Ss, Gs^Fds, Gs^Fds, Gs^Fds, Gs^Fds, Gs^Fds, Gs^Fds
Wo, Wo, Wo, Wo, Wo, Ww, Ww, Ww, Ww, Gg, Gg^Ve, Gg, Gg, Gg, Gg, Gg^Ecf, Gs^Fds, Gg, Gg, Gg, Gg, Gg, Gg, Re, Gg, Gg, Gg, Gg, Ww, Ww, Ww, Ww, Ww, Ww, Ww, Ww, Ww, Ww, Gg, Gg, Gg, Gg, Re, Gg, Gg, Gg, Gs^Fds, Gs^Fds, Gs^Fds, Gs^Fds, Gs^Fds, Gs^Fds
Wo, Wo, Wo, Wo, Wo, Ww, Ww, Ww, Ww, Ww, Ww, Gg, Gg, Gg, Gg, Gg, Gg, Gg, Gg, Gg, Ww, Ww, Ww, Ww^Bw|, Ww, Ww, Ww, Gg, Ww, Ww, Gg, Ww, Ww, Ww, Gg, Ww, Gg, Gg, Gs^Fds, Gs^Fds, Gg^Vc, Gg, Re, Gg, Gs^Fds, Gg, Gs^Fds, Gs^Fds, Gg^Vc, Gs^Fds, Gs^Fds, Gs^Fds
Wo, Wo, Wo, Wo, Wo, Wo, Ww, Ww, Ww, Ww, Ww, Ww, Ww, Gg, Ds, Gg, Gg, Gg, Ww, Ww, Ww, Ww, Ww, Ww^Bw|, Ww, Ww, Ww, Ww, Ww, Ww, Gg, Gg, Gg, Ww, Ww, Gg, Ss, Gg, Ss, Gs^Fds, Gs^Fds, Gg, Re, Gs^Fds, Gs^Fds, Gs^Fds, Gg^Ecf, Gg, Gg, Gs^Fds, Gg, Gg
Wo, Wo, Wo, Wo, Wo, Wo, Wo, Ww, Ww, Ww, Wo, Ww, Ww, Ww, Ww, Ww, Ww, Ww, Ww, Ww, Ww, Ww, Gg, Re, Gg, Gg, Gg, Ww, Gg, Ww, Gg, Gs^Fds, Gg, Ww, Ww, Gg, Gg, Gg, Ss, Ss, Gs^Fds, Gg^Ecf, Gg, Re, Gs^Fds, Gs^Fds, Gg, Gg, Gs^Fds, Gs^Fds, Gs^Fds, Gs^Fds
Wo, Wo, Wo, Wo, Wo, Wo, Wo, Ww, Ww, Wo, Wo, Wo, Wo, Ww, Wo, Ww, Ww, Ww, Ww, Ww, Gs^Fds, Gg, Gg, Re, Gg^Vc, Gg, Gg, Gg, Gg, Gg, Gg, Gs^Fds, Gg, Ww, Ww, Ww, Gg, Ss, Ss, Ss, Gg, Gg, Gg, Re, Gg, Gg, Gg, Gg, Ss, Gs^Fds, Gs^Fds, Gs^Fds
Wo, Wo, Wo, Wo, Wo, Wo, Ww, Ww, Ww, Wo, Wo, Wo, Wo, Wo, Wo, Wo, Ww, Ww, Gg, Gs^Fds, Gs^Fds, Gs^Fds, Gg, Re, Gg, Gg, Gg, Gg, Gs^Fds, Gg, Gg, Gg, Gg, Gg, Ww, Ww, Ww, Gg, Ww, Gg, Ce, Ce, Re, Re, Re, Gg, Gs^Fds, Ss, Ss, Gs^Fds, Gs^Fds, Gs^Fds
Wo, Wo, Wo, Wo, Wo, Ww, Gg^Vc, Ww, Ww, Wo, Wo, Wo, Wo, Wo, Wo, Ww, Ww, Gg, Gg, Gs^Fds, Gg^Vc, Gs^Fds, Re, Re, Gg, Gg, Gg, Gs^Fds, Gs^Fds, Gs^Fds, Gs^Fds, Gg, Gg, Gg, Gg^Vc, Ww, Ww, Ww, Ww, Ww^Bw/, Gg, 5 Ke, Ce, Gg, Re, Gg^Vc, Gs^Fds, Gs^Fds, Gs^Fds, Gs^Fds, Gs^Fds, Gs^Fds
Wo, Wo, Wo, Wo, Wo, Ww, Gs^Fds, Gs^Fds, Ww, Wo, Wo, Wo, Wo, Wo, Wo, Ww, Ww, Ww, Ds, Gg, Gg, Gg, Re, Gg, Gg, Gg, Gg, Gs^Fds, Gg^Vc, Gs^Fds, Gs^Fds, Gg, Gg, Gg, Gg, Gg, Gg, Ww, Ww, Ww, Gg, Ce, Gg, Gg^Vc, Re, Gg, Gs^Fds, Gs^Fds, Ss, Gs^Fds, Ss, Ss
Wo, Wo, Wo, Wo, Wo, Ww, Ww, Ww, Wo, Wo, Wo, Wo, Wo, Wo, Wo, Ww, Ww, Ww, Ds, Gg, Gg, Gg, Re, Gg, Gg^Ecf, Gg, Gg, Gs^Fds, Gs^Fds, Gs^Fds, Gs^Fds, Gg, Gg, Gg, Gg, Gg, Gg, Ww, Ww, Ww, Ww, Gg, Gg, Gg, Re, Gg^Ecf, Gg, Gs^Fds, Gs^Fds, Ss, Ss^Vhs, Ss
Wo, Wo, Wo, Wo, Wo, Wo, Ww, Ww, Ww, Wo, Wo, Wo, Wo, Wo, Ww, Ww, Ww^Vm, Ww, Ww, Ds, Gg, Gg, Re, Gg, Gg, Gg, Ce, Gs^Fds, Gs^Fds, Gs^Fds, Gg, Gs^Fds, Gs^Fds, Gg, Gg, Gg, Gg, Gg, Gg, Ww, Ww, Ww, Ww^Bw/, Re, Ww, Gg, Gg, Gg, Gg, Gs^Fds, Gs^Fds, Ss
Wo, Wo, Wo, Wo, Wo, Wo, Ww, Ww, Ww, Ww, Wo, Wo, Wo, Wo, Ww, Ww, Ww, Ww, Ww, Ds, Ds, Gg, Re, Gg, Gg, Ce, 4 Ke, Gg, Gs^Fds, Gs^Fds, Gs^Fds, Gs^Fds, Gs^Fdw, Gs^Fdw, Gs^Fdw, Ss, Gs^Fdw, Gg, Gg, Gg, Re, Ww^Bw/, Ww, Ww, Ww, Ww, Ww, Gg, Gg, Gs^Fds, Gs^Fds, Gs^Fds
Wo, Wo, Wo, Wo, Wo, Wo, Ww, Ww, Ww, Ww, Ww, Ww, Ww, Ww, Ww, Ww, Wo, Ww, Ww, Ww, Ds, Gg^Vc, Gg, Re, Re, Re, Ce, Ce, Gs^Fds, Gs^Fds, Gs^Fdw, Ss, Gs^Fdw, Rb^Fdw, Rb^Fdw, Rb^Fdw, Rb^Fdw, Rb^Vc, Gg, Gg, Re, Rb, Rb, Ww, Rb, Ww, Ww, Ww, Ww, Gg, Ww, Ww
Wo, Wo, Wo, Wo, Wo, Ww, Ww, Ww, Ww, Ww, Ww, Ww, Ww, Ww, Wo, Wo, Wo, Wo, Ww, Ww, Ww, Gg, Gg, Gg, Re, Gg, Gg, Gg, Gg, Gs^Fdw, Rb^Fdw, Rb^Fdw, Gg, Rb^Fdw, Rb, Rb^Fdw, Rb, Gg, Rb, Re, Rb^Vc, Rb, Rb, Ss, Rb^Vc, Rb, Ss, Ww, Ww, Ww, Ww, Ww
Wo, Wo, Wo, Wo, Wo, Ww, Ww, Ww, Ww, Gg^Ve, Gs^Fds, Ww, Ww, Ww, Wo, Wo, Wo, Wo, Wo, Wo, Wo, Ww, Ww, Gg, Gg, Re, Re, Gg, Rb^Vc, Gg, Gg, Rb, Ss, Rb, Re, Rb, Re, Ss, Rb, Re, Rb, Ss, Rb, Rb, Ss, Rb, Ss, Rb, Rb, Ww, Rb, Rb
Wo, Wo, Wo, Wo, Wo, Ww, Ww, Ww, Hh, Gs^Fds, Ch, Gs^Fds, Ww, Ww, Wo, Wo, Wo, Wo, Wo, Wo, Ww, Ww, Ww^Bw\, Ds, Gg, Gg, Re, Re, Re, Rb, Rb, Rb, Re, Re, Rb, Re, Rb, Re, Re, Re, Re, Rb, Rb, Rb, Rb, Ss, Ss, Ss, Rb, Rb, Rb^Vc, Rb
Wo, Wo, Wo, Wo, Wo, Wo, Ww, Hh, Mm, Mm, 3 Kh, Ww, Ww, Wo, Wo, Wo, Wo, Wo, Wo, Wo, Ww, Ww, Ww, Ds, Re, Gg, Re, Gg^Ecf, Rb, Re, Re, Re, Rb, Rb, Rb, Rb, Ss, Rb, Rb, Rb, Rb, Urb, Urb, Rb, Rb, Ss, Rb^Vc, Ss, Rb, Rb, Rb, Rb
Wo, Wo, Wo, Wo, Wo, Ww, Ww^Bw/, Ds, Mm, Ch, Hh, Ch, Gs^Fds, Ww, Ww, Wo, Wo, Wo, Wo, Wo, Wo, Ww, Ww^Bw\, Ds, Gg, Re, Gg, Gg, Gs^Fdw, Ss, Re, Hhd, Mm, Hhd, Rb, Ss, Ss, Rb^Vc, Rb, Rb, Qxe, Cud, Urb, Cud, Qxe, Rb, Rb, Rb, Ss, Rb, Rb, Rb
Wo, Wo, Wo, Wo, Wo, Ww, Ww, Ds, Hh, Mm, Mm, Gs^Fds, Gg^Vc, Ww, Ww, Ww, Ww, Wo, Wo, Wo, Ww, Ww, Ww, Ds, Ds, Gg, Gs^Fds, Gs^Fdw, Rb, Rb, Re, Hhd, Mm, Mm, Rb, Ss, Rb, Rb, Rb, Qxe, Cud, Cud, Urb, Cud, Cud, Qxe, Rb, Rb, Rb^Fdw, Rb^Fdw, Ss, Ss
Wo, Wo, Wo, Wo, Wo, Ww, Ww, Ds, Gg, Hh, Gs^Fds, Gs^Fds, Ww, Ww, Ww, Ww, Ww, Ww, Ww, Ww, Ww, Ww, Ww, Ww, Ds, Gg, Gs^Fds, Gs^Fdw, Gg, Re, Rb, Hhd, Ss, Hhd, Rb, Rb, Ss, Rb, Qxe, Cud, Urb, Ss, Urb, Ss, Urb, Cud, Qxe, Rb, Rb^Vc, Ss, Ss, Ss
Wo, Wo, Wo, Wo, Wo, Wo, Ww, Ww, Ww, Gg^Vc, Gs^Fds, Ww, Wo, Ww, Ww, Ww, Ww, Ww, Wo, Ww, Wo, Ww, Ww, Ww^Bw\, Ds, Gs^Fds, Gs^Fds, Gs^Fds, Rb, Re, Rb, Rb, Rb^Fdw, Rb^Fdw, Rb, Rb, Rb, Rb, Qxe, Cud, Ss, Cud, 2 Kud, Cud, Ss, Cud, Qxe, Rb, Rb, Rb^Fdw, Rb, Rb
Wo, Wo, Wo, Wo, Wo, Wo, Wo, Ww, Wo, Ww, Ww, Ww, Wo, Wo, Wo, Wo, Wo, Wo, Wo, Wo, Wo, Wo, Wo, Ww, Ww, Ds, Gg, Gg, Rb^Vc, Re, Gg, Rb^Fdw, Rb^Fdw, Hhd^Fdw, Hhd^Fdw, Rb^Fdw, Rb, Rb, Qxe, Cud, Urb, Cud, Cud, Cud, Urb, Cud, Qxe, Rb, Rb, Rb, Rb, Rb
Wo, Wo, Wo, Wo, Wo, Wo, Wo, Wo, Wo, Wo, Wo, Wo, Wo, Wo, Wo, Wo, Wo, Wo, Wo, Wo, Wo, Wo, Ww, Ww, Ww, Ds, Ds, Gg, Re, Re, Gs^Fdw, Gs^Fdw, Rb^Fdw, Hhd^Fdw, Mm, Hhd^Fdw, Ss, Rb, Rb, Cud, Cud, Ss, Urb, Ss, Cud, Cud, Rb, Rb, Rb, Ss, Ss, Rb
Wo, Wo, Wo, Wo, Wo, Wo, Wo, Wo, Wo, Wo, Wo, Wo, Wo, Wo, Wo, Wo, Wo, Wo, Wo, Wo, Wo, Wo, Ww, Ww, Ww, Ww, Ds, Gg, Re, Gg, Gg, Gs^Fdw, Gs^Fdw, Hhd, Mm, Hhd, Hhd, Rb, Rb, Qxe, Qxe, Cud, Cud, Cud, Qxe, Qxe, Rb, Rb, Rb^Vc, Ss, Rb, Rb
Wo, Wo, Wo, Wo, Wo, Wo, Wo, Wo, Wo, Wo, Wo, Wo, Wo, Wo, Wo, Wo, Wo, Wo, Wo, Wo, Wo, Wo, Wo, Ww, Ww^Bw\, Ww, Ds, Re, Gg, Gg, Gg, Gg, Gs^Fdw, Hhd, Hhd, Mm, Mm, Rb^Vc, Rb, Rb, Rb, Qxe, Rb, Qxe, Rb, Rb, Rb^Fdw, Rb^Fdw, Rb^Fdw, Rb^Fdw, Rb^Fdw, Rb^Fdw
Wo, Wo, Wo, Wo, Wo, Wo, Wo, Wo, Wo, Wo, Wo, Wo, Wo, Wo, Wo, Wo, Wo, Wo, Wo, Wo, Wo, Wo, Ww, Ww, Ww, Ds, Gg, Gg, Gg, Gg, Gg, Gg, Gg, Gg^Vc, Gg, Mm, Mm, Hhd, Hhd, Rb, Ss, Rb, Rb, Rb, Rb, Rb^Fdw, Rb^Fdw, Rb^Fdw, Rb^Fdw, Rb, Rb^Fdw, Rb^Fdw
Wo, Wo, Wo, Wo, Wo, Wo, Wo, Wo, Wo, Wo, Wo, Wo, Wo, Wo, Wo, Wo, Wo, Wo, Wo, Wo, Wo, Wo, Ww, Ww, Ww, Ds, Gg, Gg, Gg, Gg, Gg, Gg, Gg, Gg, Gg, Mm, Mm, Hhd, Hhd, Ss, Ss, Rb, Rb, Rb, Rb, Rb^Fdw, Rb^Fdw, Rb^Fdw, Rb^Fdw, Rb, Rb^Fdw, Rb^Fdw
