Gs, Gg, Gg, Gg, Gs, Gs, Gs, Gs, Gg, Gg, Gg, Gg, Gg, Rb, Gg, Gg, Gs, Gs, Gg, Gg, Ss, Gg, Ss, Gg, Gg, Ss, Gg, Ss, Ww, Ds, Ww, Ww, Ds, Gg, Gg, Gg, Gg, Gg, Gg, Ss, Gg, Gg, Ss, Ss, Gg, Ss
Gs, Gs, Gs, Gs, Gg, Gg, Gs, Gs, Gg, Gg, Gg, Gg, Gg, Rb, Gg, Gg, Gg, Gg, Ss, Gg, Gg, Gg, Gg, Ss, Sm, Ss, Ww, Ww, Ss, Ww, Ww, Gg, Gg, Gg, Gg, Gg, Gg, Gg, Ss, Ss, Gg, Ss, Ss, Gg, Ss, Gg
Gg, Gs, Gg, Gg, Ss, Gs, Gg, Gg, Gg, Gg, Gg, Gg, Gg, Rb, Gg, Gg, Gg, Ss, Ww, Ww, Ww, Wo, Wo, Wo, Wo, Ww, Ss, Ss, Ss^Vm, Wwf, Ww, Gg, Ss, Ss, Ss, Ss, Gg, Ss, Gg, Gg, Ss, Gg^Efm, Gg, Ss, Ss, Gg
Ss, Gg, Gg, Gg, Gg, Ss, Ss, Gg, Ss, Ss, Gs, Gg, Ww, Rb, Ww, Ww, Wwf, Ww, Ss, Gg, Gg, Gg, Gg, Ss, Wo, Gg, Ss, Gg, Gg, Wo, Ss, Sm, Gg, Gg, Ss, Gg^Efm, Gg, Ss, Ss, Gg, Gg, Gg, Gg, Gg, Ss, Ss
Ss, Ss, Gg, Ss, Ss, Gg, Ss, Gg, Gg, Ss, Wwf, Ww, Ww, Wwf, Gg, Gg, Gg, Gg, Gg, Gg, Gg, Gg, Ww, Wo, Gg, Ss, Gg, Gg, Ss, Ww, Ss, Ss, Ss, Ss, Gg, Ss, Gg, Gg, Gg, Ss, Ss, Ww, Gs^Vc, Ss, Gg, Ss
Gg, Ss, Gg, Gg, Ss, Ss, Gg, Gg, Ww, Wo, Gg, Gg, Gg, Rb, Gg, Ss, Gg, Ss, Ss, Ss, Gg, Ww, Ww, Gg, Ss, Gg, Ds, Gg, Ww, Ww, Gg, Gg, Ss, Gg, Gg, Gg, Ss, Gg, Gg, Ss, Gg, Gg, Wo, Ww, Ww, Ww
Gg, Gg, Ww, Ww, Ww, Wwg, Ww, Ww, Gg, Gg, Ss, Gg, Gg, Re, Gg, Ss, Ss, Gg, Gg, Ss, Gg, Ww, Gg, Gg, Chs, 1 Khs, Chs, Ss, Ww, Ss, Ss, Ss, Ss, Gg, Gg, Ss, Ss, Sm, Ss, Ss, Ww, Ww, Gg, Wo, Ss, Ss
Wwf, Ww, Ss, Ww, Gg^Efm, Sm, Ww, Ww, Gs, Ss, Gg, Ss, Ss, Rb, Gg, Ss, Gg, Ss, Ss, Ds, Ww, Wwf, Gg, Ss, Gg, Chs, Gg, Ww, Ww, Ww, Ww, Ss, Sm, Ss, Gg, Ss, Wo, Wo, Ww, Ww, Ss, Ss, Ss, Sm, Ss, Gg
Ds, Ss, Gg, Gg, Ss, Ss, Ww, Gg, Gg, Ss, Ss, Ss, Gg, Rb, Ss, Ss, Ss, Sm, Ss, Ss, Ww, Wo, Gg, Ss, Ss, Gg, Gg^Efm, Gg, Ww, Ww, Ww, Ss, Ss, Ss, Ww, Wo, Ss, Ss, Ss, Gg, Gg, Gg, Gg, Gg, Gg, Gg
Ww, Ds, Ss, Gg, Gg, Ss, Ww, Gg, Gg, Ss, Ss, Gg^Efm, Gg, Rb, Gg, Ss, Ss, Ss^Vm, Sm, Gg, Wo, Ww, Gg, Ss, Ss, Ss, Ss, Ss, Ww, Ww, Wo, Ww, Ww, Ww, Ss, Gg, Gg, Ss, Ss, Gg, Gg, Gg, Gs, Gs, Gg, Gg
Ww, Ww, 5 Kme, Ww, Ww, Ww, Gg, Gg, Ss, Ss, Ss^Vm, Ss, Ss, Rb, Gg, Gg, Ss, Ss, Ss, Wwf, Ww, Gg, Ss, Gg, Gg, Ss, Ss, Gg, Ss, Ww, Wo, Ww, Ww, Ss, Ss, Gg, Ss, Ss, Gg, Gg, Gs, Gs, Gg, Gg, Gg, Hh
Ww, Cme, Cme, Cme, Ww, Wwf, Gg, Ss, Ss, Ss, Ss, Ss, Gg, Rb, Rb, Ss, Ss, Gg, Gg, Gg, Ww, Ss, Ss, Ss, Ss, Ss, Ss, Wwf, Ss, Wo, Ww, Wo, Ww, Ww, Ww, Gg, Gg, Gg, Gg, Gg, Gs, Gg, Gs, Gg, Hh, Gs
Ww, Ww, Ww, Ww, Ww, Ds, Gg, Ss, Gg, Ss, Ss, Gg, Ss, Ss, Rb, Gg, Ss, Ss, Gg, Wo, Gg, Ss, Gg, Gg, Ss, Gg, Ss, Ss, Ss, Gg, Wo, Wo, Ww, Ww, Ww, Ww, Gg, Gg, Gs, Gg, Gg, Gs, Gs^Es, Gs, Hh, Hh
Wwr, Wwr, Wwr, Ww, Ww, Ds, Ds, Gg, Gg, Gg, Ss, Ss, Ss, Gg, Rb, Ss, Ss, Ss, Ds, Wo, Gg, Gg, Gg, Gg, Ds, Ss, Ss, Gg, Gg, Gg, Ww, Ww, Ww, Wo, Ww, Ww, Ds, Dd, Gg, Gs, Gg, Hh, Hh, Gs, Ds, Ds
Ww, Ww, Wwr, Ww, Ww, Ww, Ww, Ds, Ss, Ss, Gg, Ss, Ss, Gg, Rb, Gg, Gg, Ww, Ww, Wo, Gg, Gg, Ww, Ds, Ww^Vm, Ww, Ds, Ss, Gg, Ss, Wwf, Ww, Ww, Wo, Ww, Ww, Ww, Dd, Gs, Gs, Gs, Hh, Ds, Ds, Ww, Ww
Ww, Ww, Ww, Wwr, Ww, Ww, Ww, Ww, Ww, Ss, Ss, Gg, Ss, Ss, Rb, Gg, Ds, Ss, Ww, Wwf, Wo, Ww, Gg, Ww, Ww, Ww, Ww, Ww, Ds, Ww, Wo, Ww, Ww, Wo, Ww, Ww, Ww, Gg, Gs, Dd, Ds, Ds, Ww, Ww, Ww, Ww
Wwr, Wwr, Ww, Ww, Wwr, Ww, Wwf, Ww, Ds, Gg, Gg, Gg, Gg, Gg, Rb, Ds, Ww, Ww, Gg, Ss, Wo, Ww, Ww, Ww, Ww, Ww, Wwr, Ww, Ww, Wwf, Wo, Ww, Wo, Wo, Wo, Ww, Gs, Gs, Gs, Dd, Ds, Ww, Ww, Ww, Ww, Ww
Wo, Wo, Wo, Ww, Wwr, Ww, Ww, Wwf, Ds, Gg, Gg, Gs, Gs, Re, Gg, Gg, Ww, Ww, Ww, Ww, Ww, Wwf, Ww, Ww, Wwr, Ww, Ww, Wwr, Ww, Wwf, Wo, Ww, Wo, Wo, Ww, Ww, Ds, Gg, Gg, Ds, Ww, Ww, Ww, Ww, Ww, Ww
Wo, Wo, Ww, Wo, Ww^Vm, Ww, Ww, Ww, Ww, Gg, Gg, Gs, Gg, Rb, Gg, Wwf, Wwf, Ww, Gg, Ww, Ww, Ww, Ww, Ww, Ww, Wwr, Ww, Ww, Ww, Ww, Wo, Ww, Ww, Wo, Wo, Ww, Ww, Gs^Vc, Hh, Ww, Ww, Ww, Ww, Ww, Hh, Hh
Wo, Wo, Wo, Wwr, Wo, Ww, Wo, Ww, Wwf, Ds, Ww, Wwf, Rb, Re, Gg, Wwf, Gs^Vc, Ww, Gg, Gs, Ww, Gg, Ww, Ww, Ww, Ww, Ww, Wwr, Ww, Ww, Ww, Ww, Ww, Ww, Ww, Ww, Ww, Ww, Ww, Ww, Ww, Ww, Ww, Ww, Hh, Ww
