Hh, Hh, Hh, Hh, Hh, Hh, Hh, Hh, Hh, Hh, Hh, Hh, Hh^Fp, Hh^Fp, Hh^Fp, Hh^Fp, Hh, Hh, Hh, Hh, Hh, Hh, Hh, Hh, Hh, Hh, Hh, Hh, Rb, Hh, Hh, Hh, Hh, Hh, Hh, Hh, Hh, Hh, Hh, Hh, Hh
Hh, Hh, Hh, Hh, Hh, Hh, Hh, Hh, Hh, Hh, Hh, Hh, Hh^Fp, Hh^Fp, Hh^Fp, Hh^Fp, Hh, Hh, Hh, Hh, Hh, Hh, Hh, Hh, Hh, Hh, Hh, Hh, Rb, Hh, Hh, Hh, Hh, Hh, Hh, Hh, Hh, Hh, Hh, Hh, Hh
Hh^Fp, Hh^Fp, Hh^Fp, Hh^Fp, Hh^Fp, Hh, Hh^Fp, Hh, Hh^Fp, Hh^Fp, Hh^Fp, Hh^Fp, Hh^Fp, Hh^Fp, Hh^Fp, Hh^Fp, Hh^Fp, Hh^Fp, Hh^Fp, Hh^Fp, Hh^Fp, Hh, Hh, Hh, Hh, Hh, Hh, Rb, Hh, Hh, Hh, Hh, Hh, Hh, Hh, Hh, Hh, Hh, Hh^Fp, Hh^Fp, Hh^Fp
Mm, Hh^Fp, Mm, Hh^Fp, Hh^Fp, Hh^Fp, Hh^Fp, Hh^Fp, Hh^Fp, Hh^Fp, Hh^Fp, Hh^Fp, Hh^Fp, Hh^Fp, Hh^Fp, Hh^Fp, Mm, Mm, Mm, Hh^Fp, Hh^Fp, Hh^Fp, Hh, Hh, Hh, Hh, Hh, Rb, Hh, Hh, Hh, Hh, Hh, Hh, Hh, Hh, Hh, Hh^Fp, Mm, Mm, Mm
Mm, Mm, Mm, Mm, Mm, Hh^Fp, Hh^Fp, Hh^Fp, Hh^Fp, Hh^Fp, Hh^Fp, Hh^Fp, Hh^Fp, Hh^Fp, Hh^Fp, Mm, Mm, Mm, Mm, Hh^Fp, Hh^Fp, Hh^Fp, Hh^Fp, Hh, Hh, Hh, Hh, Rb, Hh, Hh, Hh, Hh, Hh, Hh, Hh, Hh, Hh^Fp, Hh^Fp, Mm, Mm, Mm
Xu, Mm, Mm, Mm, Mm, Mm, Mm, Mm, Mm, Mm, Mm, Mm, Mm, Mm, Mm, Mm, Mm, Mm, Mm, Hh^Fp, Hh^Fp, Hh^Fp, Hh^Fp, Hh, Hh, Hh^Fp, Hh^Fp, Rb, Hh, Hh, Hh, Hh, Hh^Fp, Hh, Hh^Fp, Hh^Fp, Mm, Mm, Mm^Xm, Mm, Mm
Xu, Xu, Xu, Mm, Mm, Mm, Mm, Mm, Mm, Mm, Mm, Mm, Mm, Mm, Mm, Mm, Mm, Mm, Hh^Fp, Hh^Fp, Hh^Fp, Hh^Fp, Hh^Fp, Hh, Hh^Fp, Hh^Fp, Hh^Fp, Hh, Hh, Hh, Hh^Fp, Hh, Hh^Fp, Hh^Fp, Hh^Fp, Mm, Mm, Mm, Mm^Xm, Mm^Xm, Mm
Xu, Xu, Xu, Xu, Xu, Xu, Xu, Xu, Xu, Xu, Xu, Mm, Mm, Mm, Mm, Mm, Mm, Mm, Hh^Fp, Hh^Fp, Hh^Fp, Hh^Fp, Hh^Fp, Hh^Fp, Hh^Fp, Hh^Fp, Hh, Rb, Hh, Hh^Fp, Hh^Fp, Hh^Fp, Hh^Fp, Hh^Fp, Mm, Mm, Mm, Mm^Xm, Mm^Xm, Mm^Xm, Mm^Xm
Xu, Xu, Xu, Xu, Xu, Xu, Xu, Xu, Xu, Xu, Xu, Xu, Xu, Mm, Mm, Mm, Mm, Hh^Fp, Hh^Fp, Hh^Fp, Hh^Fp, Hh^Fp, Hh^Fp, Hh^Fp, Hh^Fp, Hh^Fp, Hh, Rb, Hh, Hh^Fp, Hh^Fp, Hh^Fp, Hh^Fp, Mm, Mm, Mm, Mm^Xm, Mm^Xm, Mm^Xm, Mm^Xm, Mm^Xm
Xu, Xu, Xu, Xu, Xu, Xu, Xu, Xu, Xu, Xu, Xu, Xu, Xu, Xu, Mm, Mm, Mm, Hh^Fp, Hh, Hh, Hh, Hh^Fp, Hh, Hh, Rb, Rb, Hh, Hh, Hh^Fp, Hh^Fp, Hh^Fp, Hh^Fp, Mm, Mm, Mm, Mm^Xm, Mm^Xm, Mm^Xm, Mm^Xm, Mm^Xm, Mm^Xm
Xu, Xu, Xu, Xu, Xu, Xu, Xu, Xu, Xu, Xu, Xu, Xu, Xu, Xu, Mm, Mm, Hh^Fp, Hh^Fp, Hh, Hh, Hh, Hh, Hh^Fp, Hh, Rb, Hh, Hh, Hh^Fp, Hh^Fp, Hh^Fp, Hh^Fp, Hh^Fp, Mm, Mm, Mm^Xm, Mm^Xm, Mm^Xm, Mm^Xm, Mm^Xm, Mm^Xm, Mm^Xm
Xu, Xu, Xu, Xu, Xu, Xu, Xu, Xu, Xu, Xu, Xu, Xu, Mm, Mm, Mm, Hh^Fp, Hh^Fp, Hh^Fp, Hh^Fp, Hh, Hh, Hh, Hh^Fp, Hh, Rb, Hh, Hh^Fp, Hh^Fp, Hh^Fp, Hh^Fp, Hh^Fp, Hh^Fp, Mm, Mm, Mm^Xm, Mm^Xm, Mm^Xm, Mm^Xm, Mm^Xm, Mm^Xm, Mm^Xm
Mm^Xm, Xu, Xu, Xu, Xu, Xu, Xu, Xu, Xu, Xu, Xu, Xu, Mm, Mm, Mm, Hh^Fp, Hh^Fp, Hh^Fp, Hh^Fp, Hh, Hh, Hh^Fp, Hh^Fp, Hh^Fp, Rb, Hh, Hh^Fp, Hh^Fp, Hh^Fp, Hh^Fp, Hh^Fp, Hh^Fp, Mm, Mm, Mm^Xm, Mm^Xm, Mm^Xm, Mm^Xm, Mm^Xm, Mm^Xm, Mm^Xm
Mm^Xm, Xu, Xu, Xu, Xu, Xu, Uu, Xu, Uu, Xu, Xu, Xu, Mm, Mm, Mm, Hh^Fp, Hh^Fp, Hh^Fp, Hh^Fp, Hh, Hh^Fp, Hh^Fp, Hh^Fp, Hh, Hh, Hh, Hh^Fp, Hh^Fp, Hh, Hh^Fp, Hh^Fp, Hh^Fp, Mm, Mm, Mm^Xm, Mm^Xm, Mm^Xm, Mm^Xm, Mm^Xm, Mm^Xm, Mm^Xm
Xu, Mm^Xm, Mm^Xm, Uu, Uu, Uu, Xu, Uu, Xu, Uu, Xu, Xu, Xu, Mm, Mm, Mm, Hh^Fp, Hh^Fp, Hh^Fp, Hh^Fp, Hh^Fp, Hh^Fp, Hh, Hh, Rb, Hh, Hh, Hh, Hh, Hh, Hh^Fp, Mm, Mm, Mm, Mm, Mm^Xm, Mm^Xm, Mm^Xm, Mm^Xm, Mm^Xm, Mm^Xm
Uu, Uu, Mm^Xm, Xu, Xu, Xu, Xu, Xu, Xu, Uu, Uu, Xu, Xu, Mm, Mm, Mm, Hh^Fp, Hh^Fp, Hh^Fp, Hh, Hh, Hh, Hh^Fp, Hh, Rb, Hh, Hh^Fp, Hh, Hh, Hh^Fp, Hh^Fp, Mm, Mm, Mm, Mm, Mm^Xm, Mm^Xm, Mm^Xm, Mm^Xm, Mm^Xm, Mm^Xm
Xu, Xu, Xu, Xu, Uu^Vud, Xu, Uu, Xu, Xu, Xu, Xu, Uu, Xu, Xu, Mm, Mm, Mm, Hh^Fp, Hh^Fp, Hh^Fp, Hh, Hh, Hh^Fp, Hh^Fp, Hh, Rb, Rb, Hh, Hh^Fp, Hh^Fp, Hh^Fp, Mm, Mm, Mm, Mm, Mm^Xm, Mm^Xm, Mm^Xm, Mm^Xm, Mm^Xm, Mm^Xm
Uu, Uu, Uu, Uu, Uu, Uu, Re, Xu, Xu, Xu, Xu, Uu, Uu, Xu, Mm, Mm, Hh, Hh^Fp, Hh, Hh, Hh, Hh, Hh^Fp, Hh^Fp, Hh^Fp, Hh, Hh, Rb, Hh, Hh^Fp, Hh^Fp, Hh^Fp, Hh^Fp, Hh^Fp, Mm, Mm, Mm, Mm^Xm, Mm, Mm, Mm
Xu, Re, Re, Uu, Ch, Uu, Uu, Re, Re, Xu, Xu, Xu, Xu, Mm, Mm, Hh, Mm, Hh, Hh^Fp, Hh^Fp, Hh^Fp, Hh^Fp, Hh^Fp, Hh^Fp, Hh^Fp, Hh, Hh, Rb, Rb, Hh, Hh, Hh^Fp, Hh^Fp, Hh^Fp, Mm, Mm, Mm, Mm, Mm, Mm, Mm
Xu, Xu, Xu, Xu, 1 Kh, Ch, Uu, Uu, Uu, Uu^Vud, Xu, Xu, Mm, Mm, Hh, Mm, Mm, Hh^Fp, Hh^Fp, Hh^Fp, Hh^Vhh, Hh^Fp, Hh^Fp, Hh^Fp, Hh^Fp, Hh^Fp, Rb, Rb, Gs^Vh, Rb, Rb, Hh, Hh^Fp, Hh^Fp, Hh^Fp, Hh^Fp, Hh^Fp, Mm, Mm, Mm, Mm
Xu, Xu, Xu, Xu, Xu, Ch, Re, Uu, Uu, Uu, Re, Xu, Mm, Mm, Mm, Hh, Hh, Hh, Hh, Hh^Fp, Hh, Hh^Fp, Hh^Fp, Hh^Fp, Hh, Hh, Rb, Gs, Ww, Gs, Gs, Rb, Rb, Gs^Vh, Rb, Hh^Fp, Hh^Fp, Hh^Fp, Hh^Fp, Mm, Mm
Xu, Xu, Xu, Uu, Uu, Uu, Uu^Vud, Re, Uu, Uu, Mm, Mm, Mm, Mm, Mm, Mm, Hh^Fp, Hh^Fp, Hh, Hh, Hh, Hh, Hh, Hh, Hh, Rb, Gs, Gs, Ww, Ww, Gs, Rb, Hh^Fp, Rb, Hh^Fp, Rb, Rb, Hh^Fp, Hh^Fp, Mm, Mm
Xu, Xu, Xu, Xu, Xu, Xu, Uu, Re, Mm, Mm, Hh^Fp, Hh^Fp, Hh^Fp, Hh^Fp, Gs^Vh, Hh^Fp, Hh^Fp, Hh^Fp, Hh, Hh^Fp, Hh, Hh, Hh, Hh, Hh, Rb, Rb, Gs^Vh, Gs, Ww, Gs, Rb, Hh^Fp, Hh^Fp, Hh^Fp, Gs^Vh, Rb, Hh^Fp, Hh^Fp, Mm, Mm
Xu, Xu, Xu, Xu, Xu, Xu, Mm, Mm, Mm, Mm, Hh^Fp, Hh^Fp, Hh^Fp, Hh^Fp, Hh^Fp, Rb, Rb, Rb, Rb, Hh, Rb, Rb, Rb, Hh, Hh, Hh, Hh, Rb, Rb, Gs^Vh, Rb, Rb, Hh^Fp, Hh^Fp, Rb, Rb, Hh^Fp, Hh^Fp, Hh^Fp, Mm, Mm
Xu, Xu, Xu, Xu, Xu, Xu, Mm, Mm, Mm, Hh^Fp, Hh^Fp, Hh^Fp, Hh^Fp, Hh^Fp, Hh^Fp, Hh^Fp, Gs^Vh, Hh^Fp, Hh^Fp, Rb, Gs, Gs, Gs, Rb, Rb, Hh, Rb, Rb, Hh, Rb, Hh, Hh^Fp, Hh^Fp, Hh^Fp, Rb, Gs^Vh, Hh^Fp, Hh^Fp, Hh^Fp, Mm, Mm
Xu, Xu, Xu, Xu, Xu, Xu, Mm, Mm, Mm, Dd^Vdt, Hh^Fp, Hh^Fp, Hh^Fp, Hh^Fp, Hh^Fp, Hh^Fp, Hh^Fp, Hh^Fp, Hh^Fp, Rb, Gs^Vh, Ww, Ww, Gs^Vh, Rb, Rb, Rb, Rb, Hh, Hh, Hh^Fp, Hh^Fp, Hh^Fp, Hh^Fp, Rb, Hh^Fp, Hh^Fp, Hh^Fp, Mm, Mm, Mm
Xu, Xu, Xu, Xu, Xu, Xu, Xu, Mm, Mm, Mm, Mm, Hh^Fp, Mm, Hh^Fp, Mm, Hh^Fp, Hh^Fp, Hh^Fp, Hh^Fp, Hh^Fp, Hh^Fp, Ww, Gs^Vh, Gs, Rb, Hh, Hh, Rb, Rb, Hh^Fp, Ch, Hh^Fp, Rb, Rb, Hh^Fp, Hh^Fp, Mm, Mm, Mm, Mm, Xu
Xu, Xu, Xu, Xu, Uu, Xu, Xu, Xu, Xu, Mm, Mm, Mm, Mm, Mm, Mm, Mm, Hh^Fp, Hh^Fp, Hh^Fp, Hh^Fp, Hh^Fp, Hh^Fp, Hh^Fp, Rb, Hh^Fp, Hh, Hh, Hh, Hh^Fp, Ch, 2 Kh, Ch, Hh^Fp, Hh^Fp, Hh^Fp, Mm, Mm, Mm, Mm, Mm, Xu
Xu, Xu, Uu, Uu, Uu, Uu, Uu, Xu, Xu, Xu, Xu, Mm, Mm, Mm, Mm, Mm, Mm, Hh^Fp, Mm, Hh^Fp, Mm, Hh^Fp, Hh^Fp, Hh^Fp, Hh^Fp, Hh^Fp, Hh^Fp, Hh^Fp, Hh^Fp, Ch, Ch, Ch, Hh^Fp, Hh^Fp, Mm, Mm, Mm, Mm, Xu, Xu, Xu
Xu, Xu, Uu, Uu, Uu, Uu, Uu, Xu, Xu, Xu, Xu, Xu, Xu, Mm, Mm, Mm, Mm, Mm, Mm, Mm, Mm, Mm, Mm, Mm, Mm, Hh^Fp, Hh^Fp, Hh^Fp, Hh^Fp, Hh^Fp, Hh^Fp, Hh^Fp, Mm, Mm, Mm, Mm, Mm, Xu, Xu, Xu, Xu
Xu, Xu, Uu, Uu, Uu, Uu, Uu, Xu, Xu, Xu, Xu, Xu, Xu, Xu, Mm, Mm, Mm, Mm, Mm, Mm, Mm, Mm, Mm, Mm, Mm, Mm, Mm, Hh^Fp, Hh^Fp, Hh^Fp, Mm, Mm, Mm, Mm, Mm, Mm, Xu, Xu, Xu, Xu, Xu
Xu, Xu, Xu, Uu, Uu, Uu, Xu, Xu, Xu, Xu, Xu, Xu, Xu, Xu, Xu, Mm, Mm, Mm, Xu, Xu, Xu, Mm, Mm, Mm, Mm, Mm, Mm, Mm, Mm, Mm, Mm, Mm, Mm, Mm, Xu, Xu, Xu, Xu, Xu, Xu, Xu
