Mm, Mm, Mm, Mm, Mm, Mm, Mm, Mm, Mm, Mm, Mm, Mm, Mm, Hh, Hh, Hh, Hh, Mm, Mm, Mm, Hh, Hh, Gg, Gg, Gg, Gg, Gg, Gg, Gg, Re^Fp, Re^Fp, Re^Fp
Mm, Mm, Mm, Mm, Mm, Mm, Mm, Mm, Mm, Mm, Mm, Mm, Mm, Hh, Hh, Hh, Hh, Mm, Mm, Mm, Hh, Hh, Gg, Gg, Gg, Gg, Gg, Gg, Gg, Re^Fp, Re^Fp, Re^Fp
Mm, Mm, Mm, Mm, Mm, Mm, Hh, Mm, Mm, Mm, Hh, Hh, Hh, Hh, Hh, Hh, Hh, Hh, Mm, Hh, Hh, Gg, Gg, Gg, Rb^Gvs, Rb^Gvs, Rb^Gvs, Rb^Gvs, Gg, Re^Fp, Re^Fp, Re^Fp
Mm, Mm, Mm, Mm, Mm, Mm, Mm, Hh, Hh, Mm, Mm, Hh, Hh, Hh, Gg, Co, Co, Hh, Hh, Hh, Hh, Gg, Gg, Gg, Gg, Rb^Gvs, Rb^Gvs, Rb^Gvs, Gg, Gg, Re^Fp, Re^Fp
Mm, Mm, Mm, Hh, Mm, Mm, Mm, Hh, Hh, Hh, Hh, Hh, Hh, Gg, Co, 1 Ko, Co, Gg, Hh, Hh, Gg, Gg, Re^Fp, Re^Fp, Gg, Rb^Gvs, Gg, Gg, Gg, Gg, Re^Fp, Re^Fp
Mm, Mm, Mm, Mm, Hh, Mm, Mm, Hh, Hh, Hh, Hh, Mm, Mm, Hh, Hh, Co, Co, Gg, Gg, Hh, Hh, Gg, Re^Fp, Re^Fp, Gg, Gg, Gg, Gg, Gg, Gg, Gg, Gg
Mm, Mm, Hh, Hh, Hh, Mm, Hh, Hh, Hh, Hh, Hh, Hh, Mm, Hh, Hh, Gg, Gg, Gg, Gs^Vo, Hh, Gg, Gg, Re^Fp, Re^Fp, Gg, Gg, Gg, Gg, Gg, Gg, Re^Fp, Re^Fp
Mm, Mm, Mm, Hh, Hh, Hh, Hh, Hh, Hh, Hh, Gg, Gg, Hh, Mm, Hh, Gg, Gg, Gg, Gg, Gg, Gg, Gg, Gg, Re^Fp, Re^Fp, Gg, Gg, Gg, Gg, Gg, Gg, Gg
Mm, Mm, Hh, Hh, Hh, Hh, Hh, Hh, Gg, Hh, Gg, Hh, Hh, Hh, Hh, Hh, Gg, Gg, Rb^Gvs, Gg, Rb^Gvs, Gg, Gg, Re^Fp, Gg, Gg, Gg, Gg, Rb^Gvs, Gg, Re^Fp, Re^Fp
Mm, Mm, Mm, Hh, Hh, Hh, Gg, Hh, Gg, Hh^Fp, Re^Fp, Gg, Gg, Gg, Gs^Vo, Hh, Gg, Rb^Gvs, Rb^Gvs, Rb^Gvs, Rb^Gvs, Rb^Gvs, Gg, Gg, Re^Fp, Gg, Gg, Rb^Gvs, Rb^Gvs, Gg, Gg, Gg
Mm, Mm, Mm, Hh, Hh, Hh, Hh, Gg, Gg, Re^Fp, Re^Fp, Re^Fp, Gg, Gg, Gg, Gg, Gg, Rb^Gvs, Rb^Gvs, Rb^Gvs, Rb^Gvs, Gg, Gg, Gg, Gg, Gg, Gg, Rb^Gvs, Rb^Gvs, Rb^Gvs, Gg, Gg
Mm, Mm, Mm, Hh, Hh, Hh, Hh, Hh, Hh, Hh^Fp, Hh^Fp, Re^Fp, Re^Fp, Gg, Gg, Gg, Gg, Rb^Gvs, Gg, Rb^Gvs, Gg, Gg, Gg, Gg, Gg, Gg, Gg, Gg, Gg, Gg, Gg, Gg
Mm, Mm, Mm, Mm, Mm, Hh, Hh, Hh, Hh, Gg, Gg, Re^Fp, Re^Fp, Gg, Gg, Gg, Gg, Gs^Vo, Gg, Gg, Gg, Gg, Gg, Gg, Gg, Gg, Gg, Gg, Gg, Gg, Rb, Rb
Mm, Mm, Mm, Mm, Mm, Hh, Hh, Hh, Rb, Hh, Gg, Gg, Re^Fp, Re^Fp, Gg, Gg, Gg, Gg, Gg, Gg, Gg, Gg, Gg, Gg, Rb^Gvs, Gg, Gg, Gg, Gg, Gg, Rb, Rb
Mm, Mm, Mm, Mm, Mm, Hh, Hh, Rb, Hh, Hh, Gg, Gg, Gg, Gg, Gg, Gg, Gg, Gg, Gg, Gg, Gg, Rb^Gvs, Rb^Gvs, Rb^Gvs, Rb^Gvs, Rb^Gvs, Gg, Re^Fp, Gg, Rb, Rb^Gvs, Rb^Gvs
Mm, Mm, Mm, Mm, Hh, Hh, Hh, Rb, Hh, Hh, Hh, Gg, Gg, Gg, Gg, Gg, Gg, Gg, Rb^Gvs, Rb^Gvs, Rb^Gvs, Gs^Vo, Rb^Gvs, Rb^Gvs, Rb^Gvs, Rb^Gvs, Re^Fp, Re^Fp, Gg, Rb, Rb^Gvs, Rb^Gvs
Mm, Mm, Mm, Hh, Hh, Hh, Gg, Rb, Rb, Rb, Hh, Gg, Gg, Gg, Gs^Vo, Gg, Gg, Gg, Rb^Gvs, Rb^Gvs, Rb^Gvs, Rb^Gvs, Ko, Rb^Gvs, Re^Fp, Re^Fp, Re^Fp, Gg, Rb, Gg, Rb^Gvs, Rb^Gvs
Mm, Mm, Mm, Hh, Hh, Hh, Rb^Gvs, Gg, Rb^Gvs, Gg, Rb, Gg, Gg, Gg, Gg, Gg, Gg, Ww, Ww, Ww, Ww, Rb^Gvs, Co, Co, Rb^Gvs, Re^Fp, Re^Fp, Gg, Rb, Gg, Gs^Fp, Gs^Fp
Mm, Mm, Hh, Hh, Hh, Hh, Rb^Gvs, Rb^Gvs, Rb^Gvs, Gg, Rb, Gs^Vo, Gg, Gg, Gg, Ww, Ww, Wo, Wo, Wo, Ww, Rb^Gvs, Rb^Gvs, Rb^Gvs, Rb^Gvs, Rb^Gvs, Rb, Rb, Gg, Gs^Fp, Gs^Fp, Gs^Fp
Mm, Mm, Mm, Hh, Hh, Hh, Hh, Rb^Gvs, Gg, Gg, Rb, Rb, Gg, Rb^Gvs, Rb^Gvs, Ww, Wo, Wo, Wo, Wo, Wo, Ww, Rb^Gvs, Rb^Gvs, Rb, Rb, Rb, Rb, Gg, Gs^Fp, Gs^Fp, Gs^Fp
Mm, Mm, Hh, Hh, Hh, Hh, Hh, Gg, Gg, Rb, Gg, Gg, Rb^Gvs, Rb^Gvs, Rb^Gvs, Ww, Wo, Wo, Wo, Ww, Ww, Gg, Rb^Gvs, Rb^Gvs, Rb, Rb^Gvs, Rb^Gvs, Rb^Gvs, Gs^Fp, Gs^Fp, Gs^Fp, Gs^Fp
Mm, Mm, Mm, Hh, Hh, Gg, Gg, Hh, Gg, Gg, Rb, Rb^Gvs, Rb^Gvs, Rb^Gvs, Gg, Ww, Wo, Wo, Wo, Wo, Ww, Ww, Gg, Rb^Gvs, Rb^Gvs, Rb, Gg, Gg, Gg, Gs^Fp, Gs^Fp, Gs^Fp
Mm, Mm, Hh, Hh, Gg, Gg, Gg, Rb^Gvs, Rb^Gvs, Gg, Rb, Gg, Gg, Gg, Ww, Wo, Wo, Wo, Wo, Wo, Ww, Gg, Gg, Gg, Rb, Rb, Gg, Gg, Gs^Fp, Gs^Fp, Gs^Fp, Gs^Fp
Mm, Mm, Hh, Hh, Gg, Gg, Gg, Rb^Gvs, Rb^Gvs, Rb, Rb, Gg, Gs^Fp, Gs^Fp, Ww, Wo, Wo, Wo, Wo, Wo, Ww, Gg, Rb, Rb, Rb, Rb, Gg, Gg, Gs^Fp, Gs^Fp, Gs^Fp, Gs^Fp
Mm, Mm, Hh, Hh, Gg, Gg, Gg, Rb^Gvs, Rb, Rb, Gg, Gg, Gg, Ww, Wo, Wo, Ww, Ww, Ww, Ww, Gg, Gg, Gg, Gg, Rb, Rb, Gg, Gg, Gs^Fp, Gs^Fp, Gs^Fp, Gs^Fp
Hh, Hh, Hh, Hh, Gg, Gs^Vo, Gg, Gg, Gs^Fp, Gg, Gg, Gg, Gg, Ww, Wo, Wo, Ww, Gg, Gg^Vo, Gg, Gg, Gg, Gg, Gg, Gg, Rb, Rb, Gg, Gg, Gs^Fp, Gs^Fp, Gs^Fp
Hh, Hh, Hh, Gg, Gg, Rb^Gvs, Gg, Gs^Fp, Gs^Fp, Gg, Gg, Gg, Gg, Ww, Wo, Ww, Gg, Gg, Gg, Gg, Gg, Gg, Gg, Gg, Gg, Rb, Gg, Gg, Gs^Fp, Gs^Fp, Gs^Fp, Gs^Fp
Hh, Hh, Gg, Gg, Rb^Gvs, Rb^Gvs, Gg, Gs^Fp, Gg, Gg, Ww, Ww, Ww^Bw|, Ww, Ww, Ww, Gg, Gg, Gg, Gg, Re^Gvs, Gg, Re^Gvs, Gg, Gg, Gs^Vo, Re, Gg, Gg, Gs^Fp, Gs^Fp, Gs^Fp
Gg, Gg, Gg, Rb^Gvs, Rb^Gvs, Rb^Gvs, Rb^Gvs, Gg, Ww, Ww, Ww, Co, Gg, Co, Gg, Gg, Gg, Gg, Re^Gvs, Re^Gvs, Re^Gvs, Re^Gvs, Re^Gvs, Gg, Gg, Gg, Re, Gg, Gg, Gs^Fp, Gs^Fp, Gs^Fp
Hh^Fp, Hh^Fp, Gg, Gg, Gg, Rb^Gvs, Gg, Gg, Ww, Gg, Gg, Gg, Re, Gg, Gg, Gs^Fp, Gg, Gg, Gg, Gg, Re^Gvs, Re^Gvs, Gg, Gg, Gg, Gg, Gg, Re, Re^Gvs, Re^Gvs, Gs^Fp, Gs^Fp
Hh, Hh^Fp, Hh^Fp, Gs^Fp, Gs^Fp, Gg, Gg, Ww, Gg, Gg, Gg, Re^Gvs, Gg, Re, Gg, Gs^Fp, Gg, Gg, Gg, Gg, Gg, Gg, Gg, Gg, Gg, Gg, Re, Gg, Gg, Re^Gvs, Gs^Fp, Gs^Fp
Hh, Hh, Hh, Gs^Fp, Gs^Vo, Gg, Gg, Ww, Co, Gg, Rb, Rb^Gvs, Gg, Gg, Gg, Gs^Fp, Gs^Fp, Gg, Gg, Gg, Gg, Gg, Gg, Gg, Gg, Gg, Gg, Re, Gg, Gg, Gg, Gg
Hh, Hh, Hh, Gg, Gg, Gg, Gg, Gg, Ww^Bw/, Rb, Gg, Gg, Gg, Re, Gg, Gs^Fp, Gg, Gg, Gg, Gg, Gg, Gg, Re^Gvs, Gg, Gg, Gg, Gg, Re, Gg, Gg, Gg, Gg
Hh, Hh, Hh, Hh, Gg, Rb^Gvs, Rb^Gvs, Rb, Ww, Co, Gg, Gg, Gg, Re, Gg, Gg, Gs^Fp, Gg, Gg, Gg, Gg, Re^Gvs, Gg, Gs^Vo, Gg, Gg, Gg, Gs^Vo, Re, Gg, Gs, Gg
Hh, Hh, Hh, Gg, Rb, Rb, Rb^Gvs, Rb^Gvs, Ww, Gg, Gs^Vo, Gg, Re^Gvs, Re^Gvs, Gg, Gg, Gg, Gg, Gg, Gg, Gg, Gg, Gg, Gg, Gg, Re^Gvs, Re^Gvs, Gs, Re, Re, Gs, Gg
Hh, Hh, Hh, Gg, Rb, Rb^Gvs, Rb^Gvs, Rb^Gvs, Ww, Gg, Gg, Re^Gvs, Re^Gvs, Re^Gvs, Re^Gvs, Gg, Gs^Vo, Gg, Gg, Gg, Gg, Gg, Gs^Fp, Gs^Fp, Gg, Re^Gvs, Re^Gvs, Re^Gvs, Gs, Re, Re, Re
Hh, Hh, Gg, Gg, Gg, Gg, Ww, Ww, Gg, Gg, Gg, Re^Gvs, Re^Gvs, Re^Gvs, Re^Gvs, Gg, Gg, Gg, Gg, Gg, Gg, Gs^Fp, Gs^Fp, Gs^Fp, Gg, Re^Gvs, Gs, Gs, Gs, Gs, Ce, Re
Hh, Hh, Hh, Gg, Gg, Ww, Ww, Ww, Gg, Gg, Re^Gvs, Re^Gvs, Re^Gvs, Re^Gvs, Re^Gvs, Gg, Gg, Gg, Gg, Gg, Gg, Gg, Gs^Fp, Gs^Fp, Gs^Fp, Gs^Fp, Gs^Fp, Gs, Gs, Ce, Ce, Ce
Hh, Hh, Hh, Gg, Ww, Ww, Gg, Gg, Gg, Gg, Gg, Gg, Gg, Gg, Gg, Gg, Gg, Gg, Gg, Gg, Gg, Gs^Fp, Gs^Fp, Gs^Fp, Gs^Fp, Gs^Fp, Gs^Fp, Gs^Fp, Gs, 2 Ke, Ce, Ce
Hh, Hh, Hh, Gg, Ww, Ww, Gg, Gg, Gg, Gg, Gg, Gg, Gg, Gg, Gg, Gg, Gg, Gg, Gg, Gg, Gg, Gs^Fp, Gs^Fp, Gs^Fp, Gs^Fp, Gs^Fp, Gs^Fp, Gs^Fp, Gs, Ce, Ce, Ce
