Mm, Mm, Mm, Mm, Mm, Mm, Mm, Mm, Mm, Hh, Hh, Hh, Ds, Ww, Ww, Ww, Ww, Ds, Gg, Hh, Hh, Hh, Hh, Hh, Hh, Hh, Mm, Mm, Mm, Mm, Mm, Mm, Mm, Mm, Mm, Mm, Mm, Mm, Mm, Mm
Mm, Mm, Mm, Mm, Mm, Mm, Mm, Mm, Mm, Hh, Hh, Hh, Ds, Ww, Ww, Ww, Ww, Ds, Gg, Hh, Hh, Hh, Hh, Hh, Hh, Hh, Mm, Mm, Mm, Mm, Mm, Mm, Mm, Mm, Mm, Mm, Chr, Mm, Mm, Mm
Mm, Mm, Mm, Mm, Mm, Mm, Mm, Mm, Hh, Hh, Gg, Gg, Gg, Ds, Ww, Ww, Ds, Ds, Gg, Gg, Gg, Gg, Hh, Hh, Hh, Hh, Hh, Mm, Hh, Mm, Mm, Hh, Hh, Mm, Mm, Chr, 2 Khr, Chr, Mm, Mm
Mm, Mm, Mm, Mm, Mm, Mm, Mm, Hh, Hh, Gg, Gg, Gg, Ds, Ds, Ww, Ww, Ds, Gg, Gg, Gg, Gg, Gg, Gg, Hh, Hh, Hh, Hh, Hh, Hh, Hh, Hh, Hh, Hh, Hh^Vhh, Hh, Chr, Chr, Chr, Mm, Mm
Mm, Mm, Mm, Mm, Mm, Mm, Hh, Mm, Hh, Hh, Hh, Hh, Ds, Ww, Ww, Ww, Ds, Gg, Gg, Gg, Gg, Gg^Vc, Gg, Gg, Gg, Hh, Gg, Hh, Gg, Hh, Re, Hh, Hh, Hh, Re, Chr, Mm, Mm^Vhh, Mm, Mm
Mm, Mm, Mm, Mm, Mm, Hh, Hh, Hh, Hh, Gg, Gg, Gg, Ds, Ww, Ww, Ww, Ds, Gg, Gg, Gg, Gg, Gg, Gg, Gg, Gg, Gg, Re, Re, Re, Re, Gg^Vh, Re, Re, Re, Hh, Mm, Mm, Mm, Mm, Mm
Mm, Mm, Hh, Mm, Mm, Mm, Mm, Hh, Hh, Gg, Gg, Gg, Gg, Ds, Ww, Ww, Ww, Ds, Ds, Gg, Ds, Gg, Gg^Vh, Gg, Re, Re, Hh, Gg^Vc, Hh, Hh, Hh, Hh, Hh, Hh, Hh, Hh^Vhh, Hh, Mm, Mm, Mm
Mm, Mm, Mm, Mm, Hh, Mm, Hh, Hh, Hh, Hh, Gg, Gg, Gg, Ds, Ww, Ww, Ww, Ww, Ww, Ds, Ww, Ds, Ds, Gg, Re, Gg, Hh, Hh, Hh, Hh, Hh, Hh, Hh, Hh, Hh, Hh, Hh, Hh, Mm, Mm
Mm, Mm, Hh, Hh, Hh, Hh, Hh, Hh, Gg, Gg, Gg, Gg, Gg, Ds, Ds, Ds, Ds, Ww, Ww, Ww, Ww, Ww, Ww, Gg, Re, Gg, Gg, Hh, Hh, Hh, Hh, Hh, Hh, Hh, Mm, Hh, Mm, Mm, Mm, Mm
Mm, Mm, Hh, Hh, Hh, Hh, Gg, Hh, Hh, Gg, Gg, Gg, Gg, Gg, Gg, Gg, Gg, Ds, Ds, Ds, Ds, Ww, Ww, Gg, Ch, Gg, Ds, Hh, Gg, Hh, Hh, Hh, Hh, Mm, Mm, Mm, Mm, Mm, Mm, Mm
Hh, Hh, Hh, Gg, Hh, Hh, Gg, Gg, Gg, Gg, Gg, Gg^Vc, Gg, Gg, Gg, Gg, Gg, Gg, Gg, Gg, Gg, Ds, Ch, Ww^Bw/, Ww, Ww, Ww, Ds, Ds, Gg, Hh, Hh, Hh, Hh, Hh, Mm, Hh, Mm, Mm, Mm
Hh, Hh, Gg, Gg, Gg, Gg, Gg, Gg, Gg, Gg, Gg, Gg, Gg, Gg, Gg, Gg, Gg, Gg, Gg, Gg, Gg, Gg, Re, Gg, Ds, Ww, Ww, Ww, Ds, Gg, Gg, Hh, Hh, Hh, Hh, Hh, Hh, Mm, Mm, Mm
Hh, Hh, Gg, Gg, Gg, Gg, Gg, Gg, Gg, Gg, Gg, Gg, Gg, Gg, Gg, Gg, Gg, Gg, Gg, Gg, Gg, Re, Gg, Gg, Gg, Ds, Ww, Ww, Ds, Gg, Gg, Hh, Hh, Hh, Hh, Hh, Hh, Mm, Mm, Mm
Gg, Gg, Gg, Gg, Gg, Gg, Gg, Gg, Gs^Fp, Gs^Fp, Gs^Fp, Gs^Fp, Gs^Fp, Gg, Gg, Gg, Gg^Vo, Gg, Gg, Gg, Re, Re, Gg, Gg, Gg, Ds, Ds, Ww, Ww, Ds, Ds, Gg, Hh, Hh, Hh, Hh, Hh, Hh, Mm, Mm
Re, Re, Re, Gg, Gg, Gg, Gg, Gg, Gg, Gs^Fp, Gs^Fp, Gs^Fp, Gs^Fp, Gg, Gg, Gg, Gg, Gg, Re, Re, Gg, Gg^Ecf, Gg, Gg, Gg, Gg, Ds, Ww, Ww, Ww, Ww, Ds, Ds, Hh, Hh, Hh, Hh, Hh, Hh, Hh
Gg, Gg, Gg, Re, Re, Re, Re, Gg^Vc, Gg, Gg, Gg, Gs^Fp, Gs^Fp, Gg, Gg, Gg, Gg, Re, Chr, Gg, Gg, Gg, Gg^Vo, Gg, Gg, Gg, Gg, Ds, Ds, Ww, Ww, Ww, Ww, Ds, Ds, Ds, Ww, Hh, Ww, Ww
Gg, Gg, Gg, Gg, Gg, Re, Gg, Re, Gg, Gg, Gg, Gs^Fp, Gg, Gs^Fp, Gg, Gg, Re, Re, Ch, Ch, Ch, Gg, Gg, Gg, Gg, Gg, Gg, Gg, Gg, Ds, Ds, Ww, Ww, Ww, Ww, Ww, Ww, Ww, Ww, Ww
Gs, Gs, Gs, Gg, Gg, Gg, Gg, Re, Re, Gg, Gg, Gg, Gg, Gg, 1 Gg, Gg^Ecf, Re, Ch, Ch, Kh, Chr, Gg, Gg, Gg, Gg, Gg, Gg, Gg, Gg, Gg, Gg, Ds, Ds, Ww, Ds, Ww, Ds, Ww, Ds, Ds
Ss, Ss, Ss, Gs, Gs, Gs, Ss, Gg, Re, Gg, Gg, Gg, Gg, Gg, Gg^Vo, Gg, Gg, Re, Gg, Chr, Gg, Ch, Gg, Gg, Gg, Gg, Gg, Gg, Gg, Gg, Gg, Gg, Gg^Ve, Ds, Gg, Ds, Gg, Ds, Ds, Ds
Ss, Ss, Ss, Gs, Gs, Ss, Gg, Gg, Gg, Re, Re, Gg, Re, Gg, Re, Re, Re, Re, Gg, Gg, Gg, Gg, Gg, Gg^Vo, Gg, Gg, Gg, Gg, Gg, Gg, Gg, Gg, Gg, Gg, Gg, Gg, Gs^Fp, Gg, Gg, Gg
Ss, Ss, Ss, Gs, Ss, Gg, Ss, Gg, Gg, Gg, Gg, Re, Re, Re, Gg, Gg, Gg, Gg, Gg, Gg, Gg, Gg, Gg, Gg, Gg, Gg, Gg, Gg, Gg, Gg, Gg, Gg, Gg, Gg, Gg, Gg, Gs^Fp, Gs^Fp, Gs^Fp, Gs^Fp
Ss, Ss, Ss, Gs, Gs, Ss, Gs, Ss, Ss, Gg, Gg, Gg, Gg, Re, Re, Gg, Gg, Gg^Vo, Gg, Gg, Gg, Gg, Gg, Gg, Gg, Gg, Gg, Gs^Fp, Gs^Fp, Gs^Fp, Gg, Gg, Gg, Gs^Fp, Gs^Fp, Gg, Gs^Fp, Gs^Fp, Gs^Fp, Gs^Fp
Ss, Ss, Ss, Ss, Gs, Ss, Ss, Gs, Ss, Ss, Ss, Gg, Gs, Gg, Gg, Re, Re, Gg, Gg, Gg, Gg, Gg, Gg, Gg, Gg, Gg^Ve, Gg, Gs^Fp, Gs^Fp, Gs^Fp, Gs^Fp, Gg, Gg, Gs^Fp, Gs^Fp, Gs^Fp, Gs^Fp, Gs^Fp, Gs^Fp, Gs^Fp
Ss, Ss, Gs, Gs, Gs, Ss, Ss, Gs, Gs, Ss, Ss, Ss, Ss, Gs, Gg, Gg, Gg, Re, Re, Gg, Re, Re, Re, Gg, Gg, Gg, Gg, Gg, Gg, Gg, Gg, Gg, Gg, Gs^Fp, Gs^Fp, Gs^Fp, Gs^Fp, Gs^Fp, Gs^Fp, Gs^Fp
Ss, Ss, Gs, Gs^Vht, Gs, Ss, Ss, Ss, Ss, Gs, Gs^Vht, Gs, Ss, Gg, Gs, Gs, Gs, Gg, Gg, Re, Gg, Gg, Gg, Re, Gg, Gg, Gs^Fp, Gg, Gg, Gg, Gg, Gs^Fp, Gs^Fp, Gs^Fp, Gs^Fp, Gs^Fp, Hh^Fp, Gs^Fp, Gs^Fp, Gs^Fp
Ss, Ss, Ss, Gs, Ss, Ss, Gs, Ss, Ss, Gs, Gs, Gs, Ss, Gs, Ss, Gs, Gg, Ss, Ss, Gs, Ss, Ss, Gg, Re, Re, Gg, Gs^Fp, Gs^Fp, Gg, Gg, Gs^Fp, Gg, Gs^Fp, Gs^Fp, Gs^Fp, Hh^Fp, Hh, Hh^Fp, Gs^Fp, Gs^Fp
Ss, Ss, Ss, Ss, Ss, Ss^Vhs, Gs, Gs, Ss, Ss, Ss, Ss, Ss, Ss, Ss, Ss, Gs, Ss, Ss, Gs, Ss, Gg, Gg, Gg, Re, Gg, Gg, Gs^Fp, Gg, Gg, Gs^Fp, Gs^Fp, Gs^Fp, Gs^Fp, Gs^Fp, Hh^Fp, Hh^Fp, Hh^Fp, Gs^Fp, Gs^Fp
Ss, Ss, Ss, Ss, Ss, Gs, Ss, Ss, Ss, Ss, Ss, Gs, Gs, Ss, Gs, Ss, Ss, Gs, Gs, Ss, Ss, Ss, Gg, Gg, Re, Gg, Gg, Gg, Gg, Gs^Fp, Gg, Gs^Fp, Gs^Fp, Gs^Fp, Gs^Fp, Gs^Fp, Hh^Fp, Hh^Fp, Gs^Fp, Gs^Fp
Re, Re, Ce, Ss, Ss, Ss, Ss, Ss, Ss, Ss^Vhs, Ss, Gs, Gs^Vht, Ss, Gs, Ss, Ss, Ss, Gs, Ss, Gs, Gs, Gg^Vc, Gg, Gg, Re, Re, Gg, Gg, Gg, Gg, Gg, Gg, Gs^Fp, Hh, Hh^Fp, Hh, Hh, Gs^Fp, Gs^Fp
Re, Ce, 3 Ke, Ce, Re, Ss, Ss, Ss, Ss, Ss, Ss, Gs, Gs, Ss, Ss, Ss, Ss, Ss, Ss, Gs, Gs, Gs, Gs, Gs, Gs, Gg, Gg, Re, Gg, Gg, Gg, Gg, Gs^Fp, Gs^Fp, Hh^Fp, Hh^Fp, Hh^Fp, Hh, Gs^Fp, Gs^Fp
Re, Ce, Ce, Ce, Re, Ss^Vhs, Ss, Ss, Ss, Ss, Ss, Ss, Ss, Ss, Ss, Ss, Ss, Ss, Ss, Ss, Ss, Gs, Ss, Ss, Ss, Ss, Gg, Re, Re, Gg, Gs^Fp, Gs^Fp, Gs^Fp, Gs^Fp, Hh, Hh, Hh^Fp, Hh^Fp, Gs^Fp, Gs^Fp
Re, Re, Re, Re, Re, Ss, Ss, Ss, Ss, Ss, Ss, Ss, Ss, Ss, Ss, Ss, Ss, Ss, Ss, Ss, Ss, Gs, Ss, Ss, Ss, Ss, Gg, Re, Re, Gg, Gs^Fp, Gs^Fp, Gs^Fp, Gs^Fp, Gs^Fp, Hh^Fp, Gs^Fp, Gs^Fp, Gs^Fp, Gs^Fp
