Wo, Wo, Wo, Wo, Ww, Ww, Ww, Ww, Ds, Ds, Ds, Ds, Ds, Gs^Fp, Gs^Fp, Gs^Fp, Gs^Fp, Gs^Fp, Gs^Fp, Gs^Fp, Gs^Fp, Gs^Fp, Gs^Fp, Gs^Fp, Rr, Gg, Gg, Gg, Gg, Gg, Gg, Gg, Gg, Gs^Fp, Gs^Fp, Gs^Fp, Gs^Fp, Gs^Fp, Gs^Fp, Gs^Fp
Wo, Wo, Wo, Wo, Ww, Ww, Ww, Ww, Ds, Ds, Ds, Ds, Ds, Gs^Fp, Gs^Fp, Gs^Fp, Gs^Fp, Gs^Fp, Gs^Fp, Gs^Fp, Gs^Fp, Gs^Fp, Gs^Fp, Gs^Fp, Rr, 1 Gg, Re^Gvs, Gg, Re^Gvs, Gg^Efm, Gg^Efm, Gg, Gg, Gs^Fp, Gs^Fp, Gs^Fp, Gs^Fp, Gs^Fp, Gs^Fp, Gs^Fp
Wo, Wo, Wo, Wo, Ww, Ww, Ww, Ds, Ds, Ds, Gg, Gg, Re^Gvs, Gg, Gg, Gs^Fp, Gs^Fp, Gs^Fp, Gs^Fp, Gs^Fp, Gs^Fp, Gs^Fp, Gs^Fp, Gg, Gg, Rr, Gg, Re^Gvs, Re^Gvs, Re^Gvs, Gg^Efm, Gg, Gg, Gs^Fp, Gs^Fp, Gs^Fp, Gs^Fp, Gs^Fp, Gg^Fet, Gs^Fp
Wo, Wo, Wo, Wo, Ww, Ww, Ds, Ds, Gg, Gg, Gg^Vo, Re^Gvs, Re^Gvs, Re^Gvs, Gg^Vo, Gs^Fp, Gg, Gs^Fp, Gs^Fp, Gs^Fp, Gg^Fet, Gs^Fp, Gs^Fp, Gg, Re^Gvs, Rr, Rr, Re^Gvs, Re^Gvs, Re^Gvs, Re^Gvs, Gg, Gg, Gg, Gg, Gs^Fp, Gg, Gs^Fp, Gs^Fp, Gs^Fp
Wo, Wo, Wo, Wo, Ww, Ww, Ds, Ds, Re^Gvs, Re^Gvs, Re^Gvs, Re^Gvs, Re^Gvs, Re^Gvs, Gg, Gg, Gs^Fp, Gs^Fp, Gs^Fp, Gs^Fp, Gs^Fp, Gs^Fp, Gg, Re^Gvs, Re^Gvs, Re^Gvs, Gg^Vo, Rr, Re^Gvs, Re^Gvs, Re^Gvs, Gg, Gs^Fp, Gg, Gg, Gg, Gs^Fp, Gs^Fp, Gs^Fp, Gs^Fp
Wo, Wo, Wo, Ww, Ww, Ww, Ds, Gg, Re^Gvs, Re^Gvs, Re^Gvs, Re^Gvs, Re^Gvs, Re^Gvs, Gg, Gg, Gs^Fp, Gs^Fp, Gs^Fp, Gs^Fp, Gs^Fp, Gs^Fp, Gg, Re^Gvs, Re^Gvs, Re^Gvs, Re^Gvs, Rr, Rr, Re^Gvs, Re^Gvs, Re^Gvs, Gs^Fp, Gg, Gg, Gg, Gg^Efm, Gs^Fp, Gs^Fp, Gs^Fp
Wo, Wo, Ww, Ww, Ww, Ww, Ds, Ds, Gg, Re^Gvs, Co, Gg, Re^Gvs, Re^Gvs, Re^Gvs, Gs^Fp, Gs^Fp, Gs^Fp, Gs^Fp, Gs^Fp, Gg^Efm, Gg^Efm, Gg, Gs^Fp, Gs^Fp, Re^Gvs, Re^Gvs, Re^Gvs, Rr, Re^Gvs, Re^Gvs, Re^Gvs, Gs^Fp, Gg, Gg, Gg, Gg, Gs^Fp, Gs^Fp, Gs^Fp
Wo, Wo, Ww, Ww, Ww, Ds, Ds, Ds, Gg, Co, 2 Ko, Co, Re^Gvs, Re^Gvs, Re^Gvs, Gs^Fp, Gg^Fet, Gs^Fp, Gs^Fp, Gs^Fp, Gg, Gg, Gg, Gg, Gg, Re^Gvs, Re^Gvs, Re^Gvs, Rr, Gg, Gs^Fp, Gs^Fp, Gs^Fp, Gs^Fp, Gg, Gg^Efm, Re, Gs^Fp, Gs^Fp, Gs^Fp
Wo, Wo, Wo, Ww, Ww, Ww, Ds, Ds, Gg, Gg, Co, Co, Re^Gvs, Re^Gvs, Gs^Fp, Gs^Fp, Gs^Fp, Gs^Fp, Gg, Gg, Gg^Efm, Gg, Gs^Fp, Gs^Fp, Re^Gvs, Re^Gvs, Re^Gvs, Rr, Gg, Gg, Gs^Fp, Gs^Fp, Gg, Gg, Re, Re, Gs^Fp, Gs^Fp, Gs^Fp, Gs^Fp
Wo, Wo, Wo, Ww, Ww, Ww, Ww, Ds, Ds, Gg, Gg, Re^Gvs, Re^Gvs, Re^Gvs, Re^Gvs, Gs^Fp, Re^Gvs, Gs^Fp, Gg, Gg, Gs^Fp, Gs^Fp, Gs^Fp, Gs^Fp, Re^Gvs, Re^Gvs, Re^Gvs, Rr, Gg, Gs^Fp, Gg, Gg, Re, Re, Re, Re, Gs^Fp, Gs^Fp, Gs^Fp, Gs^Fp
Wo, Wo, Wo, Wo, Ww, Ww, Ww, Ds, Ds, Gg, Co, Re^Gvs, Re^Gvs, Re^Gvs, Re^Gvs, Re^Gvs, Re^Gvs, Re^Gvs, Re^Gvs, Gg, Gs^Fp, Gs^Fp, Gg, Re^Gvs, Re^Gvs, Re^Gvs, Rr, Rr, Re^Gvs, Gg, Gg, Gg, Re, Re, Gg, Gg, Gg, Gg, Gg, Gg
Wo, Wo, Wo, Wo, Ww, Ww, Ww, Ww, Ds, Ds, Gg, Gg^Vc, Re^Gvs, Re^Gvs, Re^Gvs, Re^Gvs, Re^Gvs, Re^Gvs, Re^Gvs, Gs^Fp, Gg, Gg, Gg, Gg^Vo, Re^Gvs, Re^Gvs, Rr, Re^Gvs, Re^Gvs, Gg^Vo, Gg, Re, Re, Re, Gg, Gg, Gg, Gg, Gg, Gg
Wo, Wo, Wo, Wo, Ww, Ww, Ww, Ww, Ds, Ds, Chr, Re^Gvs, Re^Gvs, Re^Gvs, Re^Gvs, Re^Gvs, Ch, Re^Gvs, Co, Gg^Vo, Gg, Gg, Co, Gg, Gg, Gg, Gg, Rr, Rr, Gg, Gg, Re, Gg, Gg, Gg, Gg^Vc, Gg, Gg, Gg, Gg
Wo, Wo, Wo, Wo, Ww, Ww, Ww, Ww, Ww, Ds, Ds, Re^Gvs, Re^Gvs, Re^Gvs, Ch, Gg^Vc, Ds, Gg, Ds, Ds, Ww^Bw/, Ds, Ds, Ds, Ds, Co, Ds, Gg, Rr, Gg, Gg, Gg, Gs^Fp, Gs^Fp, Gs^Fp, Gs^Fp, Gs^Fp, Gs^Fp, Gg, Gg
Wo, Wo, Wo, Wo, Wo, Ww, Ww, Ww, Ww, Ds, Ds, Gg, Gg, Gg, Ds, Ds, Ww, Ww^Bw|, Ww, Ww, Ww, Ds, Ww^Bw/, Ww^Bw/, Ww, Ds, Ds, Gg^Vo, Gg, Rr, Re^Gvs, Re^Gvs, Re^Gvs, Gg^Efm, Gg^Efm, Gs^Fp, Gs^Fp, Gs^Fp, Gs^Fp, Gs^Fp
Wo, Wo, Wo, Wo, Wo, Ww, Ww, Ww, Ww, Ds, Ds, Chr, Chr, Gg, Ww^Bw\, Ww, Ww, Ww, Wo, Ww, Wo, Ww, Ww, Ww, Ww^Bw/, Ww^Bw/, Ds, Co, Gg, Rr, Re^Gvs, Re^Gvs, Re^Gvs, Gg^Efm, Gg^Efm, Gg, Gg, Gs^Fp, Gg, Gg
Wo, Wo, Wo, Wo, Wo, Wo, Ww, Ww, Ww, Ww, Ds, Chr, Ds, Ds, Ww, Ww, Ww, Ww, Wo, Wo, Wo, Wo, Wo, Ww, Ww, Ww, Ww, Ds, Gg, Rr, Gg, Re^Gvs, Gg^Vo, Gg, Gg, Gg, Gg, Gg, Gg, Gg
Wo, Wo, Wo, Wo, Wo, Wo, Wwr, Ww, Ww, Ww, Ds, Ds, Ds, Ww, Ww, Ww, Ww, Wo, Wo, Wo, Wo, Wo, Wo, Ww, Ww, Ww^Bw\, Ww^Bw\, Ds, Co, Rr, Re, Gg, Gg, Gg, Re, Gg, Hh, Gg, Hh, Hh
Wo, Wo, Wo, Wo, Wo, Wo, Ww, Ww, Ww, Ds, Ds, Chr, Chr, Ww, Ww, Ww, Wo, Wo, Wo, Wo, Wo, Wo, Wo, Ww, Ww, Ww, Ds, Ds, Gg, Gg, Re, Gg, Gg, Re, Re, Gg, Hh, Hh, Hh, Hh
Wo, Wo, Wo, Wo, Wo, Wo, Wwr, Wwr, Ww, Ww, Ds, Chr, Ds, Ww, Ww, Ww, Wo, Wo, Wo, Wo, Ww, Wo, Ww, Ww, Ww, Ww^Bw\, Gg, Gg, Co, Re, Re, Gg, Re, Gg, Gs^Fp, Gg, Gg, Gg, Hh, Hh
Wo, Wo, Wo, Wo, Wo, Wo, Wo, Wwr, Wwr, Ww, Ww, Ww, Ww, Ww, Ww, Wo, Wo, Wo, Wo, Ww, Ww, Ww, Ds, Ds, Ds, Ds, Co, Ko, Co, Re, Re, Re, Gs^Fp, Gs^Fp, Gs^Fp, Gg^Vo, Gg, Gg, Hh, Hh
Wo, Wo, Wo, Wo, Wo, Wo, Wo, Wwr, Wwr, Ww, Ww, Ww, Ww, Ww, Wo, Wo, Wo, Wo, Ww, Ww, Ds, Ds, Ds, Gg, Gg, Ds, Gg, Co, Re, Re, Gs^Fp, Gs^Fp, Gs^Fp, Gs^Fp, Gs^Fp, Gs^Fp, Gg, Gg, Gg, Gg
Wo, Wo, Wo, Wo, Wo, Wo, Wo, Wwr, Wo, Wwr, Wwr, Ww, Wo, Wwr, Wo, Wo, Wo, Wo, Ww, Ww, Chr, Ch, Ds, Gg, Gg, Co, Gg^Efm, Gg, Gg, Re, Gg, Gs^Fp, Re, Re, Re, Gs^Fp, Gs^Fp, Gg, Gg, Gg
Wo, Wo, Wo, Wo, Wo, Wo, Wo, Wo, Wo, Wo, Wo, Wo, Wo, Wo, Wo, Wo, Wo, Wwr, Ww, Ww, Ww, Ds, Ww, Ds, Ds, Ds, Ds, Gg, Co, Gg, Re, Gg^Vo, Gg, Re, Re, Gg, Gg, Gg, Co, Gg
Wo, Wo, Wo, Wo, Wo, Wo, Wo, Wo, Wo, Wo, Wo, Wo, Wo, Wo, Wo, Wo, Wo, Wo, Wo, Wwr, Ww, Ww, Ww, Ww, Ww, Ww, Ww, Ds, Ds, Gg, Gg, Re, Gg, Gg, Gg, Gg, Gg, Gg, Gg, Gg
Wo, Wo, Wo, Wo, Wo, Wo, Wo, Wo, Wo, Wo, Wo, Wo, Wo, Wo, Wo, Wo, Wo, Wo, Wo, Wwr, Wo, Wo, Wo, Ww, Ww, Ww, Ww, Ww, Ww, Ds, Gg, Co, Gg^Efm, Gg, Gg, Co, Gg, Gg, Gs^Fp, Gs^Fp
Wo, Wo, Wo, Wo, Wo, Wo, Wo, Wo, Wo, Wo, Wo, Wo, Wo, Wo, Wo, Wo, Wo, Wo, Wo, Wo, Wo, Wo, Wo, Wo, Ww, Wo, Wo, Ww, Ds, Ds, Gg, Gg, Re^Gvs, Re^Gvs, Re^Gvs, Gs^Fp, Gs^Fp, Gs^Fp, Gs^Fp, Gs^Fp
Wo, Wo, Wo, Wo, Wo, Wo, Wo, Wo, Wo, Wo, Wo, Wo, Wo, Wo, Wo, Wo, Wo, Wo, Wo, Wo, Wo, Wo, Wwr, Wwr, Wo, Wo, Wo, Ww, Ds, Gg, Gg, Gg, Re^Gvs, Re^Gvs, Re^Gvs, Gg, Gg, Gs^Fp, Gs^Fp, Gs^Fp
Wo, Wo, Wo, Wo, Wo, Wo, Wo, Wo, Wo, Wo, Wo, Wo, Wo, Wo, Wo, Wo, Wo, Wo, Wo, Wo, Wo, Ww, Wwr, Ww, Wo, Wo, Wo, Ww, Ww, Ds, Gg, Gg^Efm, Re^Gvs, Re^Gvs, Gg^Vc, Gg, Gg, Gg, Gs^Fp, Gs^Fp
Wo, Wo, Wo, Wo, Wo, Wo, Wo, Wo, Wo, Wo, Wo, Wo, Wo, Wo, Wo, Wo, Wo, Wo, Wo, Wo, Wo, Wo, Wo, Wo, Wo, Wo, Wo, Wo, Ww, Ds, Gg, Re^Gvs, Re^Gvs, Re^Gvs, Gg, Gg, Ce, Gg, Gg, Gg
Wo, Wo, Wo, Wo, Wo, Wo, Wo, Wo, Wo, Wo, Wo, Wo, Wo, Wo, Wo, Wo, Wo, Wo, Wo, Wo, Wo, Wo, Wo, Wo, Wo, Wo, Ww, Ww, Ds, Ds, Gg, Re^Gvs, Re^Gvs, Re^Gvs, Gg, Ce, 4 Ke, Gg, Gg, Gg
Wo, Wo, Wo, Wo, Wo, Wo, Wo, Wo, Wo, Wo, Wo, Wo, Wo, Wo, Wo, Wo, Wo, Wo, Wo, Wo, Wo, Wo, Wo, Wo, Wo, Wo, Ww, Ds, Gg, Gg, Re^Gvs, Re^Gvs, Re^Gvs, Re^Gvs, Gg, Gg, Gg, Gg, Gg, Gg
