Mm^Xm, Mm^Xm, Mm^Xm, Mm^Xm, Mm^Xm, Mm^Xm, Mm^Xm, Mm^Xm, Mm, Mm, Mm, Mm, Mm, Mm, Mm^Xm, Mm^Xm, Mm^Xm, Mm, Mm^Xm, Mm^Xm, Mm^Xm, Mm, Mm^Xm, Mm^Xm, Mm^Xm, Mm^Xm, Mm^Xm, Mm^Xm, Mm^Xm, Mm^Xm, Mm^Xm, Mm^Xm, Mm^Xm, Mm^Xm, Mm^Xm, Mm^Xm, Mm^Xm, Mm^Xm, Mm^Xm, Mm^Xm
Mm^Xm, Mm^Xm, Mm, Mm, Hh, Co, Co, Mm, Mm, Mm, Mm, Mm, Mm, Mm, Mm, Mm, Mm, Mm^Xm, Co, Mm^Xm, Co, Mm^Xm, Hh, Mm, Hh, Mm, Hh, Mm, Hh^Vo, Mm, Hh, Mm, Hh, Co, Hh, Mm, Mm, Mm^Xm, Mm, Mm^Xm
Mm, Mm, Hh, Hh^Vo, Hh, Hh, Re^Gvs, Co, Co, Mm, Hh, Hh, Gg, Hh, Hh, Mm, Hh, Hh, Co, Hh, Co, Hh, Hh, Hh, Re, Hh^Vc, Hh, Hh, Hh, Hh, Hh, Mm, Co, Co, Hh, Hh, Re^Gvs, Mm, Hh, Hh
Mm, Mm, Hh, Hh, Hh, Re^Gvs, Re^Gvs, Gg, Hh, Co, Hh^Vc, Gg, Gg, Gg, Hh, Hh, Gg, Co, Co, Co, Co, Co, Gg, Re, Gg, Re, Gg, Re, Gg, Gg, Re, Co, Re^Gvs, Re^Gvs, Hh, Hh, Re^Vo, Re^Gvs, Re^Gvs, Re^Gvs
Hh, Hh, Hh, Gg, Re^Gvs, Re^Gvs, Re^Gvs, Hh, Hh, Co, Hh, Hh, Gg, Hh, Hh, Hh^Vo, Gg, Co, Co, 1 Ko, Co, Co, Gg, Gg, Gg, Gg, Hh, Gg, Gg, Re, Re, Re, Re, Gg, Re^Gvs, Re^Gvs, Re, Re^Gvs, Re, Re
Hh, Hh, Re^Gvs, Hh, Re^Gvs, Re^Gvs, Re^Gvs, Re^Gvs, Gg, Co, Re, Gg, Gg^Vo, Re, Re, Re, Gg, Gg, Re, Co, Re, Gg, Gg, Gg, Gg, Gg, Hh, Hh^Vo, Re, Re, Hh, Co, Hh, Re, Re, Re, Re^Gvs, Re, Re^Gvs, Re^Gvs
Re^Gvs, Re^Gvs, Re, Gg^Vo, Re^Gvs, Re^Gvs, Re, Re, Re, Re, Re, Re, Re, Re, Re, Re, Re, Co, Co, Re, Co, Co, Re, Gg, Re^Vo, Gg, Re, Re, Ww^Bw|, Re, Hh, Co, Re, Gg, Re^Gvs, Re^Gvs, Re^Vo, Re^Gvs, Re^Gvs, Re^Gvs
Re, Re, Re^Gvs, Re, Re, Re, Re^Gvs, Re^Gvs, Gg, Co, Gg^Vo, Re, Ww^Bw\, Ww^Bw|, Ww^Bw/, Re, Co, Re, Ww^Bw|, Ww^Bw|, Ww^Bw|, Re, Co, Re, Re, Re, Co, Ww^Bw\, Ww, Ww^Bw/, Co, Co, Ds, Ds, Ds, Re^Gvs, Ds, Ds, Ds, Re
Re^Gvs, Re^Gvs, Re^Gvs, Re^Gvs, Re^Gvs, Re^Gvs, Re^Gvs, Re^Gvs, Ds, Co, Co, Re, Co, Ww, Ww, Co, Co, Re^Vo, Ww^Bw|, Ww^Bw|, Ww^Bw|, Re^Vo, Co, Co, Co, Co, Ww, Ww, Ww, Ww, Ww, Co, Ww, Ww, Ds, Ds, Ww, Ww, Ds, Ds
Re^Gvs, Re^Gvs, Gg, Re^Gvs, Gg, Gg^Vo, Ds, Ds, Ww, Ww, Ww, Co, Ww, Ww, Ww, Ww, Ww, Ww, Ww^Bw|, Ww^Bw|, Ww^Bw|, Ww, Ww, Ww, Ww, Ww, Wo, Wo, Wo, Ww, Ww, Ww, Wo, Ww, Ww, Ww, Ww, Ww, Ww, Ww
Ds, Ds, Ds, Ds, Ds, Ds, Ww, Ww, Ww, Ww, Wo, Ww, Wo, Ww, Wo, Ww, Wo, Wo, Ww^Bw|, Ww^Bw|, Ww^Bw|, Wo, Wo, Wo, Wo, Wo, Wo, Wo, Wo, Wo, Wo, Wo, Wo, Wo, Wo, Wo, Wo, Wo, Wo, Wo
Ww, Ww, Ww, Ww, Ww, Ww, Wo, Ww, Wo, Wo, Wo, Wo, Wo, Wo, Wo, Wo, Wo, Wo, Co, Co, Co, Wo, Wo, Wo, Wo, Wo, Wo, Wo, Wo, Wo, Ww, Wo, Wo, Wo, Wo, Wo, Wo, Wo, Wo, Wo
Wo, Wo, Wo, Wo, Wo, Wo, Wo, Wo, Wo, Wo, Ww, Wo, Ww, Wo, Ww, Wo, Wo, Wo, Ww^Es, Co, Ww^Es, Wo, Wo, Ww, Ww, Wo, Wo, Ww, Ww, Ww, Ww, Wo, Wo, Wo, Ww, Wo, Ww, Wo, Ww, Wo
Wo, Wo, Wo, Wo, Wo, Wo, Wo, Wo, Wo, Wo, Ww, Ww, Wo, Wo, Ww, Ww, Wo, Wo, Ww^Es, Ww^Es, Ww^Es, Ww, Wo, Ww, Wo, Wo, Wo, Ww, Wo, Wo, Wo, Wo, Ww, Ww, Ww, Ww, Ww, Ww, Ww, Ww
Wo, Wo, Wo, Wo, Wo, Wo, Wo, Wo, Ww, Wo, Ww, Wo, Ww, Ww, Ww, Wo, Wo, Ww, Ww^Es, Ww^Es, Ww^Es, Wo, Wo, Wo, Wo, Wo, Wo, Wo, Ww, Ww, Ww, Wo, Ww, Ww, Ww, Ww, Ww, Ww, Ww, Ww
Wo, Wo, Wo, Wo, Wo, Ww, Ww, Ww, Ww, Wo, Wo, Wo, Ww, Ww, Ww, Ww, Gg, Khr, Chr, Re, Chr, Khr, Gg, Wo, Wo, Wo, Wo, Ww, Ww, Ww, Ww, Ww, Ww, Ww, Ww, Ww, Ww, Ww, Ss, Ww
Ww, Ww, Wo, Ww, Ww, Ww, Ww, Ww, Wo, Wo, Ww, Ww, Ww, Ww, Wwf, Re, Re, Chr, Re, Re, Re, Chr, Re, Re, Wwf, Wo, Wo, Ww, Ww, Ss, Ss, Ww, Ss, Ww, Ss, Ww, Ss, Ss, Ss, Ss
Ww, Ww, Ww, Ww, Ww, Ww, Ww, Ww, Ww, Ww, Ww, Ww, Wwf, Re, Re, Re, Re, Re, Re, Re, Re, Re, Re, Re, Re, Re, Wwf, Ww, Ss, Ss, Ss, Ss, Ss, Ss, Ss, Ss, Ss, Ss, Gg, Gg
Wo, Wo, Ww, Ww, Ww, Ww, Ww, Ww, Ww, Ww, Gg, Re, Re, Re, Gg, Gg, Re, Gg^Vc, Re, Re, Re, Gg^Vc, Re, Gg, Gg, Re, Re, Re, Gg, Ss, Ds, Ss, Gg, Ss, Ss, Gg, Re, Re^Vct, Re, Gg
Ww, Ww, Ww, Ww, Ss, Ss, Ss, Ww, Ss, Ss, Gg, Re, Gg, Re, Re, Re, Re, Re, Ch, Ch, Ch, Re, Re^Vct, Re, Re, Re, Gg, Gg, Gg, Ds, Gg, Re^Vct, Re, Re, Re, Re, Gs^Fp, Re, Gg, Re
Ww, Ww, Ss, Ss, Gg, Gg, Ss, Ss, Ss^Vhs, Ss, Gg, Gg, Gg, Gg, Re, Gg^Vc, Re, Re, Ch, 4 Kh, Ch, Gg, Re, Gg, Re^Vct, Re, Re, Re, Re, Gg^Vc, Re, Re, Ss, Gs^Fp, Gg, Re^Vct, Ss, Ss, Gg, Gg
Gg, Gg, Gg, Gg, Gg, Ss, Gg, Ss, Gg, Gg, Gg, Gg, Gg, Re^Vct, Re, Re, Gg, Gg, Re, Ch, Re, Re, Gs^Fp, Re, Gg, Gg, Gg, Gs^Fp, Ss, Re, Gs^Fp, Gs^Fp, Gs^Fp, Ss, Gg, Gg, Ss, Gs^Fp, Gg, Gg
Re, Re, Re, Gg, Gg, Gg, Gg, Gg, Gg, Gg, Gg, Gg, Gg, Gg, Gg^Vc, Re, Re, Re, Re, Re, Gs^Fp, Gs^Fp, Gg, Re, Re, Gg, Gg, Gg, Ss, Gs^Fp, Gs^Fp, Ds, Gs^Fp, Gg, Gg, Gs^Fp, Gs^Fp, Gs^Fp, Gs^Fp, Gs^Fp
Gg, Gg, Gg, Re, Hh, Gg, Hh, Gg, Gg, Gg, Gg, Gg, Gg, Gg, Gg, Gg, Re, Re^Vct, Gs^Fp, Re, Re^Vct, Gs^Fp, Gg, Re^Vct, Re, Re^Vct, Gg, Gs^Fp, Gs^Fp, Gs^Fp, Gs^Fp, Ds, Ds, Gs^Fp, Gs^Fp, Gs^Fp, Gs^Fp, Gs^Fp, Gs^Fp, Gs^Fp
Hh, Hh, Hh, Re^Vct, Re, Hh, Hh, Hh, Hh, Gg, Gg, Gg, Hh, Hh, Gg, Gg, Re, Gs^Fp, Gs^Fp, Re, Gs^Fp, Gs^Fp, Gg, Gg, Re, Gg, Gs^Fp, Gg, Gg, Ds, Ds, Ds, Gs^Fp, Gs^Fp, Gs^Fp, Ce, Gs^Fp, Gg, Gg, Gg
Hh, Hh, Hh, Hh, Hh, Re^Vct, Re, Hh, Gg, Gg, Gg, Gg, Hh, Gg, Gg, Re^Vct, Re, Gs^Fp, Re, Re, Re, Gg, Re^Vct, Re, Gg, Gg, Gg, Gg, Gg, Gs^Fp, Re^Vct, Re, Gs^Fp, Gs^Fp, Ce, 2 Ke, Ce, Gg, Gg, Gg
Hh, Hh, Hh, Hh, Hh, Gg, Re^Vct, Gg, Gg, Gg^Vc, Re^Gvs, Gg, Gg, Gg, Gg^Vc, Gg, Gg, Re, Re, Gs^Fp, Gs^Fp, Re, Gg, Re, Re, Gg, Gg^Vc, Gs^Fp, Gs^Fp, Gs^Fp, Re, Re, Gs^Fp, Gs^Fp, Ce, Ce, Ce, Gs^Fp, Gs^Fp, Gs^Fp
Hh, Hh, Mm, Hh, Ce, Gg, Hh, Re, Re, Re^Gvs, Re, Re, Re, Re^Gvs, Re^Gvs, Re^Gvs, Gg, Re^Vct, Re, Gg, Gg, Gg, Gg, Gg, Gg, Re, Re, Gs^Fp, Gs^Fp, Re^Vct, Re, Re^Vct, Gs^Fp, Gs^Fp, Gg, Gg, Ss, Ss, Gs^Fp, Gs^Fp
Hh, Hh, Hh, Hh, 3 Ke, Ce, Gg, Re^Vct, Hh, Re^Gvs, Gg, Gg, Gg, Re, Re^Gvs, Re, Re, Gg, Re, Re^Vct, Gg^Efm, Gg^Efm, Gg, Gg, Gg, Gg, Re, Re^Vct, Gs^Fp, Ss, Re, Gs^Fp, Gs^Fp, Gs^Fp, Gg, Gs^Fp, Ss, Gs^Fp, Gs^Fp, Gs^Fp
Mm, Mm, Mm, Ce, Ce, Ce, Hh, Hh, Hh, Gg, Gg, Hh, Hh, Gg, Gg, Gg, Re^Vct, Re, Gg, Gg, Gg, Gg, Gg, Gg, Gg, Gg, Gg, Re, Re, Re, Ss, Gs^Fp, Gs^Fp, Gg, Gg^Ve, Gg, Gs^Fp, Gs^Fp, Gs^Fp, Gs^Fp
Mm, Mm, Mm^Vc, Mm, Hh, Hh, Hh, Hh, Hh, Hh, Gg, Hh^Vhh, Gg, Hh, Gg, Gg, Re, Re, Gg, Gg, Gg, Gg, Gg, Gg, Gg^Efm, Gg, Gg^Ve, Gg, Gg, Re^Vct, Gs^Fp, Gg, Gg, Gg, Ss, Gs^Fp, Gs^Fp, Gg^Fet, Gs^Fp, Gs^Fp
Mm, Mm, Mm, Mm, Hh, Hh, Hh, Mm, Hh, Hh, Hh, Gg, Gg, Gg, Re, Re, Re^Vct, Gg, Gg, Gg, Gg, Gg, Gg, Gg, Gg, Gg, Re^Gvs, Re^Gvs, Ss, Gg, Gg, Gg, Gg, Gg, Gg, Ss, Gs^Fp, Gs^Fp, Gs^Fp, Gs^Fp
Mm, Mm, Mm, Mm, Mm, Mm, Hh, Hh, Hh, Hh, Gg, Gg, Gg, Re^Vct, Re, Gg, Gg, Gg, Gg, Gg, Gg, Gg, Gg, Gg, Ss, Gg, Gg, Gg, Gg, Gg, Gg, Gg, Gs^Fp, Gs^Fp, Gg, Gg, Gg, Gs^Fp, Gs^Fp, Gs^Fp
Mm, Mm, Mm, Mm, Mm, Hh, Hh, Hh, Hh, Gg, Gg, Re^Gvs, Re^Gvs, Gg, Re, Gg, Gg, Gg, Gg, Gg, Gg, Gg, Ss, Ss, Ss, Gg, Gg, Gg, Gg, Gg, Gg, Gg, Gg, Gs^Fp, Gs^Fp, Gs^Fp, Ss, Gs^Fp, Gs^Fp, Gs^Fp
Mm, Mm, Mm, Mm, Hh, Hh, Hh, Hh, Gg, Gg, Gg^Vh, Re^Gvs, Re^Gvs, Gg, Re, Re^Vct, Gg, Gg, Gg, Gg, Gg^Vh, Ss, Gg, Ss, Gg, Ss, Ss, Gg, Gg, Gg, Gg, Gg, Gg, Gg, Gg, Ss, Gs^Fp, Gs^Fp, Gs^Fp, Gs^Fp
Mm, Mm, Mm, Mm, Hh, Hh, Gg, Hh, Gg, Gg, Gg, Gg, Gg, Gg, Re, Gg, Gg, Ss, Gg, Gg, Gg, Gg, Ss, Ss, Ss, Ss, Ss, Ss, Gg, Gg, Gg, Gs^Fp, Gs^Fp, Gg, Gs^Fp, Gs^Fp, Gs^Fp, Gs^Fp, Gg^Fet, Gs^Fp
Mm, Mm, Mm, Mm, Hh, Hh, Gg, Gg, Gg^Efm, Gg^Efm, Gg^Efm, Gg, Re, Re, Gg, Gg, Ss, Ss, Ss, Ss, Ss, Ss, Ss^Vhs, Ss, Ss, Gg, Gg, Ss, Gg, Gg, Re^Gvs, Gs^Fp, Gg, Gs^Fp, Gg, Gs^Fp, Gs^Fp, Gs^Fp, Gs^Fp, Gs^Fp
