Mm, Mm, Mm, Mm, Mm, Mm, Mm, Mm, Hh^Fdw, Hh, Hh^Fdw, Mm, Mm, Wwg, Wwg, Mm, Mm, Mm, Hh^Fdw, Mm, Mm, Mm
Mm, Mm, Mm, Mm, Hh^Fdw, Mm, Mm, Mm, Hh^Fdw, Hh, Hh^Em, Mm, Hh^Fdw, Wwg, Wwg, Mm, Mm, Hh^Fmw, Hh, Mm, Mm, Mm
Mm, Hh, Hh^Fmw, Hh, Gs^Vht, Hh^Em, Hh, Hh^Fmw, 2 Co^Kov, Co, Re, Hh^Fmw, Gg^Vht, Hh^Es, Wwg, Wwg, Hh^Es, Gs^Fms, Gs^Vht, Hh^Fp, Hh^Fmw, Hh^Fmw
Hh, Mm, Hh^Fp, Hh^Em, Hh^Fdw, Re, Re^Es, Co, Co, Re^Es, Re^Es, Re, Gg^Efm, Wwg, Wwg^Bw/, Wwg^Bw\, Re, Re^Es, Gll^Fmw, Gll^Fp, Ss, Gll^Fdw
Hh^Fp, Hh^Fp, Gs^Fms, Gs^Em, Hh^Fp, Hh, Re, Gs, Gs^Fmw, Gg^Efm, Re, Gg, Re, Re, Wwg, Wwg, Wwg, Gll^Fp, Gll^Fdw, Gll^Fmw, Ss^Em, Ss
Mm, Hh^Fms, Gs^Fds, Gs^Fms, Gs^Fp, Re^Es, Gs, Gs^Fp, Gs^Fmw, Gs^Vht, Re, Re, Gg^Efm, Gg, Wwg, Rb^Es, Ss, Sm, Sm, Ss^Em, Sm^Uf, Ss^Emf
Hh^Fp, Mm, Gs^Fms, Gs^Efm, Gs^Vht, Re^Es, Re, Gs^Fmw, Gg^Es, Re, Gg^Efm, Re^Es, Gs^Vht, Wwg, Gll^Fmw, Rb^Fdw, Ss^Em, Gll^Em, Rb^Emf, Rb^Em, Sm^Em, Sm^Emf
Hh, Hh, Gs^Fp, Gs^Fms, Gg, Gs^Efm, Re, Re^Es, Re, Re, Gs^Fdw, Gs, Gll^Fdw, Wwg, Wwg, Gll^Fdw, Sm^Em, Ss^Uf, Sm^Uf, Sm, Rb^Fdw, Sm^Em
Re, Re, Re^Es, Gg^Efm, Re^Es, Re, Gg^Efm, Gs^Vht, Gs, Re^Es, Gs, Gs^Fmw, Gll^Fmw, Gll^Em, Hhd^Fdw, Hhd^Emf, Gll^Fdw, Ss^Em, Ss^Em, Ss^Em, Gll^Fmw, Gll^Fdw
Gs^Fms, Gs^Em, Gs^Fp, Re^Es, Gs^Em, Gs^Fp, Gs^Fp, Gs, Gs^Fp, Re^Es, Gs^Fp, Gd^Fdw, Gd, Gll^Em, Gll^Fmw, Gll^Fmw, Gll^Fdw, Hhd^Em, Hhd^Fdw, Hhd, Hhd, Hhd
Gs^Fms, Hh^Fp, Hh^Fms, Gs^Fp, Gs^Fms, Gs^Fp, Gs^Fms, Gs^Fms, Hh^Fp, Gs^Em, Gs^Fp, Gs^Fmw, Gs^Fp, Gs^Emf, Gd^Fp, Gll^Fmw, Gll^Fp, Gd^Em, Hhd^Fmw, Gll^Fmw, Hh^Fp, Hhd^Fp
Gs^Fds, Hh^Fds, Hh^Fms, Gll^Emf, Gs^Fp, Hh^Fms, Gs^Fms, Hh^Efm, Gs^Fms, Gs^Fp, Gs^Fp, Gs, Gg^Efm, Gs^Fmw, Ce, Gd^Fp, Gs^Efm, Hh^Fmw, Gs^Fp, Gll^Em, Hh^Fmw, Hh^Fp
Hh^Fp, Hh, Hh, Gll^Fmw, Hh, Mm, Gs^Fds, Gs^Fds, Hh^Fp, Gg^Efm, Gs^Fp, Gs^Fp, Hh^Fp, Ce, 1 Ke, Ce, Gs^Fmw, Gd^Fp, Hh^Fmw, Hh^Fmw, Mm, Mm
Mm, Mm, Mm, Hh^Fdw, Hh, Hh^Fp, Hh^Fms, Hh^Fms, Hh^Fms, Gs^Fp, Hh^Fms, Gg^Efm, Hh^Fmw, Ce, Ce, Ce, Gs^Efm, Gs^Em, Hh^Fdw, Hh^Fdw, Mm, Mm
Mm, Mm, Hh^Fdw, Hh^Fmw, Mm, Hh^Fp, Mm, Mm, Mm, Mm, Mm, Hh^Fp, Hh^Fp, Gg^Efm, Gs^Fmw, Hh^Fmw, Hh^Fmw, Hh, Mm, Mm, Mm, Mm
Mm, Mm, Mm, Mm, Mm, Hh^Fmw, Mm, Mm, Mm, Mm, Mm, Hh^Fp, Gs^Fp, Gs^Es, Gs^Fp, Gs^Fp, Hh^Fdw, Hh, Mm, Mm, Mm, Mm
