Wo, Wo, Mm^Xm, Mm^Xm, Mm^Xm, Mm^Xm, Mm^Xm, Mm^Xm, Mm, Mm^Xm, Hh^Fmw, Mm, Mm, Hh, Hh^Fmw, Hh, Gs, Gd, Re, Gg, Hh^Fmw, Mm, Mm^Xm, Mm^Xm, Ms^Xm, Mm^Xm, Ms^Xm, Mm^Xm, Ai, Ai, Wo, Ai, Ms
Wo, Wo, Mm^Xm, Mm^Xm, Mm^Xm, Mm^Xm, Mm, Mm^Xm, Mm, Mm, Hh^Fp, Mm, Gs^Efm, Hh^Fdw, Mm, Gs^Efm, Gd^Em, Gd^Edpp, Re, Hh^Em, Mm, Mm, Mm^Xm, Mm^Xm, Mm^Xm, Mm^Xm, Ms^Xm, Ms, Wo, Wo, Ai, Ai, Ms
Mm, Wo, Wo, Mm^Xm, Mm^Xm, Mm, Mm, Mm, Mm, Mm, Hh^Vo, Hh^Fdw, Hh^Em, Gs, Hh, Hh^Em, Re^Es, Re^Es, Hh^Emf, Hh^Fmw, Hh^Fmw, Mm, Mm, Mm^Xm, Mm, Mm, Hh^Fdw, Ms, Wo, Ms, Ms^Xm, Ms^Xm, Ms^Xm
Mm^Xm, Wo, Wo, Wo, Mm^Xm, Mm, Gs^Fp, Gs^Fp, Hh^Fmw, Hh^Fdw, Re, Hh, Gs, Gd^Edpp, Re, Re, Gd^Edpp, Aa^Fda, Ha^Fma, Hh^Fdw, Mm, Mm, Wo, Mm, Mm, Hh, Wo, Wo, Ha, Ms, Ms^Xm, Ms^Xm, Ms^Xm
Mm^Xm, Mm^Xm, Mm^Xm, Mm^Xm, Mm, Mm, Hh^Em, Gs^Fmw, Gs^Fdw, Re, Gd^Edpp, Re^Es, Gd^Edb, Gd^Edb, Re^Edb, Gd, Aa^Voa, Ha^Fda, Ha^Fpa, Hh^Fdw, Ms, Ms, Wo, Wo, Wo, Wo, Hh, Wo, Ai, Ai, Ms, Ms^Xm, Wo
Mm^Xm, Mm^Xm, Mm^Xm, Mm^Xm, Mm, Hh^Vo, Hh^Fdw, Gd^Edpp, Re, Gd, Gd^Fdw, Aa, Aa, Re^Edb, Co^Edb, Aa, Ha^Edb, Ha^Fpa, Ms, Ha^Fma, Wo, Wo, Mm, Wo, Mm, Mm, Hh^Fdw, Wo, Wo, Wo, Wo, Wo, Ai
Mm, Mm^Xm, Mm, Mm, Mm, Hh^Fp, Re^Es, Re^Es, Gd^Es, Aa, Aa^Fda, Ha^Fda, Aa^Fma, Co^Edb, 3 Koa, Coa^Edb, Ms^Edb, Ms, Ms, Wo, Ms, Ms, Ms, Hh^Fdw, Hh^Fmw, Hh^Fmw, Wo, Wo, Ha^Fda, Ai, Ha, Ha^Fda, Ha
Mm^Xm, Mm, Mm, Hh^Fdw, Gs^Fmw, Gd^Fmw, Re, Gd, Aa^Fda, Aa, Ha, Aa^Fpa, Ha^Voa, Coa, Coa, Ha^Edb, Wo, Ms, Wo, Wo, Ms, Ms, Ms, Ha^Fdw, Hh^Emf, Gd^Fmw, Gd^Emf, Wo, Wo, Ms, Ms^Xm, Ms^Xm, Ms^Xm
Mm^Xm, Mm^Xm, Mm, Mm, Hh^Fdw, Gd^Em, Re^Es, Hh^Fdw, Mm, Mm, Ha^Fda, Ms, Ms, Ms, Ms, Wo, Wo, Wo, Ms, Wo, Ms, Ms, Aa^Vca, Ha^Fda, Ha^Fda, Aa^Fdw, Ww^Ewl, Wo, Wo, Ms, Ms, Ms^Xm, Mm^Xm
Mm^Xm, Mm, Mm, Mm, Hh^Fmw, Re, Hh, Mm, Mm, Hh, Ms, Ms, Wo, Ms, Wo, Wo, Ai, Ai, Ms, Ha^Fda, Ha^Fda, Ms, Aa, Aa^Fpa, Aa^Fda, Ww^Ewl, Ww, Ww^Ewf, Wo, Wo, Mm^Xm, Mm^Xm, Mm^Xm
Mm^Xm, Mm, Hh^Fp, Mm, Hh^Em, Hh, Gd^Edpp, Hh^Fdw, Mm, Ms, Ms, Wo, Ha, Wo, Ms, Wo, Wo, Ms, Ha^Fda, Ms, Ha, Gd, Gd, Gd, Aa, Aa, Ww, Wo, Mm, Mm, Mm^Xm, Mm^Xm, Mm^Xm
Wo, Mm, Hh^Fdw, Gs^Fmw, Gd^Fdw, Re, Gd^Es, Aa, Ha^Es, Ha, Wo, Wo, Ms, Ms, Ms, Ms, Wo, Ha^Fda, Ha, Ha^Fpa, Re, Re^Es, Re, Re^Es, Re, Gd^Edpp, Ww^Ewl, Ww, Ww^Ewl, Mm, Mm, Mm^Xm, Mm^Xm
Wo, Hh, Hh^Fmw, Gd^Fmw, Gd, Re, Aa, Aa^Voa, Ai, Ai, Ai, Ai, Ai, Ms, Wo, Ai, Ha, Ms, Re^Es, Re, Ha, Aa, Ha^Fda, Aa, Gd^Es, Gd, Gs, Ww^Ewl, Hh^Fmw, Mm, Mm, Mm, Mm
Mm, Wo, Ww, Re^Es, Re^Es, Gd^Edpp, Aa, Ai, Ai, Wo, Ai, Ai, Wo, Aa, Ai, Ai, Ha^Vhha, Re^Es, Ha^Fda, Gd^Es, Ha^Fma, Ha^Fda, Aa, Aa, Ha, Re, Gd^Fdw, Hh^Em, Gd^Fp, Hh, Hh^Fdw, Mm, Mm
Hh^Fmw, Ww, Ww^Ewf, Ww^Ewl, Hh, Gd^Edpp, Re^Es, Ai, Ai, Ai, Ai, Ai, Ai, Aa, Aa, Aa, Gd, Re, Aa^Fda, Ha, Ms^Xm, Ha^Fpa, Ha^Fda, Ms, Aa^Fda, Re^Es, Re^Es, Gd^Emf, Gd^Fmw, Hh^Fmw, Hh^Fdw, Mm, Mm
Mm, Hh, Wo, Ww^Ewl, Re, Re, Aa, Aa, Ai, Wo, Wo, Wo, Ai, Ai, Re^Es, Gd, Re^Es, Re^Es, Ha, Ms, Ms^Xm, Ms^Xm, Ms, Ha^Fda, Aa^Fma, Aa, Re, Gs^Fdw, Hh^Fmw, Mm, Mm, Mm, Hh
Mm^Xm, Mm, Wo, Hh, Gs^Efm, Re^Es, Aa, Ai, Ai, Ai, Ai, Ai, Ai, Ai, Aa, Re, Gd^Es, Ha, Ms, Ms^Xm, Ms^Xm, Wo, Ms, Ha^Fma, Ha^Vhha, Aa, Gd^Edpp, Re, Hh, Mm, Mm, Mm, Mm
Wo, Wo, Mm, Ww^Ewl, Gd^Es, Re, Re, Ai, Wo, Ai, Wo, Ai, Ai, Ai, Aa, Re, Aa, Ha^Fpa, Ms, Wo, Wo, Wo, Ms^Xm, Ms, Aa, Aa, Gs, Re, Re^Es, Gd^Vct, Mm, Mm, Mm
Mm, Wo, Hh^Fmw, Hh, Gd^Es, Re^Es, Re, Aa, Aa, Wo, Wo^Bw/, Wo^Bw/, Wo^Bw\, Wo, Wo^Bw/, Re, Ha^Em, Ha^Fma, Ms^Xm, Wo, Wo, Ms, Mm, Mm^Xm, Mm, Gd^Es, Ce, Ce, Ce, Gd^Es, Hh^Fdw, Hh^Fmw, Mm
Mm^Xm, Mm^Xm, Mm, Ha^Em, Aa, Aa, Gd^Es, Re, Re, Re, Re, Wo, Wo, Wo^Bw/, Wo, Aa, Aa^Fda, Ms, Ms, Ms^Xm, Ms^Xm, Wo, Wo, Mm, Mm, Gd^Es, Ce, 1 Ke, Ce, Mm, Hh, Mm, Hh
Mm^Xm, Mm^Xm, Ms, Ha, Aa^Fda, Aa, Aa, Re, Hh^Fdw, Hh, Re, Wo, Wo, Wo, Wo, Wo, Ai, Ha, Ms, Ms^Xm, Ms^Xm, Wo, Wo, Mm, Hh^Fdw, Hh^Em, Gd^Vct, Ce, Re^Es, Hh, Gs^Efm, Hh^Fdw, Re
Mm^Xm, Mm^Xm, Mm^Xm, Ms, Ha, Aa^Es, Ha, Aa, Aa^Es, Gd^Es, Gd^Fdw, Gd^Vo, Ww^Ewl, Wo, Gd, Wo, Wo, Ai, Wo, Ha, Wo, Wo, Ms, Mm, Aa^Fda, Hh^Fdw, Aa, Gs^Es, Re, Gd, Re^Es, Re^Es, Gd
Mm^Xm, Mm^Xm, Ms^Xm, Ms, Ha^Fma, Ha^Voa, Ha^Fda, Ha^Fma, Ha, Hh^Es, Hh^Fdw, Hh^Fmw, Gd^Es, Ww, Ww, Ww, Ww, Wo, Ai, Wo, Wo, Ha, Ms^Xm, Aa^Fma, Ms, Ha^Em, Aa^Fda, Aa, Gd^Edpp, Re, Gd^Fmw, Hh, Hh^Fmw
Ms^Xm, Ms^Xm, Ms, Ha^Fda, Ha^Fpa, Ms, Ms, Ms, Aa^Em, Aa^Em, Coa, Co, Co^Edb, Ww^Ewl, Ha, Ai, Ha^Fda, Ww, Wo, Wo, Ha, Ms, Ms^Xm, Ms, Mm^Xm, Mm, Hh^Fmw, Hh^Em, Ha^Fda, Ha, Mm, Hh^Fdw, Hh
Ms, Ms^Xm, Ms^Xm, Ms, Ms, Ms, Ms, Ms, Ha, Ha^Fda, Aa^Edb, 2 Koa, Coa^Edb, Gd^Edb, Gd^Es, Aa, Ha^Em, Ai, Ww, Wo, Ai, Ms, Ms, Mm, Mm^Xm, Mm, Mm, Mm, Mm, Ms, Mm^Xm, Mm, Mm
Mm^Xm, Mm^Xm, Mm^Xm, Mm^Xm, Mm^Xm, Ms^Xm, Ms, Ms, Ha^Fma, Aa^Em, Aa^Fda, Aa^Edb, Aa, Aa^Edb, Aa^Fda, Aa^Em, Ha^Fda, Ha, Aa, Wo, Wo, Ha, Ms, Ms^Xm, Mm^Xm, Mm^Xm, Mm^Xm, Mm^Xm, Ms^Xm, Ms^Xm, Ms^Xm, Ms^Xm, Ha
Mm^Xm, Mm^Xm, Mm^Xm, Mm^Xm, Mm^Xm, Ms, Ms, Ha^Voa, Ha, Ha^Fda, Ms, Ha^Em, Aa, Ha^Voa, Ha^Fma, Aa^Fma, Ha^Fda, Ha^Fma, Aa^Fma, Ai, Wo, Hh, Mm, Mm, Mm, Mm^Xm, Ms, Ms^Xm, Ms^Xm, Ms^Xm, Ms, Ms, Ms
Mm^Xm, Mm, Mm^Xm, Mm^Xm, Mm, Mm, Ms, Ha^Fpa, Hh^Fpa, Ha^Fma, Ms, Ms, Ha, Ha^Em, Gs^Fma, Ms, Hh, Aa^Fpa, Aa, Ai, Ww, Wo, Wo, Hh, Mm, Mm, Ms, Ms, Gg, Ms, Ms, Ha, Gg
