Mm, Mm, Mm, Mm, Mm, Mm, Hh^Fmw, Hh, Hh^Fp, Gs^Fp, Gg^Efm, Re, Hh, Hh^Fp, Gg^Fp, Hh, Hh^Fmw, Mm, Hh^Fp, Mm, Mm, Mm, Mm, Mm^Xm, Mm^Xm, Mm, Mm^Xm, Mm^Xm, Mm^Xm, Mm^Xm, Mm^Xm, Mm^Xm, Mm^Xm, Mm, Mm^Xm, Mm, Mm, Mm, Mm^Xm, Gg, Mm^Xm, Gg
Mm, Mm, Mm, Hh^Fp, Hh^Fp, Hh, Hh^Fdw, Mm, Mm, Gg^Efm, Hh^Fp, Re^Es, Gs^Fdw, Gg^Fmw, Gg^Fmw, Hh^Fmw, Hh, Mm, Mm, Hh^Fp, Mm, Mm, Mm, Mm, Hh^Vhh, Mm, Mm, Mm, Mm, Mm, Mm, Mm, Mm, Mm^Xm, Mm^Xm, Mm^Xm, Mm, Mm, Mm, Mm^Xm, Mm, Mm^Xm
Mm, Mm, Mm, Hh^Fmw, Gd^Fdw, Gd^Es, Re^Vct, Hh^Fdw, Gs^Edpp, Hh^Fp, Re, Re^Es, Gs^Em, Gg^Emf, Hh^Fdw, Gs^Fp, Gg^Fp, Hh^Fmw, Hh^Fdw, Hh^Fmw, Hh^Fdw, Hh^Fmw, Mm, Mm, Hh^Emf, Mm, Mm, Mm, Hh^Fms, Hh^Fp, Mm, Mm, Mm, Mm^Xm, Mm, Mm, Hh^Fp, Hh^Fms, Hh^Fp, Mm, Hh, Mm
Mm, Mm, Mm, Hh^Fdw, Gd^Edp, Re^Es, Hh^Es, Re, Re^Es, Re^Es, Gs^Efm, Gg, Gg^Efm, Hh^Em, Hh^Vc, Gg^Fmw, Hh^Fmw, Hh^Fp, Hh^Fmw, Hh^Emf, Hh^Em, Mm, Hh^Fmw, Hh^Fp, Hh^Em, Hh^Fp, Hh^Fp, Hh^Fms, Ww^Ewl, Hh^Fp, Hh^Fmw, Mm, Mm, Mm, Mm, Hh^Fp, Wwr, Hh^Fmw, Wwr, Hh^Fmw, Wwr, Wwr
Mm, Hh^Fmw, Hh^Fdw, Mm, Hh^Fdw, Gd^Edpp, Co^Edb, Hh^Fp, Re^Edb, Gs, Gs, Gg^Efm, Hh^Fdw, Gg^Efm, Hh^Fmw, Hh^Fdw, Mm, Hh^Fp, Hh^Em, Re^Wm, Hh, Hh^Fdw, Re, Hh^Em, Mm, Hh^Fmw, Gg^Fp, Gg^Fms, Ww^Ewl, Mm, Mm, Hh^Fmw, Mm, Mm, Hh^Fmw, Ww^Ewl, Wwr, Wwr, Ww, Ww, Ww^Ewl, Wwr
Mm, Mm, Mm, Hh^Vo, Gd^Edp, Re^Edb, 2 Ko, Co^Edb, Re^Edb, Gd^Edpp, Gs^Edpp, Hh, Gs^Em, Gs, Hh^Fp, Mm, Mm, Mm, Hh^Vhh, Re^Gvs, Re^Gvs, Hh^Em, Re^Es, Hh, Hh^Em, Hh^Fmw, Ww^Ewl, Ww, Ww, Mm, Ww, Ww^Ewl, Ww^Ewl, Mm, Ww, Ww, Ww^Ewf, Ww^Ewf, Ww^Ewl, Md, Md, Md
Hh^Fmw, Mm, Mm, Gd^Fmw, Gd^Fdw, Re^Edb, Co^Edb, Re^Edb, Gd^Edb, Re, Re^Edb, Hh^Fdw, Gs^Fp, Hh^Em, Mm, Hh^Fmw, Hh^Em, Hh^Fmw, Re^Gvs, Re^Gvs, Re^Gvs, Re^Es, Re, Gs^Es, Ce, Gg^Efm, Ww, Ww, Hh^Em, Ww, Hhd^Fdw, Ww, Ww, Ww, Hhd^Fdw, Ww, Re^Edb, Ww^Ewl, Re^Es, Md, Md, Md
Ww, Hh^Fmw, Hh^Fp, Hh^Fmw, Gd^Fdw, Gd^Edpp, Gd, Gd^Edb, Gs, Gs^Edb, Re^Es, Gs, Hh^Fdw, Hh^Fmw, Hh, Hh^Vl, Hh, Hh^Fdw, Gd, Re^Gvs, Gd^Edpp, Re, Gs^Vh, Re, Ww^Bw\, Ww, Ww, Mm, Hh^Fdw, Hhd^Fmw, Mm, Mm, Gd^Vo, Rd^Es, Re^Es, Re^Edb, Re^Edb, Re^Edb, Rd^Es, Re, Re^Es, Re
Ww, Gs^Fp, Gg^Em, Hh^Emf, Gs^Fmw, Hh^Fmw, Hh^Es, Gd^Vct, Gs^Es, Gs^Es, Gd^Fmw, Re, Re, Re, Re^Es, Re^Es, Re, Gs^Edpp, Gs^Efm, Gd^Edpp, Re, Re, Re^Es, Ww^Ewl, Ww^Ewl, Ww^Bw\, Ww^Bw\, Ww^Ewl, Hh^Em, Hh^Fp, Hhd^Fdw, Hhd^Fmw, Re, Hhd^Edpp, Re, Re^Edb, 4 Ko, Re^Edb, Hhd^Edpp, Hhd^Es, Hhd^Edpp, Hhd^Edpp
Ww^Ewl, Ww^Ewl, Gg^Es, Gs^Fdw, Ww^Ewl, Gs^Em, Gs^Es, Gs^Efm, Gs^Em, Gd^Fdw, Hh^Fdw, Re^Es, Hh^Em, Hh^Fdw, Gd^Fdw, Re, Re^Es, Re^Es, Re, Re^Es, Gs, Re^Es, Re^Vct, Ww^Ewl, Ww^Ewf, Ww, Ww, Re^Es, Re, Hh^Fmw, Rd^Es, Rd^Es, Gd^Ecf, Re^Es, Hhd^Fdw, Co, Co, Co, Hhd^Vct, Md, Md, Hhd^Fdw
Ww, Ww, Ww, Ww, Ww, Gg^Efm, Gs^Fdw, Gs^Fmw, Gs^Fp, Gs^Em, Hh^Em, Re^Es, Hh^Vc, Hh^Fmw, Gs^Em, Re, Gs^Fmw, Gs, Re^Es, Re^Vct, Ce, Ce, Ce, Ww, Ww, Ww, Gs^Fp, Gs^Efm, Gd^Es, Re, Re^Es, Re^Edb, Gd^Edb, Hhd^Vct, Md, Gd^Es, Hhd^Fdw, Hhd, Mm, Hhd^Fdw, Hhd, Hhd^Fdw
Wwr, Wwr, Wo, Wwr, Wwr, Ww^Ewl, Ww^Ewl, Gs^Fmw, Hh^Fdw, Gg^Efm, Re, Re, Gd^Em, Gd^Es, Gs^Fmw, Gs^Emf, Gg^Fp, Gg^Efm, Gs^Vh, Gg^Em, Ce, 1 Ke, Gs^Fmw, Ww^Ewl, Ww, Gs^Fmw, Gs^Fmw, Gs^Fdw, Re, Re, Gd, Hhd^Edb, Hhd, Md, Md, Hhd, Mm, Mm, Mm^Xm, Mm, Mm, Mm
Ww^Ewl, Wo, Wo, Ww^Ewl, Wwr, Wwr, Ww, Gg^Em, Gg^Efm, Re^Es, Gg^Efm, Gs^Fmw, Ww^Ewl, Gs^Fdw, Gg^Fdw, Ww^Ewl, Ww^Ewl, Gg^Efm, Gg^Em, Gs^Fdw, Gs^Fmw, Gs^Em, Gs^Em, Gs^Fmw, Ww, Gs^Em, Wwr, Gd^Fdw, Ww, Re^Es, Gd, Hhd^Es, Hhd^Fdw, Md, Hhd^Fdw, Hhd^Vo, Mm, Mm, Mm^Xm, Mm^Xm, Mm^Xm, Mm
Wo, Wwr, Wo, Wo, Wo, Wo, Wo, Ww, Ww, Re, Ww, Gg^Efm, Ww^Ewf, Ww^Ewl, Ww, Ww^Ewl, Wwr, Ww, Ww, Ww^Ewl, Gs^Em, Gg^Efm, Gg^Efm, Gs^Fdw, Gg^Efm, Ww, Ww^Ewf, Wwr, Ww^Ewl, Re^Es, Hhd^Es, Hhd^Fdw, Hhd^Es, Hhd^Es, Hhd^Fdw, Mm, Mm, Mm^Xm, Mm^Xm, Mm^Xm, Mm, Mm^Xm
Wo, Wo, Wo, Wo, Ww^Ewl, Wo, Ww^Ewf, Wwr, Ww, Ww^Bw|, Ww, Ww, Wwr, Wwr, Wo, Wwr, Wo, Wwr, Wo, Ww, Ww, Ww, Ww, Gg, Gg, Ww, Ww, Ww^Ewl, Hh^Fmw, Re, Gd, Gd^Fmw, Hh^Em, Md, Mm, Mm, Mm, Mm^Xm, Mm, Mm, Hh^Fp, Mm
Mm, Wo, Hh, Wo, Hh^Fp, Wwr, Ww, Ww, Ww, Ww^Bw|, Ww, Wo, Wo, Wo, Wo, Wo, Wwr, Wo, Wo, Wo, Wwr, Ww, Wo, Ww, Ww, Ww^Bw\, Gs^Efm, Hh^Fp, Re^Es, Re^Es, Hh^Fmw, Gs^Fp, Hh^Fmw, Hhd^Es, Mm, Mm, Hh^Fmw, Hh^Es, Hh^Fmw, Hh^Fp, Hh^Fmw, Hh^Fp
Mm, Wo, Wo, Mm, Mm, Hh^Fmw, Hh^Fp, Hh^Fdw, Hh, Re, Gg^Efm, Wwr, Wo, Wo, Ww, Wwr, Re^Gvs, Ww, Ww, Wo, Wo, Wo, Wo, Ww, Ww^Ewl, Ww, Ww, Gs^Em, Re, Hh^Em, Hh^Fdw, Hh^Em, Hh^Em, Mm, Mm, Hh^Fdw, Gg^Em, Hh^Em, Mm, Mm, Mm, Hh
Mm, Wo, Wo, Mm, Wo, Hh^Fdw, Mm, Hh^Em, Gg^Em, Re, Gg^Efm, Ww, Ww, Wo, Ww^Ewl, Re^Gvs, Re^Gvs, Re^Gvs, Wwr, Wo, Wo, Wo, Ww, Ww, Ww^Ewl, Ww^Ewl, Ww^Bw/, Ww^Bw/, Ww, Gs^Fp, Gs^Fp, Gs^Fmw, Hh^Fp, Hh^Fmw, Hh^Fdw, Hh^Fp, Gg^Emf, Gs^Fp, Gs^Fp, Hh^Fmw, Hh^Fp, Hh^Fp
Mm, Mm, Mm, Wo, Mm, Mm, Mm, Hh^Fmw, Gs, Re, Re, Gg^Em, Gs, Ww^Ewl, Re^Wm, Re^Gvs, Hh^Vhh, Ww^Ewl, Ww, Wo, Wo, Wo, Ww, Gs^Fp, Re, Re^Es, Gg^Efm, Ww, Wwr, Ww^Ewl, Hh, Gs^Fp, Gg^Fp, Gs^Fp, Gg^Emf, Gs^Fdw, Mm, Hh^Fmw, Mm, Mm, Mm, Mm
Md, Mm, Mm, Mm, Mm, Mm, Mm, Hh^Em, Re^Es, Re^Es, Gs^Efm, Re^Es, Re^Es, Gs, Gs^Es, Hh^Em, Hh^Es, Ww, Ww, Wwr, Ww^Ewf, Ww^Ewf, Ww^Ewl, Gs^Fmw, Re^Es, Gg^Em, Gs^Fmw, Wwr, Wwr, Ww^Ewl, Gs^Em, Gs^Fmw, Hh^Fmw, Gg^Fmw, Gg^Em, Mm, Hh^Es, Hh^Fp, Mm, Mm, Mm^Xm, Mm^Xm
Mm^Xm, Md, Hhd^Fdw, Mm, Hhd^Fmw, Md, Hhd^Edpp, Hhd^Fdw, Gs, Re, Gd^Edpp, Gs, Re, Gs^Efm, Re, Hh^Es, Gd, Hh^Fdw, Gd^Edpp, Ww, Hh^Em, Ww^Ewl, Re, Re, Re, Gg^Fp, Gs^Vc, Gs^Fmw, Wwr, Ww, Hh, Hh^Fdw, Hh^Fdw, Gs^Fp, Hh^Fmw, Hh^Es, Mm, Hh^Fdw, Mm, Mm^Xm, Mm^Xm, Mm^Xm
Mm^Xm, Mm^Xm, Mm, Hhd^Fmw, Hhd^Em, Hhd^Fdw, Re^Vct, Re^Es, Re^Es, Gd, Co, Gd^Edpp, Re^Es, Re^Es, Gd^Vo, Re, Re, Re, Re^Es, Gd^Em, Hh^Fmw, Hh^Fdw, Re, Gs, Re^Es, Gs^Em, Gd^Es, Ww^Ewl, Ww^Ewl, Ww, Ww, Gs^Efm, Gs^Em, Gg^Fmw, Gs^Fp, Hh^Fp, Hh^Fdw, Mm, Mm^Xm, Mm^Xm, Mm^Xm, Mm^Xm
Mm^Xm, Mm^Xm, Mm, Md, Hhd, Gd^Edpp, Re^Es, Re^Edb, Re, Co^Edb, 3 Ko, Re^Edb, Re^Edb, Hhd, Hhd^Edpp, Gd^Es, Gs, Hh^Es, Gs, Re, Re^Es, Re, Hh^Fdw, Gs^Fmw, Gd^Em, Re, Re^Gvs, Re^Gvs, Rd^Es, Wwr, Ww^Ewl, Ww, Hh^Fdw, Hh^Fmw, Ww^Ewl, Hh^Fmw, Mm, Mm, Mm, Mm^Xm, Mm^Xm, Mm^Xm
Mm^Xm, Mm^Xm, Mm^Xm, Hhd^Em, Hhd^Fdw, Gd^Vct, Gd^Edp, Gd^Ecf, Re^Edb, Re^Edb, Co^Edb, Co, Re^Es, Re, Hhd^Edpp, Gd^Es, Hhd^Edb, Gd^Edb, Gd^Edpp, Hh, Hh^Fdw, Hh, Hh^Vh, Gd^Fdw, Re^Wm, Re^Gvs, Re^Gvs, Re^Gvs, Re^Gvs, Ww^Ewf, Ww, Ww, Ww, Ww, Ww^Ewl, Hh^Fdw, Mm, Mm, Mm, Mm, Mm, Wo
Mm^Xm, Mm^Xm, Mm, Md, Hhd^Fmw, Hhd^Fmw, Gd^Fmw, Gd^Fdw, Gd^Edb, Re^Edb, Re, Re^Es, Hhd^Edpp, Hhd^Vo, Hhd^Fmw, Md, Md, Hhd^Fdw, Gd^Edpp, Mm, Mm, Mm, Mm, Hh^Em, Gd, Re^Gvs, Rd^Es, Re^Gvs, Hh^Vhh, Hh^Fmw, Mm, Ww, Hh^Es, Wwr, Wwr, Ww^Ewf, Hh^Es, Mm, Mm, Mm, Wo, Wo
Mm, Mm, Mm, Hhd^Fdw, Md, Hhd^Fdw, Hhd, Hhd^Edpp, Hhd, Re^Edb, Re^Vct, Hhd, Mm, Md, Hhd^Fdw, Hhd^Fdw, Hhd^Edpp, Hhd^Em, Hhd^Fdw, Mm, Hhd^Fdw, Hh^Fmw, Hh^Em, Hh^Fdw, Gd, Rd^Es, Hh^Em, Gs^Fp, Hh^Fmw, Mm, Mm, Ww^Ewf, Ww, Hh, Ww, Ww, Hh, Hh^Es, Wo, Mm, Wo, Wo
Hhd, Hhd^Fdw, Hhd^Fdw, Mm, Mm, Re^Es, Gd^Fdw, Gd^Edp, Re^Es, Re^Edb, Hhd^Edpp, Hhd^Fdw, Md, Mm, Mm, Md, Gd^Es, Hhd^Edpp, Hhd^Fdw, Md, Md, Hh, Mm, Mm, Hh, Gd, Gs^Fmw, Hh^Fdw, Hh^Fmw, Hh^Fdw, Hh^Fdw, Mm, Mm, Ww, Ww, Wwr, Wwr, Wwr, Wo, Wo, Wo, Mm^Xm
Hh^Fds, Mm, Mm, Hhd, Re, Re^Es, Re, Re^Es, Re, Hhd^Em, Md, Hhd^Fdw, Hhd, Md, Mm, Hhd^Fdw, Hhd, Gd^Es, Gg, Md, Gg, Gs^Es, Gg, Hh^Fdw, Gg, Gd^Em, Re, Hh^Em, Hh, Mm, Mm, Mm, Mm, Mm, Wo, Wo, Wo, Wo, Mm, Wo, Mm^Xm, Mm^Xm
