Xu, Xu, Xu, Xu, Xu, Xu, Xu, Xu, Xu, Xu, Mm, Mm, Mm, Mm, Mm, Mm, Mm, Mm, Hh, Gs^Fp, Gs^Fms, Hh^Fp, Gs^Fms, Gg, Hh^Fms, Gg, Ww, Ww, Ww, Gs^Fp, Gs^Fp, Gg, Ww, Ww, Ww, Ww, Ww, Ww, Ww, Ww, Gs^Fp
Xu, Xu, Xu, Xu, Xu, Xu, Xu, Xu, Xu, Xu, Mm, Mm, Hh^Fdw, Mm, Mm, Hh^Fmw, Mm, Mm, Hh^Fp, Gs^Fms, Gs^Fms, Hh^Fds, Hh^Fp, Gs^Fp, Gs^Fms, Hh^Fp, Gg^Efm, Ww, Ww, Ww, Ww, Ww, Ww, Ww, Gs^Es, Gg^Efm, Re^Es, Ww^Bw/, Ww^Bw\, Gs^Fp, Re
Xu, Xu, Xu, Xu, Xu, Xu, Xu, Xu, Xu, Mm, Mm, Mm, Hh, Hh^Es, Hh^Fmw, Hh^Fp, Hh, Hh^Es, Mm, Hh^Fp, Gs^Fms, Hh^Fds, Gs^Fms, Gs^Fms, Gs^Fds, Hh, Gs^Fp, Ww, Ww, Ww, Ww, Ww, Ww, Ww, Gg^Efm, Gs, Re, Ww, Ww, Re^Es, Gg
Xu, Xu, Xu, Xu, Xoc, Xoc, Xoc, Xu, Xu, Mm, Hh^Fdw, Ce, Gg, Hh^Fmw, Gs, Hh^Es, Gs^Es, Hh^Fp, Hh^Fp, Gs^Em, Hh^Fp, Hh, Gs^Fp, Gs^Efm, Gs^Fds, Gs^Fms, Gs^Fms, Gs^Fp, Gs, Gs, Gs^Em, Gs^Fp, Gs^Fp, Gg^Efm, Gs, Gs^Em, Re, Gs^Fp, Ww, Ww, Ww
Xu, Xu, Xoc, Xoc, Xoc, Xoc, Xoc^Efs, Xoc, Xoc, Mm, Hh^Fmw, Hh, Hh^Es, Ce, Ce, Gs, Gg^Efm, Hh, Gg, Gs, Gs, Gs^Em, Hh^Fp, Gs^Fms, Gs^Fms, Hh^Fms, Gg^Efm, Gs^Fp, Gs^Em, Gs^Fp, Gs^Fms, Gs^Em, Gs^Fms, Gs^Fp, Gs, Gs^Fp, Gs^Fp, Re^Es, Ww, Wo, Wo
Xoc, Xoc, Xoc^Efs, Xoc^Efs, Iwr, Iwr, Iwr, Xoc^Efs, Xoc, Hh, Hh, Gg^Em, Hh, Hh^Es, Ce, Gg, Gg, Gs, Hh^Fp, Gs, Gg^Es, Hh^Fp, Gs^Em, Gs^Fp, Gg^Em, Gs^Fp, Gg, Gs, Gs^Fp, Gs^Fms, Gs^Fds, Gs^Fms, Gs^Fp, Gg^Em, Gg, Gs^Fms, Gs^Fp, Re, Gs^Vl, Wo^Bw/, Wo
Xoc, Xoc, Iwr, Iwr, Iwr, Iwr, Xoc, Xoc, Xoc, Hh^Fdw, Gg, Gg^Efm, Gg, Gs, Gg, Gg, Ce, Gs, Gg, Gg^Efm, Gs, Gg^Em, Gs, Gs^Fp, Gg, Gs, Gs^Fms, Gg^Es, Gs^Fms, Gs^Fms, Gs^Emf, Gs^Fp, Gs, Gg, Gg, Ww, Ww, Ww, Ww, Ww, Ww
Xoc, Xoc, Xoc, Iwr, Xoc, Iwr, Iwr, Xoc, Ch, Ch, Hh, Gg^Ve, Gs, Gg, Gg^Efm, Gg^Em, Gg^Ve, Gg^Es, Ce, Gg, Gs, Gs^Fp, Gg, Gg, Gg^Es, Gs^Fp, Gs, Gg^Efm, Gs^Fms, Gs^Fp, Gs^Fms, Gs^Em, Gs, Gs^Fp, Gg^Es, Gg^Efm, Ww, Ww, Gs^Fp, Gs^Fms, Gs^Fms
Xu, Xoc, Xoc, Xoc, Xoc, Xoc, Xoc, Rr, Rr, Rr^Ebn, Gs^Es, Rr, Rr, Rr^Ebn, Rr, Rr, Gg, Gg, Gg^Efm, Ce, Gg, Gs, Gs, Gs^Fp, Gs^Es, Gg^Em, Gg, Gs^Fp, Gs^Fp, Gs^Fms, Gs^Fp, Gs^Fp, Gg^Efm, Gg, Gs, Gg, Gs, Gg^Efm, Gs^Es, Gs^Fp, Gs^Fmw
Xu, Xu, Xu, Xoc, Mm, Xoc, Ch, Ch, Rr^Ebn, Rr, Re, Gd, Rr, Rr, Rr, Gs, Gg^Ve, Gs^Em, Gg, Gg, Ce, Gg^Es, Gg, Gs^Fp, Gs, Gg, Gg^Efm, Gs^Fp, Gg^Em, Gs^Fms, Gs^Fds, Gs^Fms, Gg^Efm, Gs^Fms, Gs^Fp, Gs^Fp, Gs^Em, Gs^Fp, Gs, Gs^Em, Gs
Mm, Xu, Mm, Mm, Hh^Fdw, Hh, Hh^Fdw, Gs, Gs^Es, Rr, Rr, Re^Es, Rr, Gs^Es, Gs, Rr, Gs, Gg^Efm, Gs^Eff, Gg^Efm, Gg, Re, Re, Gg, Gg^Efm, Gg, Gs, Gs, Gs^Fp, Gs^Fms, Gs^Fms, Gs^Fms, Gs^Fds, Gs^Fms, Gg^Efm, Gs^Fms, Gs^Fms, Gs^Efm, Gll, Gs^Fmw, Gg^Fp
Mm, Mm, Mm, Mm, Rr, Hh, Rr^Vhc, Gs, Hh, Rr^Vhc, Rr, Rr, Rr, Rr, Rr, Gs, Re, Gs^Eff, Re^Vh, Gs^Eff, Gs, Ch, Ch, Gs, Gg, Gs, Gs^Em, Gs^Fp, Gs^Fms, Gs^Fp, Gs^Fds, Gs^Fp, Gs^Fms, Gs^Fp, Gs^Fms, Gs^Fds, Gll^Fp, Gs^Fp, Gll^Es, Gll^Fmw, Gs^Fp
Mm, Mm, Mm, Hh^Vhh, Rr^Es, Rr^Es, Rr^Ebn, Rr, Re, Re, Re, Re, Re^Es, Rr, Rr, Re, Gd, Re^Es, Re^Gvs, Re^Gvs, Gs, Re^Es, Ch, Re^Es, Gs, Gg, Gs^Fp, Gs^Fms, Gs^Fms, Gs^Fds, Gs^Fms, Gg^Efm, Gs^Fds, Gs^Fms, Gs^Fms, Gll^Em, Gll^Fdw, Gll^Fmw, Rb^Edb, Gll^Es, Gll^Fp
Mm, Mm, Mm, Hh^Fmw, Hh, Ch, Ch, Rr^Es, Rr, Rr, Rr, Re^Es, Re^Es, Rr, Rr^Es, Re^Es, Gd, Gd, Re^Es, Re, Gg, Gg, Gg^Efm, Re, Gg^Es, Gg, Gs, Gs^Fp, Gs^Em, Gs^Fms, Gs^Fms, Gs^Fp, Gs^Fp, Gs^Fms, Gs^Fmw, Gll^Fmw, Rb^Edb, Gll^Fdw, Rb^Edb, Gll^Fp, Gll^Fmw
Hh, Hh^Fmw, Ch, Hh^Es, Ch, 2 Kh, Ch, Rr^Es, Rr, Rr^Es, Rr, Rr, Rr, Rr, Rr, Re^Es, Re, Gs, Gg^Efm, Gs, Gs, Gg, Re^Es, Gg, Gs, Gg, Gg^Efm, Gs, Gs^Fms, Gs^Em, Gs^Fms, Gs^Fms, Gs^Fp, Gll^Fp, Gll^Fmw, Gll^Em, Cer^Edb, Cer^Edb, Rb^Vct, Gll^Fmw, Gll^Emf
Mm, Mm, Hh^Fmw, Mm, Ch, Ch, Rr, Rr, Rr^Es, Re^Es, Re, Rr, Rr^Es, Rr, Rr, Gs, Gs, Re^Vh, Gg, Gs, Re^Es, Ch, Re, Gs, Gg^Es, Gg, Gs^Em, Gs^Fp, Gs^Fds, Gs^Fms, Gs^Fp, Gs, Gll^Em, Gs^Es, Gll^Em, Rb^Edb, Cer^Edb, 1 Ker, Cer^Edb, Rb^Em, Gll^Fmw
Hh, Hh^Es, Ch, Hh^Es, Rr^Vhc, Rr^Ebn, Rr, Rr, Gd, Re, Gd, Re^Es, Rr^Vhc, Rr, Rr, Gs, Gg, Gg^Efm, Gg, Re, Ch, Ch, Re, Gs, Gg, Gs^Em, Gs^Fp, Gs^Fms, Gs^Fp, Gs^Fds, Gg^Em, Gs^Fmw, Gs^Fp, Gll^Fp, Gll^Em, Gll^Emf, Rb^Vct, Cer^Edb, Gll^Fmw, Gll^Fdw, Gs^Fp
Hh, Hh, Ch, Rr, Rr, Gs, Gg, Gs, Gs, Gs^Es, Gs, Gs, Gd^Es, Rr, Rr, Rr^Es, Rr, Rr, Gs, Gg, Gd, Re^Es, Gs^Es, Gs, Gs, Gs, Gg, Gs^Em, Gs^Fms, Gs^Fms, Gs^Es, Gs^Fp, Gs, Gll^Fmw, Gll^Fmw, Rb^Edb, Gll^Fmw, Gll^Edb, Gll^Fmw, Gll^Fp, Gs^Fp
Gs^Fp, Gs^Fp, Hh, Hh^Fp, Ch, Gs^Fp, Gg^Efm, Gg^Fms, Gg^Fms, Gg^Fp, Gg^Efm, Gs, Gs, Gd, Gs, Rr, Rr^Es, Rr^Ebn, Ch, Re^Es, Gd, Gs, Gg^Efm, Gg, Gg^Efm, Gg, Gs, Gs, Gd^Es, Gs, Gs^Eff, Gs, Gs^Es, Gs^Fp, Gs^Fmw, Gll^Fdw, Gll^Fmw, Gll^Fp, Gs^Fms, Gs^Fmw, Gs
Hh^Fms, Gs^Fms, Gs^Fds, Hh^Fms, Hh^Fp, Hh, Gs, Gg^Fp, Gg^Fms, Gg^Fet, Ww, Gs^Fp, Wwf^Ewf, Gs, Gs, Gg, Gs, Rr, Rr, Re^Es, Gs, Gs, Gs, Gg, Gs^Em, Gg, Gs, Gd^Vc, Re^Eff, Gs^Eff, Re^Gvs, Gs^Eff, Gs^Eff, Gs^Fp, Gd^Es, Gs^Fms, Gs^Vl, Gs^Fp, Gs^Fp, Gs^Em, Gg
Gs, Hh^Fp, Hh^Fms, Hh^Fms, Ch, Gs^Fp, Gs^Fp, Gg^Efm, Gg^Efm, Wwf^Ewl, Ww^Ewf, Ww^Ewl, Ww^Ewl, Wwf, Gg^Efm, Gg, Ch, Rr, Gs, Re, Re, Gg, Gs, Gd, Ce, Ce, Gg^Es, Gd^Eff, Gd, Re^Gvs, Re^Gvs, Re^Gvs, Re^Gvs, Re^Eff, Re^Eff, Gs, Gg^Em, Gs^Fms, Gg, Gs, Ww
Hh^Fp, Hh, Gs^Fds, Hh^Fms, Ch, Hh, Gs^Fp, Gs, Gg^Fp, Wwf, Ww, Ww, Wwf, Gg^Fms, Gg, Gs, Re^Es, Re^Es, Gg, Gg, Gs, Re, Re, Re^Es, Gd, Gs, Gs, Gs^Es, Gs^Es, Re^Gvs, Re^Gvs, Re^Gvs, Re^Eff, Re^Eff, Ww, Gs^Es, Gs^Fp, Gs, Gs^Fp, Gg^Efm, Ww
Gs^Em, Hh^Fp, Gs^Fp, Gs^Fms, Hh, Ch, Re^Es, Hh^Es, Hh^Fms, Gg^Fp, Gg^Fms, Gg^Fms, Gg^Efm, Gg, Ch, Gd, Gd, Gs, Gg^Efm, Gg^Es, Ce, Gg, Gg^Efm, Re^Es, Re, Gd, Gs, Gs, Gs, Gd, Gd^Eff, Gd^Eff, Gs^Fms, Ww, Ww, Gs^Efm, Gs^Fp, Ww, Ww, Ww, Ww
Gs, Gs^Fms, Gs^Em, Gs^Fp, Gg^Efm, Gs, Re^Es, Ch, Gs^Es, Gs, Gg, Gg^Efm, Gs, Gg^Es, Re^Es, Re, Gs, Gg, Gs, Ce, Gs, Gs, Gs^Es, Gs, Gs, Re^Es, Gd, Gg^Efm, Gs, Gg^Vh, Gs^Fp, Gs^Fp, Gs^Fp, Gs^Fp, Gg^Em, Ww, Ww, Ww, Wo, Wo, Ww
Gs^Fp, Gg^Em, Gs^Fp, Gs, Gs^Fp, Gg, Gs, Re, Gs, Gs, Ch, Re, Ch, Gs, Gs, Gs^Es, Gs, Gs^Es, Gd^Eff, Gd^Eff, Gd^Eff, Gs, Gs^Es, Gs, Gd, Re, Re, Gs, Gg, Gs^Fp, Gg, Gs^Fms, Gg, Gs^Fms, Gs, Gg^Efm, Ww, Wo, Wo, Ww, Gg
Gg^Es, Gs, Gs^Fp, Gs, Gg^Efm, Gs^Fp, Gs, Gs, Gd^Es, Gd^Es, Gd, Ch, Re^Es, Re, Gd, Gd, Gs^Eff, Gs^Eff, Re^Gvs, Re^Wm, Re^Gvs, Gd^Eff, Gd^Eff, Gd, Gd^Es, Gd, Gs, Re, Re, Gg^Efm, Gg^Es, Gg^Efm, Gs^Es, Gs, Re^Gvs, Ww, Gs^Es, Ww, Ww, Ww, Ww
Gg, Gs, Gg, Gg, Gg, Gs, Gs^Es, Gd, Re^Gvs, Re^Wm, Re^Gvs, Gd^Es, Gd, Gs^Es, Gs, Gs, Gd^Es, Re^Gvs, Re^Gvs, Re^Gvs, Re^Gvs, Re^Gvs, Re^Gvs, Gd, Gs^Es, Gd, Gs, Gg, Re^Es, Gg, Gs, Gg^Efm, Gs^Es, Re^Gvs, Re^Gvs, Re^Gvs, Re^Gvs, Gs^Es, Gs, Gs^Fms, Ww
Gg, Gg^Efm, Gg, Gg^Efm, Gs^Fds, Gs, Gs, Re^Gvs, Re^Gvs, Re^Gvs, Re^Gvs, Re^Gvs, Re^Gvs, Gs, Gg, Gs, Gg, Gd, Re^Gvs, Re^Gvs, Re^Gvs, Re^Gvs, Re^Gvs, Gd, Gs, Gs, Gg, Gg^Efm, Gg, Re, Gg, Gs, Gs, Re^Gvs, Re^Gvs, Re^Gvs, Re^Gvs, Gs, Re^Gvs, Gg^Efm, Gg
