Irs, Xos, Xol, Xol, Xos, Xos, Xos, Xos, Xos, Xos, Xol, Xos, Xos, Xos, Xos, Xos, Xos, Xos, Xos, Xos, Xos, Xos, Xos, Xos, Xos, Xos, Xos, Xos, Xos
Xos, Irs, Iwr, Xol, Xos, Xos, Xos, Xos, Icn^Ebn, Xos, Xos, Xol, Xos, Xos, Xol, Xos, Icn, Icn, Icn, Xol, Xol, Xos, Xol, Xol, Icn, Xos, Xos, Xos, Xos
Xos, Xos, Iwr, Iwr, Xos, Xos, Icn^Eb, Icn, Iwr, Icn, Icn^Eb, Xos, Xos, Xol, Icn, Iwr, Iwr, Icn, Xol, Xol, Xol, Xol, Xol^Efs, Iwr, Iwr, Icn, Xos, Xos, Xos
Xos, Iwr, Iwr, Xos, Xos, Xos, Xos, Iwr, Iwr, Iwr, Xos, Xos, Xol, Icn, Iwr, Iwr, Iwr, Iwr, Xos, Xos, Irs, Icr, Icr, Iwr^Pr\, Xos, Xos, Xos, Xos, Xos
Xos, Xos, Xos, Iwr, Iwr, Xos, Xos, Xos, Xos, Iwr^Pr/, Icr, Xos, Xos, Xol, Xol, Xol, Xos, Iwr^Pr/, Icr, Irs, Irs, Irs, Xol, Xol, Xol, Xos, Iwr, Xos, Xos
Xos, Xos, Xos, Xos, Xos, Iwr, Xos, Xos, Xos, Xos, Xos, Icr, Icr, Xos, Xos^Efs, Xos, Irs, Icr, Irs, Irs^Ebn, Xos, Irs^Pr/, Iwr, Xol, Iwr, Ior, Iwr, Iwr, Xol
Xos, Xos, Xos, Xos, Xos, Xos, Xos, Xos, Xol, Xos, Xol, Xos, Xos, Irs, Irs, Irs, Irs^Ebn, Irs, Irs, Xol, Xol, Xos, Xos, Iwr, Ior, Ior, Ior, Ior, Xos
Xos, Xos, Xos, Xos, Xos, Xos, Xos, Xol, Urc, Urc, Iwr, Xol, Xos, Xos, Xol, Xos, Xos, Irs, Irs, Xos, Xos, Xos, Xos, Xos, Ior^Pr\, Ior, Xos, Xos, Xos
Xos, Xos, Xos, Xos, Xos, Xos, Iwr, Iwr, Iwr, Iwr, Iwr, Iwr, Iwr^Pr/, Xol, Xos, Xos, Xos, Irs, Irs^Ebn, Xos, Xos, Xos, Xos, Ior, Iwr, Xol, Xos, Xos, Xos
Xos, Xos, Icn, Icn^Eb, Iwr, Xos, Iwr^Pr\, Iwr, Urc, Urc, Xos, Xos, Xos, Irs, Irs, Xos^Efs, Irs, Irs, Xos, Xos, Xos, Xos, Iwr, Ior, Ior, Iwr, Ior^Eb, Xol, Xos
Xol, Icn^Ebn, Iwr, Iwr, Iwr, Iwr, Xos, Xos, Xos, Xos, Xos, Xos, Xos, Xos, Irs, Irs, Xos, Xos, Xos, Xos, Iwr, Iwr, Iwr, Ior, Ior, Ior, Xol, Xol, Xos
Xos, Icn, Icn^Eb, Iwr, Xos, Xos, Xol, Xol, Xos, Xos, Xos, Xos, Irs, Irs^Pr\, Xos, Xol, Xos, Xos, Xos, Iwr^Eb, Iwr, Iwr, Urc, Ior, Xol, Xol, Xos, Xos, Xos
Xos, Xos, Xos, Xos, Xos, Xos, Xos, Xos, Xos, Xos, Irs, Irs, Irs, Irs, Irs, Xos, Xos^Efs, Xos, Irs, Iwr^Pr\, Xos, Urc, Xol, Xol, Xol, Xos, Xos, Xos, Xos
Xos, Xos, Xos, Xos, Xos, Xos, Xos, Xos, Xos, Irs, Irs, Irs, Irs, Irs, Irs, Irs, Irs, Irs, Xos, Xos, Xos, Xol, Xol, Xos, Xol, Xos, Xos, Xos, Xos
Xos, Xos, Xos, Xos, Iwr^Eb, Xos, Xos, Xos, Iwr, Irs^Pr\, Xos, Irs, Irs^Ebn, Irs, Irs, Irs, Irs, Irs, Xos, Xos, Xos, Xos, Xol, Xol, Xol, Xol, Xol, Xos, Xos
Xos, Xos, Xos, Iwr, Iwr, Urc, Urc, Urc, Iwr, Xos, Xos, Xos, Xos, Irs, Irs, Irs, Irs, Icr, Icr, Xos, Xos, Xos, Xos, Xol, Xol, Xol, Xol, Xol, Xos
Xos, Xos, Xos, Xos, Xos, Iwr, Iwr, Iwr, Xos, Xos, Xos, Xos, Xos, Xos, Xos, Icr, Icr, 1 Irs, Irs, Icr, Icr, Xos, Xos, Xos, Xol, Xol, Xos, Xos, Xos
Xos, Xos, Xos, Xos, Xos, Xos, Xos, Xos, Xol, Xol, Xol, Xol, Xol, Xos, Xos, Xos, Xos, Icr, Icr, Irs, Irs, Icr, Icr, Xos, Xos, Xos, Xos, Xos, Xos
Xos, Xos, Xos, Xos, Xos, Xos, Xos, Xol, Xol, Xol, Xol, Xol, Xol, Xos, Xos, Xos, Xos, Xos, Xos, Icr, Icr, Irs, Rrc, Rrc, Rrc, Xos, Xos, Xos, Xos
Xos, Xos, Xos, Xos, Xos, Xos, Xos, Xol, Xos, Xol, Xol, Xol, Xos, Xos, Xos, Xos, Xos, Xos, Xos, Xos, Xos, Rrc, Rrc, Rrc, Rrc, Rrc, Rrc, Xos, Xos
Xos, Xos, Xos, Xos, Xos, Xos, Xos, Xos, Xos, Xol, Xos, Xos, Xos, Xos, Xos, Xos, Xos, Xos, Xos, Xos, Xos, Rrc, Rrc, Rrc, Rrc, Rrc, Rrc, Rrc, Xos
Xos, Xos, Xos, Xos, Xos, Xos, Xos, Xos, Xos, Xos, Xos, Xos, Xos, Xos, Xos, Xos, Xos, Xos, Xos, Xos, Xos, Rrc, Rrc, Rrc, Rrc, Rrc, Rrc, Rrc, Xos
