Xu, Xu, Xu, Xu, Xu, Xu, Xu, Xu, Xu, Xu, Xu, Xu, Xu, Xu, Xu, Xu, Xos, Xos, Xos, Xos, Xos, Xos, Xos, Xos, Xos, Xos, Xu, Xu, Xu, Xu, Ur^Es, Ur, Xu, Xu, Xu, Xu, Xos
Xu, Xu, Xu, Xu, Xu, Xu, Xu, Xu, Xu, Xu, Xu, Xu, Uh^Uf, Xu, Uh^Uf, Xu, Xos, Xos, Xos, Xos, Xos, Xos, Uh^Uf, Xos, Xos, Xos, Xu, Xu, Xu, Xu, Uu^Em, Ur^Es, Xu, Xu, Xu, Xu, Xu
Xu, Xu, Xu, Xu, Xu, Xu, Xu, Xu, Xu, Xu, Xu, Xu, Uh^Uf, Uh^Emf, Uh^Em, Xu, Xos, Xos, Urb^Eb, Xos, Xos, Uh^Emf, Uh^Em, Uu^Emf, Uh^Uf, Xom, Xos, Xu, Xu, Uh^Uf, Uh^Emf, Ur, Ur^Es, Xu, Xuc, Xu, Xu
Xu, Xu, Xu, Xu, Xu, Xu, Xu, Xu, Xu, Xu, Xu, Uh^Uf, Uu^Emf, Uu^Ii, Uu^Em, Xol^Efs, Ur, Ur^Es, Urb, Urb, Ur^Es, Xos^Efs, Ur^Es, Uu^Em, Xom, Xom, Xos, Xos, Xom, Xuc, Xuc, Xuc, Xuc, Ur, Uu^Uf, Xuc, Xos
Xu, Xu, Xu, Xu, Xu, Xu, Xu, Xu, Xos, Xos, Uu^Em, Uh^Em, Uu^Em, Uu, Uu^Es, Uu, Ur, Urb, Urb, Urb, Ur^Es, Ur, Uu, Uu^Em, Xom, Xos, Xom, Xom, Ur^Es, Xom, Ur^Es, Xuc, Xuc, Ur^Es, Uu^Em, Xuc, Xos
Xu, Xu, Xu, Xu, Xu, Xu, Xos, Xos, Xos, Xos, Uh^Emf, Uu^Em, Uu, Uu^Es, Uu, Ur^Es, Urb, Urb, Urb, Urb, Urb, Ur, Ur^Es, Uu^Em, Uu^Ebn, Xom^Efs, Ur, Ur, Uu^Em, Ur, Xuc, Ur^Es, Ur, Uu^Em, Xu, Xos, Xos
Xu, Xu, Xu, Xu, Xu, Xu, Xos, Xos, Uu, Uh, Uu^Em, Uu^Ii, Ur, Ur^Es, Ur^Ii, Xoc, Urb, Urb, Urb, Urb, Urb, Ur^Es, Ur, Uu, Ur, Ur^Es, Ur^Es, Uu^Emf, Xom, Xuc, Xos, Xu, Xu, Xu, Xos, Xos, Xos
Xu, Xu, Xu, Xu, Xu, Xos, Xol, Xos, Ur, Ur, Ur^Es, Ur, Xoc, Irs, Irs, Irs, Urb, Urb, Xos, Urb, Urb, Urb, Urb, Ur^Es, Urb, Uu, Uu, Uu^Em, Xol^Efs, Xos, Uu^Emf, Xu, Xu, Xu, Xu, Xu, Xos
Xu, Xu, Xu, Xu, Xu, Xol, Uu^Em, Ur^Ebn, Ur^Es, Irs, Irs, Irs, book_start Icr^Ii, Irs, Irs, Irs, Irs, Urb, Urb, Urb, Urb, Urb, Ur^Es, Ur, Urb, Urb, Xos, Urb^Pr/, Urb, Ur, Ur^Eb, Uu^Uf, Uu^Uf, Xu, Xu, Xu, Xos
Xu, Xu, Xu, Xu, Uh^Em, Uu^Em, Uu^Ii, Ur^Es, Ur, Xoc, Irs^Ii, Irs, Irs, Irs, Irs^Ii, Xoc, Irs, Urb, Ur, Urb, Urb, Xos, Ur^Es, Ur, Xos, Urb^Pr/, Urb, Urb, Urb, Urb, Uu^Em, Uu^Emf, Urb^Pr/, Xos, Xos, Xu, Xu
Xu, Xu, Uh^Uf, Uh^Emf, Uu^Em, Uu, Uu, Uu^Em, Ur, Ur^Es, Ur, Ur^Es, Xos, Irs, Irs, Irs, Urb, Ur^Es, Xos, Ur^Es, Ur, Ur^Es, Xos, Xos, Xos, Xol, Xol, Urb, Urb, Ur^Es, Xos, Xos, Xu, Uu^Em, Uh^Uf, Xu, Xu
Xu, Xu, Uh^Uf, Uu^Uf, Uh^Emf, Uh^Em, Uu^Ii, Ur, Uu, Ur^Es, Uu, Ur, Uu, Ur^Es, Urb, Urb, Urb, Urb, Urb, Urb, Ur^Pr/, Xos, Urc, Urc, Urc, Xol, Xol, Xol, Xol, Ur^Pr/, Ur^Es, Xu, Xu, Uu^Em, Uh^Emf, Xu, Xos
Xu, Xu, Xu, Xu, Xu, Uh^Em, Uh^Em, Uu^Em, Uu^Em, Uu, Uu^Em, Uu^Ii, Uu, Ur, Urb, Xos, Urb, Urb^Ebn, Xos, Xos, Urc, Ur, Ur, Ur, Urc, Urc, Xos, Xos, Xos, Xol, Ur, Uu, Uu^Em, Uu, Xu, Xu, Xos
Xu, Xu, Xu, Xu, Xu, Xu, Uh^Uf, Uh^Emf, Xu, Xu, Xu, Uh^Emf, Uu^Em, Ur^Es, Ur, Urb, Xos, Xos, Xol, Urc, Urc, Ur, Urc, Ur, Ur^Pr/, Xos, Xos^Efs, Xol, Urb, Urb, Urb, Ur, Ur^Es, Uu^Ebn, Xu, Xu, Xos
Xu, Xu, Xu, Xu, Xu, Xu, Xu, Xu, Xu, Xu, Xu, Uh^Uf, Xos, Xos, Xos, Urb^Pr/, Urb, Xol, Xol, Xol, Xol, Urc, Xos, Xos, Xos, Ur, Ur^Es, Ur^Eb, Urb, Urb, 1 Urb, Urb, Ur, Xol, Xol, Xos, Xos
Xu, Xu, Xu, Xu, Xu, Xos, Xos, Xu, Xu, Xu, Xos, Xos, Xol, Xol, Ur^Es, Ur^Es, Urb, Urb, Urb, Xos, Xol, Xos, Xos, Xol, Ur^Es, Ur, Urb, Ur, Ur^Es, Ur, Ur^Es, Ur, Ur^Es, Xol, Xos, Xos, Xos
Xu, Xu, Xu, Xu, Xos, Xos, Xu, Xu, Xu, Xu, Uu^Em, Xos, Uu^Ebn, Uu, Ur, Urb, Urb, Urb, Xos, Urb^Pr/, Urb, Xol, Urb, Ur, Urb, Urb, Urb, Urb, Urb, Urb, Ur^Es, Ur, Ur^Es, Xos, Xos, Xos, Xos
Xu, Xu, Xos, Xos, Xos, Xu, Xu, Xos, Xu, Xu, Uh^Em, Uu, Uh^Em, Uu, Uu^Es, Urb, Xos, Xos, Xos, Xos, Xu, Urb, Ur^Es, Ur, Ur^Es, Urb, Urb, Urb, Urb, Urb, Xos, Ur, Ur, Ur, Irs, Xos, Xos
Xos, Xos, Xos, Xos, Xos, Xos, Xu, Xos, Xu, Uh^Uf, Uh^Emf, Uh^Emf, Uh^Uf, Uu^Em, Xos, Xos, Xu, Xu, Xu, Xu, Uh^Emf, Xu, Uu^Em, Uu, Ur, Urb, Urb, Urb, Xos, Xos, Xos, Xos, Xos, Ur, Irs, Irs, Irs
Xos, Xos, Xos, Xos, Xos, Xos, Xos, Xu, Xu, Xu, Xu, Xu, Xu, Xu, Xos, Xos, Xu, Xu, Xu, Xu, Uh^Uf, Uh^Em, Uu^Em, Uu^Ebn, Xol, Ur^Es, Xos, Xos, Xos, Xos, Xos, Xos, Xos, Xos, Xos, Irs, Irs
Xos, Xos, Xos, Xos, Xos, Xos, Xos, Xos, Xu, Xos, Xu, Xu, Xos, Xos, Xos, Xos, Xos, Xu, Xu, Xu, Xu, Xu, Xu, Xu, Xos, Xos, Xos, Xos, Xos, Xos, Xos, Xos, Xos, Xos, Xos, Xos, Xos
Xos, Xos, Xos, Xos, Xos, Xos, Xu, Xu, Xos, Xu, Xos, Xos, Xos, Xos, Xos, Xos, Xos, Xos, Xos, Xos, Xos, Xos, Xos, Xos, Xos, Xos, Xos, Xos, Xos, Xos, Xos, Xos, Xos, Xos, Xos, Xos, Xos
