Xu, Xos, Xuc, Xu, Xos, Xu, Xu, Xu, Xos, Xu, Xos, Uu, Xu, Xu, Xu, Uh, Uh^Uf, Xu, Xu, Xu, Re, Uu, Rb^Es, Rb^Es, Ur^Es, Uu, Rb^Es, Ur, Uu^Em, Uu, Uu
Xos, Xos, Irs, Xuc, Ur, Xuc, Xuc, Xu, Xuc, Xos, Xos, Xu, Uu^Vu, Xu, Uu^Em, Uh^Emf, Uu, Xu, Uu, Xu, Re, Re, Rb^Es, Uu, Ur, Uu, Ur, Ur^Es, Uu^Emf, Uu^Es, Uh^Em
Xuc, Ur, Ur^Br\, Icr, Ur^Es, Ur^Br/, Xuc, Xuc, Uh^Uf, Uu^Emf, Uh^Uf, Uh^Emf, Rb^Es, Rb^Es, Re^Edb, Ql, Ql, Uu^Vud, Rb^Es, Rb^Es, Ql, Rd^Esd, Uu^Vu, Rb^Es, Ur^Es, Ur^Es, Uu^Em, Xu, Xu, Uh^Uf, Xu
Xuc, Irs, Ur^Es, Ur^Br|, Xuc, Irs^Ebn, Xuc, Xuc, Uh^Em, Xu, Xu, Xu, Re^Edb, Rd^Esd, Re^Edb, Rb^Edb, Ql, Rd^Esd, Ur^Edb, Re^Edb, Rd^Edb, Ql, Ql, Ql, Uu^Em, Uh^Em, Xu, Xu, Xu, Xu, Xu
Xu, Xos, Urb, Uu^Br\, Uu^Br|, Xuc, Xos, Xos, Rb^Es, Xu, Ur^Es, Uu^Em, Xu, Ql, Rd^Esd, Ql^Bs\, Uu^Vu, Ur^Edb, Ql, Rd^Edb, Ql, Ql^Bs\, Rd^Edb, Ur^Edb, Rb^Es, Uh^Emf, Xu, Xu, Xu, Xu, Xu
Xu, Xu, Xuc, Xuc, Ur^Es, Xos, Xuc, Uu^Emf, Uu^Br\, Xu, Ur^Es, Xu, Ql, Ql, Ql, Ql, Ql, Ql, Cud, Ql, Ql^Bs/, Rd^Esd, Ql, Re^Edb, Rb^Es, Xu, Xu, Uh^Emf, Uh^Uf, Xu, Xu
Xu, Xu, Xos, Xuc, Rb^Es, Xuc, Rb^Es, Uu^Br/, Ur^Es, Rb^Br\, Rd^Edb, Ql, Ql, Uu^Vud, Ur^Edb, Ql, Cud, Ql, Cud, Cud, Ql, Ql, Rd^Esd, Rb^Es, Uu^Vud, Xu, Xu, Uu, Xu, Xu, Xu
Xu, Xu, Xos, Cud, Rb, Uu^Br/, Uu, Uu^Em, Xuc, Ur^Es, Ur^Edb, Rd^Esd, Ql^Bs/, Ur^Edb, Rd^Esd, Cud, Cud, Kud, Cud, Cud, Ql, Ql, Re^Es, Re^Es, Uu, Xu, Uh, Rb^Es, Uh^Emf, Uh^Uf, Xu
Xu, Xuc, Uu^Br|, Ur^Es, Xos, Xuc, Ur, Xuc, Xu, Xuc, Uu^Vu, Ur^Edb, Xu, Ql, Ql, Ql, Cud, Ql, Ql, Ur, Ql^Bs\, Ql, Uu, Uu^Es, Ur^Es, Uu, Xu, Uh^Emf, Xu, Uh^Uf, Xu
Xuc, Xuc, Ur^Es, Xuc, Uu, Xuc, Ur, Uh^Em, Xu, Xu, Xuc, Rb, Xu, Xu, Ql, Ql, Ql, Ql, Ql, Ql, Ql, Ur, Ur^Edb, Uu^Edb, Ur, Xu, Xu, Xu, Xu, Xu, Xu
Cud, Ur, Uu^Br|, Uu^Br/, Xu, Rb^Es, Xuc, Cud, Xos, Xu, Xuc, Uu, Uu, Xu, Rd^Es, Ql, Ql, Xu, Xu, Xu, Ql, Uu^Vud, Uu^Edb, Uu^Edb, Rb, Xu, Uu, Xu, Xu, Xu, Xu
Uu, Rb^Es, Ur^Br/, Ur, Xuc, Xu, Xos, Xu, Xuc, Xos, Xu, Xu, Uu, Xu, Re^Es, Ql, Rd^Esd, Ql, Re^Es, Xu, Xu, Xu, Uu^Em, Ur, Ur^Es, Rb^Es, Uu^Em, Xu, Xu, Xu, Xu
Xu, Xu, Uu^Em, Uu, Uh^Em, Xos, Cud, Xuc, Uu^Em, Rb^Es, Uu, Uu, Uu, Rb, Uu^Emf, Rd^Esd, Rb, Re^Es, Uu^Em, Xu, Uh^Uf, Uu^Emf, Xu, Xu, Xu, Ur^Es, Xu, Uh^Em, Uh^Emf, Xu, Xu
Xos, Xos, Uu^Emf, Xos, Xos, Uu, Rb^Es, Uh^Emf, Xos, Xu, Ur^Es, Ur, Uu^Em, Uh^Em, Uh^Uf, Uh^Emf, Xu, Uu^Em, Uh^Em, Uh^Emf, Uh^Uf, Xu, Xu, Xu, Xu, Uu, Xu, Xu, Uh^Uf, Xu, Xu
Xu, Uh^Uf, Uh^Uf, Xos, Ur, Rb^Es, Urb, Uh^Em, Xu, Xu, Ur^Es, Xu, Xu, Rb^Es, Xu, Uu^Em, Uu^Em, Xu, Uu^Em, Xu, Xu, Xu, Xu, Xu, Rb, Rb^Es, Uu^Em, Uh^Emf, Uh^Uf, Xu, Xu
Xu, Xos, Uh^Emf, Xos, Uu^Em, Urb, Urb^Ii, Urb, Ur^Es, Uu, Xu, Xos, Xu, Rb^Es, Xu, Xu, Uh^Uf, Xu, Uu, Xu, Xu, Xu, Xu, Ur^Es, Xu, Rb, Uh^Em, Xu, Xu, Xu, Xu
Xu, Xu, Uu^Em, Uu^Em, Uh^Uf, Urb, Rb, Urb, Ur^Es, Rb, Rb^Es, Rb^Es, Uu^Em, Uu, Uu^Em, Rb^Es, Rb^Es, Uh^Emf, Uu^Em, Xu, Rb^Es, Ur^Es, Ur^Es, Uu, Xu, Uh^Emf, Xu, Xu, Xu, Xu, Xu
Qxu, Xu, Uu^Em, Uh^Emf, Xos, Ur, Xu, Rb^Es, Xu, Ur, Xu, Xu, Rb, Uh^Emf, Uh^Uf, Uh^Em, Urb, Uu^Em, Xu, Rb, Urb, Urb, Ur, Xu, Uu^Em, Uh^Uf, Xu, Xu, Xu, Xu, Xu
Qxu, Qxu, Qxu, Uh^Em, Xu, Xos, Xu, Xos, Xos, Ur^Es, Xu, Xu, Ur^Es, Xu, Rb^Es, Ai, Ur, Uu^Em, Uh^Uf, Xu, Urb, Urb^Ebn, Urb, Rb^Es, Rb^Es, Xu, Xu, Xu, Xu, Xu, Xu
Qxu, Qxu, Qxu, Uu^Em, Uu, Xu, Xu, Xu, Xos, Rb, Uu^Em, Ur^Es, Xu, Rb^Es, Rb^Es, Ur, Xu, Uu^Em, Xu, Uh^Em, Re, Urb, Uu, Rb, Xu, Xu, Xu, Xu, Xu, Xu, Xu
Qxu, Qxu, Qxu, Uh^Emf, Uh^Uf, Xu, Xu, Xu, Xu, Xos, Uh^Uf, Uu^Emf, Uu, Xu, Uu^Em, Uh^Emf, Uh^Uf, Xu, Xu, Uu^Em, Rb^Es, Uu, Xu, Uu^Em, Uh^Em, Xu, Uu^Emf, Xu, Xu, Xu, Xu
Qxu, Qxu, Qxu, Qxu, Xu, Xu, Xu, Xu, Xu, Xu, Xu, Uh^Uf, Uh^Emf, Rb^Em, Urb, Urb, Uu^Em, Xu, Xu, Xu, Xu, Rb^Es, Xu, Rb^Es, Uh^Emf, Uh^Uf, Xu, Uh^Uf, Uh^Em, Xu, Xu
Qxu, Qxu, Qxu, Qxu, Xu, Xu, Xu, Xu, Xu, Xu, Xu, Xu, Xu, Uu^Em, Urb, Urb^Ii, Urb, Uh^Emf, Uh^Uf, Xu, Xu, Uu, Uu^Em, Uu^Em, Xu, Xu, Xu, Uh^Em, Uh^Em, Xu, Xu
Xu, Qxu, Ur^Es, Qxu, Xu, Xu, Uh^Em, Xu, Uh^Uf, Xu, Xu, Xu, Xu, Ur^Es, Rb, Urb, Uu^Em, Uu^Em, Xu, Xu, Xu, Xu, Uu^Em, Uu^Em, Uh^Uf, Uu, Qxu, Uh^Emf, Uu, Xu, Xu
Xu, Qxu, Uh^Em, Ur^Es, Uu, Uu^Em, Xu, Uh^Emf, Uh^Uf, Xu, Xu, Xu, Xu, Ur, Ur^Es, Uu, Xu, Uh^Emf, Xu, Xu, Xu, Uu^Em, Ur^Es, Uh^Emf, Xu, Uu^Em, Qxu, Qxu, Xu, Xu, Qxu
Xu, Xu, Xu, Uu, Uh, Xu, Xu, Uu^Em, Uu^Emf, Xu, Xu, Xu, Uh, Xu, Rb^Es, Xu, Xu, Xu, Xu, Xu, Uu^Em, Uu, Ur^Es, Xu, Xu, Qxu, Qxu, Qxu, Qxu, Qxu, Qxu
Xu, Xu, Xu, Xu, Uh, Xu, Xu, Xu, Xu, Uu^Em, Xu, Xu, Ur^Es, Uu, Uu^Em, Uh^Emf, Xu, Xu, Xu, Xu, Uu, Rb^Es, Xu, Xu, Xu, Xu, Xu, Qxu, Qxu, Qxu, Qxu
Xu, Xu, Xu, Xu, Xu, Uh, Qxu, Qxu, Qxu, Uu, Uu, Uu, Ur^Es, Rb, Uu, Uh^Em, Ur, Ur^Es, Uu, Rb, Ur, Qxu, Qxu, Qxu, Qxu, Qxu, Qxu, Qxu, Qxu, Qxu, Qxu
Ur^Es, Xu, Xu, Xu, Xu, Qxu, Qxu, Qxu, Qxu, Cud, Qxu, Ur, Cud, Uu, Xu, Uu^Em, Ur^Es, Xu, Xu, Qxu, Qxu, Qxu^Bcx\, Qxu^Bcx\, Qxu, Qxu, Qxu, Qxu, Qxu, Xu, Qxu, Qxu
Uh^Em, Xu, Xu, Xu, Xu, Qxu, Qxu, Qxu, Qxu, Qxu, Xu, Xu, Qxu, Xu, Xu, Uu^Em, Uu^Em, Xu, Qxu, Qxu, Qxu, Qxu, Qxu, Qxu, Qxu, Qxu, Qxu, Qxu, Xu, Xu, Xu
Uh^Uf, Uu^Es, Uh^Emf, Xu, Xu, Xu, Qxu, Qxu, Ur^Es, Qxu^Bcx/, Qxu, Qxu, Qxu, Qxu, Uh^Uf, Uh^Emf, Uu^Em, Xu, Uh^Emf, Qxu, Qxu, Qxu, Qxu, Qxu, Qxu, Qxu, Qxu, Qxu, Qxu, Xu, Xu
Uh^Em, Xu, Uh^Em, Xu, Uh, Xu, Uu^Em, Ur^Es, Uu^Uf, Qxu, Qxu, Qxu, Qxu, Qxu, Xu, Xu, Uh^Uf, Uh^Emf, Uh^Uf, Xu, Qxu, Qxu, Qxu, Qxu, Qxu, Qxu, Qxu, Qxu, Qxu, Xu, Xu
Uh^Uf, Xu, Uu, Ur, Uu, Ur^Es, Uu^Em, Uh^Emf, Xu, Qxu, Xu, Qxu, Qxu, Qxu, Qxu, Xu, Xu, Xu, Qxu, Qxu, Qxu, Qxu, Qxu, Qxu, Qxu, Qxu, Qxu, Qxu, Qxu, Qxu, Xu
Uu^Em, Uh^Emf, Ur^Es, Ur, Ur^Es, Ur^Es, Uu, Uh^Em, Xu, Xu, Xu, Xu, Qxu, Qxu, Qxu, Qxu, Qxu, Qxu, Qxu, Qxu, Qxu, Qxu, Qxu, Qxu, Qxu, Qxu, Qxu, Qxu, Qxu, Qxu, Xu
Uu^Edb, Uu, Ur^Es, Uu, Uu^Em, Uu, Ur^Es, Uu, Uh^Em, Xu, Xu, Xu, Xu, Qxu, Qxu, Qxu, Qxu, Qxu, Qxu, Qxu, Qxu, Qxu, Qxu, Qxu, Qxu, Qxu, Qxu, Qxu, Qxu, Xu, Xu
Uu^Edb, Ur^Edb, Uu, Ur, Uu, Uu^Edb, Uh^Edb, Ur^Es, Xu, Uh^Em, Uh^Emf, Xu, Xu, Xu, Qxu, Qxu, Qxu, Qxu, Qxu, Qxu, Xu, Qxu, Qxu, Qxu, Xu, Qxu, Qxu, Qxu, Xu, Xu, Xu
Gg, Uu^Em, Uu^Em, Uu, Uu^Edb, Uu^Edb, Gg, Xu, Uu^Em, Uu^Em, Uh^Uf, Xu, Xu, Xu, Xu, Qxu, Qxu, Qxu, Qxu, Xu, Xu, Xu, Xu, Xu, Xu, Xu, Xu, Xu, Xu, Xu, Gg
