Xu, Xu, Xu, Xu, Xu, Xu, Xu, Xu, Wog, Wog, Wog, Xu, Xu, Xu, Xu, Gg, Xu, Xu, Xu, Xu, Xu, Gll^Fdw, Gll^Fdw, Gd, Xu, Xu, Xu, Gll^Fp, Gll^Fmw, Rp, Gll^Fp, Gs^Fp
Xu, Xu, Wwrg, Wwrg, Wwg^Ewl, Xu, Xu, Wwg, Wwrg, Wwrg, Xu, Xu, Xu, Xu, Xu, Xu, Xu, Xu, Xu, Xu, Xu, Xu, Gd^Em, Xu, Xu, Xu, Xu, Gll^Fdw, Rp, Rp, Gll^Fmw, Gll^Fp
Wog, Xu, Wwg, Xu, Xu, Xu, Xu, Wwg, Wwrg, Wwrg, Wwg, Wwg^Ewl, Wwg^Ewl, Uu^Em, Uu, Uu^Emf, Uh^Uf, Uh^Em, Rb^Es, Xu, Uu, Re^Vct, Rb, Re^Es, Re^Es, Gd, Gd^Em, Gll^Em, Rp, Gll^Fdw, Gll^Fp, Gll^Fmw
Wog, Wog, Wog, Wwg, Wwg, Xu, Wog, Xu, Wog, Wwg^Ewl, Uu^Em, Uu^Em, Uu^Es, Rb^Es, Ur^Es, Ur^Es, Uu^Em, Uu^Em, Xu, Uu^Em, Ce, Rb^Es, Ce, Rb, Ur^Es, Ur, Ur, Rp, Gll^Fdw, Gll^Emf, Gll^Fmw, Gll^Fp
Xu, Wog, Xu, Wwrg, Wwrg, Wog, Wwg, Wog, Wwg, Wwg^Ewl, Ur, Ur, Uu, Ur, Uh^Em, Uu, Uu^Em, Ur^Es, Ur^Es, Ur, Ur^Es, Ce, Ke, Ur, Ce, Re^Vct, Gd, Gll^Em, Gll^Em, Gll^Fmw, Gll^Fp, Gll^Emf
Xu, Xu, Xu, Xu, Wwrg, Wog, Wwrg, Wwrg, Wwg^Bw/, Uu^Vu, Uu^Uf, Xu, Xu, Xu, Xu, Xu, Uh^Emf, Uu^Em, Uu, Rb^Vct, Rb, Ce, Ce, Ce, Re^Es, Re^Es, Re, Gd^Em, Xu, Re^Em, Xu, Gs^Fp
Xu, Xu, Xu, Xu, Wog, Wwg, Wwrg, Wwg, Wwg^Ewl, Xuc, Xu, Xu, Xu, Xu, Xos, Uh^Em, Uu^Em, Ur^Es, Xu, Re^Es, Uu, Uu^Em, Rb^Es, Rb, Rb^Vct, Uu, Uu, Xu, Xu, Xu, Xu, Xu
Xu, Uh^Uf, Uu^Emf, Uh, Wog, Wwg, Wog, Wwg, Xuc, Xuc, Xu, Xuc, Wwg, Xos, Wwg^Ewl, Re, Rb^Es, Ur, Uh^Em, Xu, Re^Es, Uu^Em, Xu, Uu, Uu, Xu, Xu, Xu, Xu, Xu, Xu, Xu
Xu, Uh^Em, Uu^Em, Wog^Bw\r, Wog, Wog, Wwrg, Xu, Xu, Xu, Xu, Wwg^Ewl, Xos, Wwg^Ewl, Uh^Em, Re^Es, Xu, Rb, Uh^Em, Xu, Rb^Es, Uu, Xu, Xu, Uu^Emf, Xu, Xu, Xu, Xu, Xu, Xu, Xu
Wog, Wwg, Wwg, Wwrg, Wog, Wog, Wwg, Wwg, Xos, Xos, Xuc, Xu, Xos, Re^Es, Uh^Emf, Xuc, Xos, Uu, Uu^Es, Rb, Uu, Uh^Em, Rb, Rb, Re^Em, Uu^Uf, Re^Edb, Uu^Es, Uu^Em, Xu, Uh^Uf, Xu
Xu, Wog, Wog, Wog, Wog, Wog, Wwg^Bw\r, Wwg^Ewl, Wwg^Ewl, Rb^Es, Wwg, Xuc, Wwg^Ewl, Uh^Em, Xu, Xos, Xuc, Re^Es, Ur, Uu^Es, Uh^Em, Uh^Emf, Uu, Uu^Em, Re^Edb, Rb^Edb, Rb^Edb, Rb^Es, Uh^Em, Uh^Emf, Uh^Uf, Xu
Wwg, Wog, Wwrg, Wog, Wog, Wwg^Ewl, Rd^Esd, Re^Es, Rb^Es, Uu, Xuc, Wwg, Uh^Em, Re^Br\, Re^Es, Xuc, Rb^Es, Uu, Ur^Edb, Xu, Xu, Xu, Xu, Re^Em, Xu, Uu^Edb, Rb^Es, Uu^Em, Uh^Emf, Xu, Xu, Xu
Xuc, Wwg, Xuc, Wwrg, Wwg, Wwg, Xu, Xuc, Xuc, Xu, Uu^Emf, Uh^Uf, Rb^Es, Re^Br|, Ur, Rb^Em, Uu, Uu, Uu^Edb, Uu^Vud, Xu, Xu, Xu, Xu, Xu, Xu, Uu^Em, Uu, Xu, Xu, Xu, Xu
Xos, Xos, Wwrg, Wwg, Wwg^Ewl, Rd^Esd, Ur, Xuc, Uu^Vu, Xuc, Ur^Br\, Uu^Em, Ur^Br\, Rb^Es, Uu^Em, Ur, Ur, Ur^Edb, Uu^Edb, Uu^Edb, Xu, Xu, Rb^Es, Xu, Uu^Es, Uu^Es, Uu, Uh^Em, Xu, Xu, Xu, Xu
Wog, Xuc, Wog, Wwg^Ewl, Xos, Re^Em, Re^Es, Ur^Es, Uu^Em, Uh^Emf, Ur^Br|, Ur^Br/, Re^Es, Uh^Em, Rb^Es, Uu^Em, Re^Br/, Rd, Uu^Em, Ur^Edb, Ur^Es, Xu, Rb^Em, Rb, Rb^Edb, Re^Es, Rb^Edb, Xu, Ql, Ql, Xu, Xu
Wog, Wog, Wwg, Xuc, Uu^Emf, Uh^Uf, Rb^Es, Rb^Es, Ur^Br/, Ur^Br/, Uu^Br|, Xuc, Uh^Emf, Uu^Em, Rb^Es, Re^Br|, Uu^Emf, Uh^Uf, Uh^Em, Uu, Uu, Xu, Uu^Em, Uu^Emf, Xu, Rd^Edb, Re^Edb, Rd^Ii, Ql, Ql, Xu, Xu
Xuc, Xuc, Wwg^Ewl, Xuc, Ur^Br/, Ur^Br|, Uu^Vu, Ur^Br|, Uu^Em, Ur, Uu^Br|, Xos, Xos, Uh^Uf, Re, Xuc, Xuc, Xos, Xu, Uu^Es, Ur^Es, Rb^Es, Cud, Uh^Uf, Xu, Xu, Ql, Rd^Esd, Ql, Xu, Xu, Xu
Rb^Br/, Rb^Br/, Rb^Br\, Rb^Es, Rd^Es, Uu, Xos, Xuc, Xos, Xuc, Xos, Uh^Uf, Uu^Em, Re^Em, Uh^Emf, Xuc, Uh^Emf, Uh^Uf, Rb, Ur, Rb^Es, Rb^Es, Re, Xu, Xu, Ql, Ql, Ql^Bs|, Ql, Xu, Xu, Xu
Xu, Xuc, Uh^Em, Uu^Emf, Xuc, Xos, Xuc, Xu, Xu, Xos, Xuc, Uu^Em, Uu^Es, Ur^Br\, Xuc, Xu, Uu^Uf, Uu^Em, Rb^Emf, Ur^Es, Re, Re^Edb, Rd^Edb, Ql, Ql, Xu, Ql, Ql^Bs|, Ql, Ql, Xu, Xu
Xu, Xuc, Xuc, Uh^Uf, Xos, Xos, Xu, Xu, Uh^Uf, Xu, Uh^Emf, Uh^Em, Xuc, Ur^Es, Uu^Em, Cud, Ur, Uu, Ur, Uu^Em, Re^Es, Rb^Edb, Rd^Esd, Rd^Esd, Ql, Ql, Ur^Ii, Ur^Es, Urb^Vu, Ql, Ql, Xu
Xu, Xu, Xos, Xos, Xos, Xu, Xu, Xu, Xu, Uh^Em, Uh^Uf, Xuc, Xu, Xu, Re^Em, Uu^Emf, Rb^Es, Ur^Es, Uu^Em, Re^Es, Rb^Es, Re, Uu^Em, Ql, Ql^Bs/, Ql^Bs/, Ql, Ur^Edb, Ql^Bs\, Ql, Ql, Xu
Xuc, Xu, Xuc, Xos, Xos, Xu, Uu^Vu, Xu, Uu^Em, Uh^Emf, Uu, Xu, Uu, Xu, Re, Re^Em, Rb^Es, Ur, Ur, Uu^Em, Uu^Em, Cud, Uu^Emf, Uu^Em, Ql, Ql, Ql, Ql, Ql, Ql^Bs\, Rd^Esd, Xu
Xuc, Xuc, Uh^Uf, Uu^Emf, Uh^Uf, Uh^Emf, Rb^Es, Rb^Es, Re^Edb, Ss, Ss^Em, Uu^Vud, Rb^Es, Rb^Es, Sm, Rd^Esd, Uu^Vu, Rb^Es, Ur^Es, Uu^Em, Uu^Em, Xu, Xu, Uh^Uf, Ql, Ql, Xu, Ql, Ql, Rd^Edb, Rb^Ii, Xu
Xuc, Xuc, Uh^Em, Xu, Xu, Xu, Re^Edb, Rd^Esd, Re^Edb, Rb^Edb, Sm, Rd^Esd, Ur^Edb, Re^Edb, Rd^Edb, Ss^Em, Sm, Sm, Ur^Em, Uh^Em, Xu, Xu, Xu, Ql, Ql, Xu, Xu, Ql, Ql, Ql, Ql, Xu
Xos, Xos, Rb^Es, Xu, Ur^Es, Uu^Em, Xu, Ss^Emf, Rd^Esd, Ss^Bs\, Uu^Vu, Ur^Edb, Ss^Em, Rd^Edb, Ss^Emf, Ss^Bs\, Rd^Edb, Ur^Edb, Rb^Es, Uh^Emf, Xu, Xu, Xu, Xu, Xu, Ql, Ql, Ql, Xu, Xu, Xu, Xu
Xuc, Uu^Emf, Uu^Br\, Xu, Ur^Es, Xu, Ss^Uf, Ss^Em, Ss^Em, Sm, Sm^Emf, Sm, Cud, Ss^Uf, Ss^Bs/, Rd^Esd, Ss^Em, Re^Edb, Rb^Es, Xu, Xu, Uh^Emf, Uh^Uf, Xu, Xu, Ql, Ql, Ql, Xu, Xu, Xu, Xu
Rb^Es, Uu^Br/, Ur^Es, Rb^Br\, Rd^Edb, Ss^Em, Ss^Emf, Uu^Vud, Ur^Edb, Ss, Cud, Sm^Uf, Cud, Cud, Sm^Edb, Ss^Emf, Rd^Esd, Rb^Es, Uu^Vud, Xu, Xu, Uu, Xu, Xu, Xu, Xu, Xu, Xu, Xu, Xu, Xu, Xu
Uu, Uu^Em, Xuc, Ur^Es, Ur^Edb, Rd^Esd, Ss^Bs/, Ur^Edb, Rd^Esd, Cud, Cud, 1 Kud, Cud, Cud, Sm^Edb, Sm^Edb, Re^Es, Urb^Ii, Uu, Xu, Uh, Rb^Es, Uh^Emf, Uh^Uf, Xu, Xu, Xu, Xu, Xu, Xu, Xu, Xu
Ur, Xuc, Xu, Xuc, Uu^Vu, Ur^Edb, Uu, Sm, Sm^Edb, Sm^Edb, Cud, Ss^Uf, Sm^Emf, Ur, Sm^Bs\, Ss^Em, Uu, Uu^Es, Ur^Es, Uu, Xu, Uh^Emf, Xu, Uh^Uf, Xu, Xu, Xu, Xu, Xu, Xu, Xu, Xu
Ur, Uh^Em, Xu, Xu, Xuc, Rb, Urb, Xu, Sm, Ss^Edb, Ss^Em, Ss, Sm^Uf, Sm^Em, Ss^Em, Ur, Ur^Edb, Uu^Edb, Ur, Xu, Xu, Xu, Xu, Xu, Xu, Xu, Xu, Xu, Xu, Xu, Xu, Xu
Xuc, Cud, Xos, Xu, Xuc, Uu, Uu, Xu, Rd^Es, Ss^Edb, Sm^Emf, Xu, Xu, Xu, Ss^Em, Uu^Vud, Uu^Edb, Uu^Edb, Rb, Xu, Uu, Xu, Xu, Xu, Xu, Xu, Xu, Xu, Xu, Xu, Xu, Xu
Xos, Xos, Xuc, Xos, Xu, Xu, Uu, Xu, Re^Es, Ss^Em, Rd^Esd, Sm^Em, Sm, Xu, Xu, Xu, Uu^Em, Ur, Ur^Es, Rb^Es, Uu^Em, Xu, Xu, Xu, Xu, Xu, Xu, Xu, Xu, Xu, Xu, Xu
