Gg, Gg, Gg^Kov, Gg^Kov, Gg^Kov, Gg^Kov, Gg^Kov, Gg^Kov, Gg^Kov, Gg, Gg^Kov, Gg^Kov, Gg^Kov, Gg, Gg^Kov, Gg^Kov, Gg^Kov, Gg
Gg^Kov, Gg^Kov, Gg^Kov, Gg^Kov, Gg^Kov, Gg^Kov, Gg^Kov, Gg^Kov, Gg^Kov, Gg^Kov, Gg^Kov, Gg^Kov, Gg^Kov, Gg^Kov, Gg^Kov, Gg^Kov, Gg^Kov, Gg^Kov
Gg^Kov, Xv, Gg^Kov, Gg^Kov, Gg^Kov, Gg^Kov, Gg^Kov, Gg^Kov, Gg^Kov, Gg^Kov, Gg^Kov, Gg^Kov, Gg^Kov, Gg^Kov, Gg^Kov, Gg^Kov, Gg^Kov, Gg^Kov
Gg^Kov, Gg^Kov, Gg^Kov, Gg^Kov, Gg^Kov, Gg^Kov, Gg^Kov, 1 Kha^Kov, Gg^Kov, Gg^Kov, Gg^Kov, Gg^Kov, Gg^Kov, 2 Kha^Kov, Gg^Kov, Gg^Kov, Gg^Kov, Gg^Kov
Gg^Kov, Xv, Gg^Kov, Gg^Kov, Gg^Kov, Gg^Kov, Gg^Kov, Cha^Kov, Gg^Kov, Gg^Kov, Gg^Kov, Gg^Kov, Gg^Kov, Cha^Kov, Gg^Kov, Gg^Kov, Gg^Kov, Gg^Kov
Gg^Kov, Gg^Kov, Gg^Kov, Gg^Kov, Gg^Kov, Gg^Kov, Gg^Kov, Gg^Kov, Gg^Kov, Gg^Kov, Gg^Kov, Gg^Kov, Gg^Kov, Gg^Kov, Gg^Kov, Gg^Kov, Gg^Kov, Gg^Kov
Gg^Kov, Xv, Gg^Kov, Chs^Kov, Gg^Kov, Chs^Kov, Gg^Kov, Ch^Kov, Gg^Kov, Ch^Kov, Gg^Kov, Chs^Kov, Gg^Kov, Ch^Kov, Gg^Kov, Ch^Kov, Gg^Kov, Gg^Kov
Gg^Kov, Gg^Kov, Gg^Kov, Gg^Kov, Gg^Kov, Gg^Kov, Gg^Kov, Gg^Kov, Gg^Kov, Gg^Kov, Gg^Kov, Gg^Kov, Gg^Kov, Gg^Kov, Gg^Kov, Gg^Kov, Gg^Kov, Gg
Gg^Kov, Gg^Kov, Gg^Kov, Chs^Kov, Gg^Kov, Chs^Kov, Gg^Kov, Ch^Kov, Gg^Kov, Ch^Kov, Gg^Kov, Chs^Kov, Gg^Kov, Ch^Kov, Gg^Kov, Ch^Kov, Gg^Kov, Gg
Gg, Gg^Kov, Gg^Kov, Gg^Kov, Gg, Gg^Kov, Gg^Kov, Gg^Kov, Gg^Kov, Gg^Kov, Gg, Gg^Kov, Gg, Gg^Kov, Gg^Kov, Gg^Kov, Gg, Gg
